gameId,blueWins,blueWardsPlaced,blueWardsDestroyed,blueFirstBlood,blueKills,blueDeaths,blueAssists,blueEliteMonsters,blueDragons,blueHeralds,blueTowersDestroyed,blueTotalGold,blueAvgLevel,blueTotalExperience,blueTotalMinionsKilled,blueTotalJungleMinionsKilled,blueGoldDiff,blueExperienceDiff,blueCSPerMin,blueGoldPerMin,redWardsPlaced,redWardsDestroyed,redFirstBlood,redKills,redDeaths,redAssists,redEliteMonsters,redDragons,redHeralds,redTowersDestroyed,redTotalGold,redAvgLevel,redTotalExperience,redTotalMinionsKilled,redTotalJungleMinionsKilled,redGoldDiff,redExperienceDiff,redCSPerMin,redGoldPerMin
4477599823,1,44,4,1,9,5,16,0,0,0,0,17433,6.8,17284,198,32,1668,-774,19.8,1743.3,19,3,0,5,9,4,2,1,1,0,15765,7.0,18058,210,72,-1668,774,21.0,1576.5
4477407120,1,10,1,1,10,5,8,0,0,0,0,17465,6.8,17968,218,51,1428,463,21.8,1746.5,42,3,0,5,10,9,1,1,0,0,16037,6.8,17505,222,40,-1428,-463,22.2,1603.7
4445983241,1,14,3,1,6,2,5,1,1,0,0,17259,7.4,19920,249,64,2452,1600,24.9,1725.9,37,4,0,2,6,5,0,0,0,0,14807,7.0,18320,221,52,-2452,-1600,22.1,1480.7
4518396542,1,30,4,1,8,4,4,1,1,0,0,17038,7.2,18971,233,60,1530,334,23.3,1703.8,37,2,0,4,8,2,1,0,1,0,15508,6.8,18637,233,48,-1530,-334,23.3,1550.8
4522086611,1,17,2,0,5,5,4,1,1,0,0,16660,7.0,19188,217,55,785,1439,21.7,1666.0,18,2,1,5,5,6,0,0,0,0,15875,6.8,17749,200,48,-785,-1439,20.0,1587.5
4512064032,1,13,2,0,4,4,5,0,0,0,0,15198,7.0,18486,205,60,-266,15,20.5,1519.8,15,5,1,4,4,2,1,1,0,0,15464,7.0,18471,224,57,266,-15,22.4,1546.4
4524540652,0,108,2,0,6,6,9,0,0,0,0,17070,7.0,17907,208,60,1044,662,20.8,1707.0,12,4,1,6,6,8,0,0,0,0,16026,7.0,17245,208,32,-1044,-662,20.8,1602.6
4509051206,1,15,1,1,12,5,13,0,0,0,0,19292,7.2,18153,210,34,4641,2291,21.0,1929.2,17,1,0,5,12,5,1,1,0,0,14651,6.6,15862,172,52,-4641,-2291,17.2,1465.1
4483434284,1,12,2,0,12,9,9,1,1,0,0,17905,7.2,18292,195,39,482,466,19.5,1790.5,91,2,1,9,12,10,0,0,0,0,17423,7.0,17826,159,68,-482,-466,15.9,1742.3
4499523222,1,18,3,0,9,6,14,1,1,0,0,16945,6.8,17806,204,36,1574,761,20.4,1694.5,17,2,1,6,9,6,0,0,0,0,15371,6.8,17045,194,54,-1574,-761,19.4,1537.1
4512168503,0,18,4,0,4,7,3,2,1,1,0,15210,6.8,17099,185,72,-2630,-2244,18.5,1521.0,19,4,1,7,4,6,0,0,0,0,17840,7.2,19343,222,71,2630,2244,22.2,1784.0
4448166002,0,19,3,1,2,11,2,0,0,0,0,14959,6.8,16588,226,54,-3301,-2246,22.6,1495.9,16,2,0,11,2,18,1,1,0,0,18260,7.4,18834,203,53,3301,2246,20.3,1826.0
4497475863,0,35,2,1,6,5,6,1,1,0,0,15765,7.0,17647,214,45,-164,-313,21.4,1576.5,12,2,0,5,6,6,0,0,0,0,15929,6.8,17960,218,47,164,313,21.8,1592.9
4470313749,1,19,3,1,4,9,4,0,0,0,0,15198,6.4,16245,226,37,-797,-532,22.6,1519.8,19,3,0,9,4,10,1,1,0,0,15995,6.6,16777,180,46,797,532,18.0,1599.5
4518283013,0,16,7,1,8,8,9,1,1,0,0,17055,7.0,17918,199,48,-431,120,19.9,1705.5,20,2,0,8,8,13,0,0,0,0,17486,7.0,17798,221,52,431,-120,22.1,1748.6
4501838629,0,43,3,1,5,9,2,1,1,0,0,16099,7.0,18159,244,50,-1367,-1526,24.4,1609.9,19,14,0,9,5,9,1,0,1,0,17466,7.4,19685,197,64,1367,1526,19.7,1746.6
4490435808,0,13,5,1,5,5,8,1,0,1,0,16009,6.8,18033,220,40,540,269,22.0,1600.9,15,2,0,5,5,8,1,1,0,0,15469,6.8,17764,185,54,-540,-269,18.5,1546.9
4477045051,0,19,4,1,10,9,12,0,0,0,0,17487,6.8,17660,211,41,274,-459,21.1,1748.7,14,3,0,9,10,13,1,1,0,0,17213,7.0,18119,198,52,-274,459,19.8,1721.3
4519295854,0,11,1,0,8,8,6,1,1,0,0,16002,6.8,17397,177,52,-1260,-1183,17.7,1600.2,11,2,1,8,8,13,0,0,0,0,17262,7.0,18580,209,56,1260,1183,20.9,1726.2
4480429391,1,14,1,1,13,2,11,2,1,1,1,21382,7.2,20346,246,48,6624,4865,24.6,2138.2,14,2,0,2,13,4,0,0,0,0,14758,6.2,15481,185,51,-6624,-4865,18.5,1475.8
4520799131,0,38,0,1,6,8,5,0,0,0,0,15617,6.8,17606,194,35,-2139,-1844,19.4,1561.7,95,0,0,8,6,10,1,1,0,0,17756,7.4,19450,200,80,2139,1844,20.0,1775.6
4497870077,1,17,0,0,1,7,0,1,1,0,0,13749,6.2,16076,208,43,-3574,-3171,20.8,1374.9,25,3,1,7,1,9,0,0,0,0,17323,7.2,19247,222,67,3574,3171,22.2,1732.3
4521502172,0,18,4,1,8,7,10,0,0,0,0,16746,6.8,17772,188,48,409,-292,18.8,1674.6,17,5,0,7,8,8,1,1,0,0,16337,7.0,18064,216,52,-409,292,21.6,1633.7
4527311147,0,19,0,1,6,8,5,1,1,0,0,17093,7.0,18357,233,48,-414,-601,23.3,1709.3,165,1,0,8,6,7,0,0,0,0,17507,7.2,18958,243,48,414,601,24.3,1750.7
4502535933,1,76,1,1,1,1,1,0,0,0,0,15082,6.8,17854,239,51,1389,894,23.9,1508.2,15,2,0,1,1,0,1,1,0,0,13693,6.4,16960,209,56,-1389,-894,20.9,1369.3
4481379221,0,14,3,1,8,8,9,0,0,0,0,17202,6.6,17447,214,40,-336,-1059,21.4,1720.2,14,0,0,8,8,9,1,1,0,0,17538,7.0,18506,214,71,336,1059,21.4,1753.8
4497825054,1,17,5,0,6,4,9,0,0,0,0,17096,7.2,19253,241,63,419,462,24.1,1709.6,14,4,1,4,6,5,1,1,0,0,16677,7.2,18791,247,60,-419,-462,24.7,1667.7
4518466773,1,17,4,1,4,4,0,1,1,0,0,15154,6.6,17000,219,54,-277,208,21.9,1515.4,42,3,0,4,4,7,0,0,0,0,15431,6.6,16792,224,43,277,-208,22.4,1543.1
4448069997,0,13,1,0,0,6,0,0,0,0,0,13078,6.2,15827,184,61,-3205,-3400,18.4,1307.8,30,5,1,6,0,4,1,1,0,0,16283,7.4,19227,210,54,3205,3400,21.0,1628.3
4522366207,0,30,3,0,3,7,3,0,0,0,0,14668,6.6,16196,197,52,-2440,-2239,19.7,1466.8,21,5,1,7,3,6,1,1,0,0,17108,7.2,18435,230,55,2440,2239,23.0,1710.8
4504379351,0,16,5,1,5,2,2,0,0,0,0,15890,7.0,18495,232,51,995,707,23.2,1589.0,18,1,0,2,5,4,1,1,0,0,14895,6.8,17788,219,60,-995,-707,21.9,1489.5
4484601181,1,16,0,0,8,5,8,2,1,1,0,17390,7.2,19016,212,60,1716,1837,21.2,1739.0,15,1,1,5,8,8,0,0,0,0,15674,6.8,17179,226,36,-1716,-1837,22.6,1567.4
4462628331,1,13,6,1,7,11,8,0,0,0,0,16749,6.8,17223,226,47,-2320,-1204,22.6,1674.9,37,2,0,11,7,12,2,1,1,0,19069,6.8,18427,207,60,2320,1204,20.7,1906.9
4520320166,1,18,4,0,12,9,9,0,0,0,0,19397,7.0,19301,232,44,2287,2551,23.2,1939.7,12,8,1,9,12,4,0,0,0,0,17110,6.6,16750,184,52,-2287,-2551,18.4,1711.0
4511656001,1,16,2,1,8,3,5,2,1,1,1,18661,7.4,19718,233,56,4867,4211,23.3,1866.1,14,1,0,3,8,7,0,0,0,0,13794,6.6,15507,169,40,-4867,-4211,16.9,1379.4
4521903863,1,40,3,1,8,3,10,2,1,1,0,18122,7.4,20449,247,68,2696,3081,24.7,1812.2,12,14,0,3,8,3,0,0,0,0,15426,6.8,17368,222,54,-2696,-3081,22.2,1542.6
4461618866,1,18,2,1,3,3,3,1,1,0,0,15923,7.0,18062,248,50,1916,1404,24.8,1592.3,17,3,0,3,3,3,1,0,1,0,14007,6.8,16658,193,40,-1916,-1404,19.3,1400.7
4495097170,0,15,2,0,5,11,5,0,0,0,0,15543,6.8,17304,197,44,-3318,-2979,19.7,1554.3,14,1,1,11,5,8,2,1,1,0,18861,7.6,20283,228,60,3318,2979,22.8,1886.1
4525546355,0,18,2,0,4,8,5,0,0,0,0,15470,7.0,17547,226,64,-2376,-1482,22.6,1547.0,15,5,1,8,4,13,1,1,0,0,17846,7.4,19029,248,48,2376,1482,24.8,1784.6
4519007166,1,19,2,1,8,9,7,2,1,1,0,15775,6.6,17200,149,47,-2675,-1325,14.9,1577.5,19,4,0,9,8,11,0,0,0,0,18450,7.0,18525,231,42,2675,1325,23.1,1845.0
4519853578,0,12,2,0,5,9,3,1,0,1,0,15173,7.0,17165,183,59,-2354,-1337,18.3,1517.3,16,3,1,9,5,7,1,1,0,0,17527,7.0,18502,210,46,2354,1337,21.0,1752.7
4509741728,1,13,5,0,6,6,8,2,1,1,0,16516,7.0,17456,184,57,366,596,18.4,1651.6,20,2,1,6,6,7,0,0,0,0,16150,6.6,16860,221,48,-366,-596,22.1,1615.0
4521299727,1,35,3,1,13,5,16,0,0,0,0,19452,7.6,20776,212,59,2593,3690,21.2,1945.2,14,3,0,5,13,7,2,1,1,0,16859,6.8,17086,213,64,-2593,-3690,21.3,1685.9
4437158302,0,18,0,0,2,10,0,0,0,0,0,14082,6.6,16368,238,29,-3196,-1322,23.8,1408.2,14,2,1,10,2,14,1,1,0,0,17278,6.8,17690,216,60,3196,1322,21.6,1727.8
4522841712,0,18,2,1,5,8,7,0,0,0,0,16049,6.6,16758,217,51,-883,-1828,21.7,1604.9,14,7,0,8,5,9,0,0,0,0,16932,7.0,18586,187,43,883,1828,18.7,1693.2
4519990304,1,16,3,1,7,4,9,2,1,1,0,17897,7.0,18898,237,46,2332,637,23.7,1789.7,16,2,0,4,7,4,0,0,0,0,15565,7.0,18261,190,68,-2332,-637,19.0,1556.5
4461986866,0,86,3,1,6,4,10,0,0,0,0,17275,7.2,19289,241,44,1702,1352,24.1,1727.5,14,1,0,4,6,4,1,1,0,0,15573,6.8,17937,234,60,-1702,-1352,23.4,1557.3
4500245820,0,14,2,1,8,6,6,1,1,0,0,16706,6.8,17561,216,36,31,-741,21.6,1670.6,16,2,0,6,8,7,1,0,1,0,16675,7.0,18302,231,52,-31,741,23.1,1667.5
4493337415,1,9,2,0,5,4,5,1,0,1,0,15549,6.8,17486,222,52,-193,-607,22.2,1554.9,15,4,1,4,5,2,1,1,0,0,15742,6.8,18093,248,48,193,607,24.8,1574.2
4470174827,1,16,2,1,10,3,11,1,0,1,0,17986,7.0,18856,218,50,3239,2494,21.8,1798.6,12,3,0,3,10,4,0,0,0,0,14747,6.6,16362,198,53,-3239,-2494,19.8,1474.7
4492065807,1,15,4,1,8,4,12,0,0,0,0,18498,7.2,18641,232,48,2759,980,23.2,1849.8,18,0,0,4,8,2,1,1,0,0,15739,7.0,17661,215,43,-2759,-980,21.5,1573.9
4523556041,1,10,9,0,10,10,10,1,1,0,0,17754,7.0,18278,195,52,292,1026,19.5,1775.4,124,0,1,10,10,12,1,0,1,0,17462,6.8,17252,190,40,-292,-1026,19.0,1746.2
4525061092,1,16,2,1,9,6,7,0,0,0,0,16902,6.8,17878,207,49,1451,1154,20.7,1690.2,14,2,0,6,9,7,0,0,0,0,15451,6.8,16724,199,44,-1451,-1154,19.9,1545.1
4484044944,0,88,1,0,4,11,9,0,0,0,0,16121,6.6,16956,169,65,-1587,-1578,16.9,1612.1,14,2,1,11,4,12,1,1,0,0,17708,6.8,18534,221,40,1587,1578,22.1,1770.8
4491887077,0,16,4,0,8,10,13,0,0,0,0,16707,6.6,16612,204,43,-648,-1422,20.4,1670.7,18,3,1,10,8,12,1,1,0,0,17355,6.8,18034,193,52,648,1422,19.3,1735.5
4498878998,1,15,3,1,5,8,9,0,0,0,0,16391,6.8,17744,228,68,-842,-711,22.8,1639.1,22,1,0,8,5,9,1,1,0,0,17233,7.0,18455,239,44,842,711,23.9,1723.3
4509392638,0,18,3,1,5,9,4,0,0,0,0,15815,7.0,18120,202,56,-2234,-1264,20.2,1581.5,18,3,0,9,5,8,2,1,1,0,18049,7.4,19384,258,48,2234,1264,25.8,1804.9
4511865277,0,42,5,0,7,11,6,0,0,0,0,16664,6.8,17627,214,48,-2262,-1763,21.4,1666.4,19,3,1,11,7,16,1,1,0,0,18926,7.4,19390,195,60,2262,1763,19.5,1892.6
4463010085,0,15,1,0,2,6,2,0,0,0,0,14498,7.0,17488,223,57,-1754,-1471,22.3,1449.8,17,2,1,6,2,4,0,0,0,0,16252,7.2,18959,228,66,1754,1471,22.8,1625.2
4502501913,1,11,3,0,9,3,8,1,1,0,0,18012,7.2,19378,261,60,2845,4032,26.1,1801.2,14,1,1,3,9,4,0,0,0,0,15167,6.2,15346,185,52,-2845,-4032,18.5,1516.7
4468973214,0,23,1,0,4,7,6,0,0,0,0,15210,6.6,16010,207,40,-2161,-3222,20.7,1521.0,35,1,1,7,4,8,2,1,1,0,17371,7.4,19232,214,72,2161,3222,21.4,1737.1
4515527726,1,39,1,0,7,6,6,0,0,0,0,17605,7.4,19964,254,64,1564,668,25.4,1760.5,17,2,1,6,7,3,1,1,0,0,16041,7.2,19296,214,44,-1564,-668,21.4,1604.1
4520001245,1,13,2,0,6,2,8,1,1,0,0,16753,7.4,18695,201,63,2631,2349,20.1,1675.3,23,2,1,2,6,1,1,0,1,0,14122,6.4,16346,207,48,-2631,-2349,20.7,1412.2
4295358071,1,17,6,0,10,6,13,0,0,0,0,18348,6.6,17087,195,52,1864,-797,19.5,1834.8,19,4,1,6,10,7,1,1,0,0,16484,7.0,17884,211,59,-1864,797,21.1,1648.4
4521386660,1,15,1,1,4,4,1,0,0,0,0,14881,7.0,18074,209,45,-856,-563,20.9,1488.1,164,3,0,4,4,1,0,0,0,0,15737,7.0,18637,236,55,856,563,23.6,1573.7
4447641028,0,79,1,1,11,14,10,0,0,0,0,16978,5.6,13699,158,28,-4259,-3503,15.8,1697.8,28,3,0,14,11,21,1,0,1,2,21237,7.0,17202,203,34,4259,3503,20.3,2123.7
4504974041,0,13,1,1,2,4,2,0,0,0,0,14651,6.8,18301,241,41,-1991,-1055,24.1,1465.1,15,1,0,4,2,4,0,0,0,0,16642,7.2,19356,248,78,1991,1055,24.8,1664.2
4478101809,0,15,0,0,2,9,0,0,0,0,0,14244,6.6,16850,207,48,-3553,-1730,20.7,1424.4,13,1,1,9,2,9,1,1,0,0,17797,7.0,18580,220,48,3553,1730,22.0,1779.7
4524775955,1,14,2,0,6,9,7,2,1,1,0,15649,6.8,17052,186,44,-2822,-1240,18.6,1564.9,13,2,1,9,6,9,0,0,0,0,18471,7.0,18292,248,32,2822,1240,24.8,1847.1
4526523308,0,22,1,0,5,5,2,0,0,0,0,15752,7.0,18629,217,55,-717,8,21.7,1575.2,94,2,1,5,5,4,0,0,0,0,16469,7.2,18621,218,54,717,-8,21.8,1646.9
4521143475,0,15,5,0,9,8,7,1,0,1,1,19084,6.8,17286,225,38,2445,-81,22.5,1908.4,28,3,1,8,9,5,1,1,0,0,16639,6.8,17367,189,68,-2445,81,18.9,1663.9
4467234641,1,18,5,1,7,7,6,0,0,0,0,16119,6.6,16658,217,41,-524,-1029,21.7,1611.9,23,5,0,7,7,8,2,1,1,0,16643,6.8,17687,190,50,524,1029,19.0,1664.3
4527416964,0,14,5,0,3,6,3,0,0,0,0,14399,6.6,17167,221,40,-3656,-2866,22.1,1439.9,19,1,1,6,3,4,0,0,0,0,18055,7.4,20033,232,82,3656,2866,23.2,1805.5
4523595695,1,24,3,0,6,5,12,0,0,0,0,17074,7.2,18861,242,64,519,1436,24.2,1707.4,62,3,1,5,6,7,1,1,0,0,16555,6.6,17425,232,52,-519,-1436,23.2,1655.5
4521293628,1,13,6,0,10,11,13,1,1,0,0,17948,6.6,16194,193,35,93,-1276,19.3,1794.8,17,3,1,11,10,13,0,0,0,0,17855,6.8,17470,219,40,-93,1276,21.9,1785.5
4437799907,0,13,1,1,10,10,14,1,1,0,0,18931,7.2,18806,222,52,1804,820,22.2,1893.1,18,0,0,10,10,10,0,0,0,0,17127,7.0,17986,211,36,-1804,-820,21.1,1712.7
4460977711,1,15,5,1,4,7,2,0,0,0,0,15169,7.0,17363,217,44,-145,120,21.7,1516.9,51,2,0,7,4,3,0,0,0,0,15314,6.8,17243,205,39,145,-120,20.5,1531.4
4516616203,1,23,0,0,2,5,1,0,0,0,0,15508,7.0,17985,258,60,-919,-923,25.8,1550.8,11,2,1,5,2,8,0,0,0,0,16427,7.2,18908,226,48,919,923,22.6,1642.7
4496540023,1,16,6,0,9,10,8,1,1,0,0,17170,7.0,18583,204,46,-522,226,20.4,1717.0,16,2,1,10,9,10,0,0,0,0,17692,7.0,18357,192,42,522,-226,19.2,1769.2
4481775600,1,14,4,1,4,4,3,1,0,1,0,16087,7.2,19195,224,66,225,824,22.4,1608.7,164,2,0,4,4,5,1,1,0,0,15862,7.0,18371,208,68,-225,-824,20.8,1586.2
4516828940,0,19,0,0,11,5,10,0,0,0,1,18855,7.0,18139,180,44,3164,287,18.0,1885.5,18,0,1,5,11,1,1,1,0,0,15691,7.0,17852,206,64,-3164,-287,20.6,1569.1
4388887551,1,28,3,1,9,4,14,0,0,0,0,18274,7.2,18252,242,57,2422,656,24.2,1827.4,15,1,0,4,9,4,0,0,0,0,15852,7.0,17596,228,59,-2422,-656,22.8,1585.2
4522534575,1,15,2,1,5,6,5,1,1,0,0,15536,6.8,17751,179,52,-833,-1021,17.9,1553.6,13,2,0,6,5,6,1,0,1,0,16369,7.2,18772,240,60,833,1021,24.0,1636.9
4524545264,0,24,3,0,3,10,2,0,0,0,0,14796,6.4,16448,204,53,-3385,-2980,20.4,1479.6,15,3,1,10,3,10,2,1,1,0,18181,7.4,19428,223,56,3385,2980,22.3,1818.1
4463523266,1,16,3,1,11,7,14,0,0,0,0,19379,7.0,18120,215,40,3021,347,21.5,1937.9,15,3,0,7,11,8,0,0,0,0,16358,6.8,17773,186,52,-3021,-347,18.6,1635.8
4475587548,1,19,3,1,6,2,5,1,1,0,0,16948,6.8,18641,241,52,2711,1821,24.1,1694.8,19,7,0,2,6,0,0,0,0,0,14237,6.4,16820,223,52,-2711,-1821,22.3,1423.7
4521225915,0,15,1,0,1,9,1,1,0,1,0,14055,6.8,17109,204,48,-3872,-3173,20.4,1405.5,18,4,1,9,1,9,0,0,0,0,17927,7.6,20282,214,48,3872,3173,21.4,1792.7
4525625887,0,15,3,0,3,5,2,0,0,0,0,15001,6.8,18001,206,65,-1787,-608,20.6,1500.1,60,1,1,5,3,8,1,1,0,0,16788,7.0,18609,257,62,1787,608,25.7,1678.8
4457658840,0,16,2,0,3,7,5,0,0,0,0,15442,6.6,17224,237,47,-2109,-1475,23.7,1544.2,20,4,1,7,3,10,1,1,0,0,17551,7.2,18699,233,50,2109,1475,23.3,1755.1
4519014512,0,15,3,1,6,5,8,2,1,1,0,16997,6.8,17893,215,46,639,-401,21.5,1699.7,15,2,0,5,6,6,0,0,0,0,16358,6.8,18294,220,58,-639,401,22.0,1635.8
4459553176,0,19,2,0,8,8,9,1,1,0,0,16352,6.8,17749,214,36,-730,58,21.4,1635.2,11,6,1,8,8,10,0,0,0,0,17082,7.0,17691,191,50,730,-58,19.1,1708.2
4489773127,0,13,2,1,5,9,6,0,0,0,0,15061,6.4,16082,203,44,-1805,-2303,20.3,1506.1,18,2,0,9,5,8,1,1,0,0,16866,7.0,18385,201,49,1805,2303,20.1,1686.6
4494926014,0,16,1,0,3,8,3,0,0,0,0,14397,6.6,16267,210,52,-3517,-3374,21.0,1439.7,14,2,1,8,3,9,1,1,0,0,17914,7.2,19641,226,64,3517,3374,22.6,1791.4
4450597950,0,41,3,0,11,6,11,2,1,1,0,18185,7.4,19645,204,55,2363,2162,20.4,1818.5,19,2,1,6,11,7,0,0,0,0,15822,7.0,17483,204,44,-2363,-2162,20.4,1582.2
4524502451,1,16,3,1,4,4,3,1,1,0,0,15620,7.0,17974,225,52,234,-318,22.5,1562.0,89,2,0,4,4,4,0,0,0,0,15386,7.0,18292,227,40,-234,318,22.7,1538.6
4524576336,1,47,3,0,10,8,12,1,1,0,0,17342,7.0,17885,179,48,-447,-955,17.9,1734.2,13,0,1,8,10,5,0,0,0,0,17789,7.2,18840,206,44,447,955,20.6,1778.9
4517783802,0,12,0,1,3,11,5,0,0,0,0,14145,6.0,15252,186,40,-5471,-4481,18.6,1414.5,11,1,0,11,3,10,2,1,1,1,19616,7.6,19733,228,57,5471,4481,22.8,1961.6
4526633001,0,17,1,1,4,2,3,0,0,0,0,16177,7.0,18367,226,56,1255,277,22.6,1617.7,15,3,0,2,4,1,0,0,0,0,14922,6.8,18090,253,45,-1255,-277,25.3,1492.2
4503773782,1,39,2,1,4,4,5,1,1,0,0,15736,7.2,18719,231,56,131,1381,23.1,1573.6,15,0,0,4,4,4,0,0,0,0,15605,7.0,17338,246,43,-131,-1381,24.6,1560.5
4506913159,1,43,2,0,10,6,17,1,1,0,0,18751,7.2,19155,232,52,1520,1168,23.2,1875.1,15,5,1,6,10,8,0,0,0,0,17231,6.8,17987,232,51,-1520,-1168,23.2,1723.1
4446215269,0,11,2,0,5,12,4,0,0,0,0,16154,6.8,18081,216,44,-2129,-2255,21.6,1615.4,25,2,1,12,5,12,0,0,0,0,18283,7.4,20336,206,72,2129,2255,20.6,1828.3
4519790060,1,25,0,0,11,10,7,1,1,0,0,19061,7.2,19093,236,50,1362,1592,23.6,1906.1,86,0,1,10,11,11,0,0,0,0,17699,6.8,17501,191,46,-1362,-1592,19.1,1769.9
4511051956,0,18,3,1,5,5,4,0,0,0,0,16864,7.0,18195,247,51,874,-554,24.7,1686.4,17,2,0,5,5,5,2,1,1,0,15990,7.2,18749,232,56,-874,554,23.2,1599.0
4527873286,1,17,2,1,7,4,5,1,1,0,0,17765,7.2,18967,211,69,2519,2469,21.1,1776.5,46,3,0,4,7,7,0,0,0,0,15246,6.8,16498,229,34,-2519,-2469,22.9,1524.6
4519728493,1,18,2,1,10,4,13,1,0,1,0,17902,7.2,18882,186,50,2224,2062,18.6,1790.2,15,2,0,4,10,7,1,1,0,0,15678,6.6,16820,208,44,-2224,-2062,20.8,1567.8
4521124599,1,14,3,1,6,4,9,2,1,1,0,16972,7.4,19577,218,55,752,344,21.8,1697.2,15,1,0,4,6,3,0,0,0,0,16220,7.2,19233,247,68,-752,-344,24.7,1622.0
4498407529,1,11,2,0,5,7,3,0,0,0,0,14439,6.4,16062,171,35,-3435,-1632,17.1,1443.9,15,2,1,7,5,6,1,1,0,0,17874,6.8,17694,230,68,3435,1632,23.0,1787.4
4481449658,1,11,7,0,4,3,3,1,1,0,0,15800,7.0,18316,244,58,1344,1628,24.4,1580.0,16,2,1,3,4,1,0,0,0,0,14456,6.6,16688,210,37,-1344,-1628,21.0,1445.6
4500913253,1,34,2,1,10,10,12,0,0,0,0,18152,7.0,18364,196,56,-973,-2396,19.6,1815.2,15,2,0,10,10,10,0,0,0,0,19125,7.4,20760,238,68,973,2396,23.8,1912.5
4524493753,0,12,5,1,5,3,5,0,0,0,0,15827,6.8,17668,212,52,443,-1437,21.2,1582.7,38,1,0,3,5,4,1,1,0,0,15384,7.2,19105,232,59,-443,1437,23.2,1538.4
4452642610,0,14,1,1,9,4,9,0,0,0,0,18751,7.2,20236,249,58,4671,4193,24.9,1875.1,36,1,0,4,9,5,1,1,0,0,14080,6.6,16043,177,57,-4671,-4193,17.7,1408.0
4468070903,1,18,3,1,5,4,5,0,0,0,0,15938,6.8,17167,200,41,673,-64,20.0,1593.8,17,2,0,4,5,3,1,0,1,0,15265,6.6,17231,210,50,-673,64,21.0,1526.5
4522097208,0,15,2,1,6,3,7,1,1,0,0,16067,6.4,16652,218,42,841,-1456,21.8,1606.7,18,5,0,3,6,1,0,0,0,0,15226,7.0,18108,246,53,-841,1456,24.6,1522.6
4515529388,1,14,2,0,7,5,6,1,1,0,0,15866,6.8,17452,176,59,394,-55,17.6,1586.6,14,2,1,5,7,4,0,0,0,0,15472,6.8,17507,216,45,-394,55,21.6,1547.2
4518849828,1,13,1,1,7,4,6,2,1,1,0,17237,7.2,18352,196,56,1346,849,19.6,1723.7,17,2,0,4,7,3,0,0,0,0,15891,6.8,17503,241,45,-1346,-849,24.1,1589.1
4523592716,0,14,2,0,1,9,2,1,1,0,0,14041,6.6,16529,229,49,-4377,-4323,22.9,1404.1,16,3,1,9,1,5,0,0,0,0,18418,7.4,20852,234,79,4377,4323,23.4,1841.8
4526974346,0,15,3,0,4,7,4,1,0,1,0,16938,7.2,18931,248,60,-377,414,24.8,1693.8,16,2,1,7,4,11,1,1,0,0,17315,7.2,18517,224,56,377,-414,22.4,1731.5
4505466847,0,42,3,0,3,4,4,0,0,0,0,14923,7.0,17661,229,48,-1899,-2290,22.9,1492.3,51,2,1,4,3,4,0,0,0,0,16822,7.2,19951,244,64,1899,2290,24.4,1682.2
4515910414,0,15,3,1,11,10,10,1,0,1,0,18145,7.2,18705,211,40,-139,-652,21.1,1814.5,14,3,0,10,11,8,1,1,0,0,18284,7.2,19357,236,50,139,652,23.6,1828.4
4517889470,0,14,2,0,4,7,4,1,0,1,0,17147,6.8,17894,213,53,946,-439,21.3,1714.7,15,3,1,7,4,9,1,1,0,0,16201,7.0,18333,222,44,-946,439,22.2,1620.1
4475027319,1,19,2,0,10,4,12,1,1,0,0,18491,7.2,19416,237,55,3517,2881,23.7,1849.1,13,4,1,4,10,4,0,0,0,0,14974,6.8,16535,211,48,-3517,-2881,21.1,1497.4
4520841378,1,13,3,0,4,7,3,1,1,0,0,16055,6.8,17933,227,55,93,1195,22.7,1605.5,15,1,1,7,4,9,0,0,0,0,15962,6.8,16738,214,36,-93,-1195,21.4,1596.2
4515256232,0,16,1,1,4,10,5,0,0,0,0,15684,6.6,17047,240,44,-2797,-2649,24.0,1568.4,14,3,0,10,4,9,1,1,0,0,18481,7.4,19696,220,66,2797,2649,22.0,1848.1
4515259819,1,137,1,0,0,3,0,1,1,0,0,13610,6.6,16594,199,46,-1817,-1854,19.9,1361.0,18,2,1,3,0,1,0,0,0,0,15427,7.0,18448,238,53,1817,1854,23.8,1542.7
4452033938,0,16,3,0,3,2,3,1,0,1,0,15028,6.8,18170,212,52,147,1258,21.2,1502.8,17,5,1,2,3,5,1,1,0,0,14881,6.8,16912,231,52,-147,-1258,23.1,1488.1
4518314539,0,15,2,0,1,6,0,0,0,0,0,13881,6.8,16550,209,47,-2973,-1940,20.9,1388.1,15,2,1,6,1,13,1,1,0,0,16854,7.0,18490,222,56,2973,1940,22.2,1685.4
4515360430,1,15,1,1,5,3,2,2,1,1,0,16243,7.4,19006,245,59,855,2880,24.5,1624.3,17,3,0,3,5,4,0,0,0,0,15388,6.4,16126,204,50,-855,-2880,20.4,1538.8
4518540865,1,12,3,1,12,7,13,0,0,0,0,19049,7.6,20348,225,48,2900,2308,22.5,1904.9,14,1,0,7,12,5,1,1,0,0,16149,6.8,18040,172,52,-2900,-2308,17.2,1614.9
4483263508,0,80,1,0,1,7,1,0,0,0,0,14400,6.4,16399,215,43,-2884,-3321,21.5,1440.0,35,0,1,7,1,5,1,1,0,0,17284,7.2,19720,239,66,2884,3321,23.9,1728.4
4515711372,0,15,0,1,5,9,3,0,0,0,0,15144,6.6,16696,205,36,-4172,-2185,20.5,1514.4,15,4,0,9,5,9,0,0,0,1,19316,7.2,18881,221,47,4172,2185,22.1,1931.6
4442297652,0,11,4,0,5,9,5,0,0,0,0,15192,6.6,16557,198,44,-3240,-2369,19.8,1519.2,22,2,1,9,5,18,0,0,0,0,18432,7.2,18926,252,52,3240,2369,25.2,1843.2
4524303948,0,39,1,0,7,6,7,0,0,0,0,15551,6.4,15956,176,42,-259,-576,17.6,1555.1,14,2,1,6,7,6,0,0,0,0,15810,6.6,16532,173,49,259,576,17.3,1581.0
4523035934,1,17,4,0,6,6,6,0,0,0,0,16936,7.2,18646,240,56,272,359,24.0,1693.6,56,2,1,6,6,7,1,1,0,0,16664,6.8,18287,199,68,-272,-359,19.9,1666.4
4511928610,0,16,3,1,5,9,4,0,0,0,0,14987,6.6,15728,199,43,-1913,-1233,19.9,1498.7,15,3,0,9,5,16,1,1,0,0,16900,6.6,16961,202,44,1913,1233,20.2,1690.0
4503433606,1,10,2,0,4,11,2,0,0,0,0,15602,6.6,17116,216,38,-2082,-527,21.6,1560.2,45,2,1,11,4,13,1,1,0,0,17684,6.8,17643,199,44,2082,527,19.9,1768.4
4524787194,0,43,0,0,1,4,0,0,0,0,0,13046,6.2,15452,197,41,-2264,-964,19.7,1304.6,15,6,1,4,1,2,0,0,0,0,15310,6.6,16416,222,44,2264,964,22.2,1531.0
4489864950,0,18,6,1,11,5,10,2,1,1,0,17962,7.0,17698,191,48,3367,1963,19.1,1796.2,19,2,0,5,11,6,0,0,0,0,14595,6.4,15735,185,24,-3367,-1963,18.5,1459.5
4511176249,1,49,1,1,5,4,6,0,0,0,0,14991,6.8,17977,193,43,-274,-406,19.3,1499.1,17,3,0,4,5,3,1,1,0,0,15265,7.0,18383,217,56,274,406,21.7,1526.5
4526832160,1,15,2,1,6,7,8,0,0,0,0,15909,6.8,16835,203,44,-3179,-2074,20.3,1590.9,15,1,0,7,6,9,1,0,1,2,19088,7.0,18909,253,41,3179,2074,25.3,1908.8
4515517372,1,17,5,0,2,2,2,0,0,0,0,15423,6.8,18333,227,60,699,753,22.7,1542.3,16,2,1,2,2,3,1,1,0,0,14724,6.8,17580,232,46,-699,-753,23.2,1472.4
4525584889,1,15,2,1,4,6,2,0,0,0,0,15729,7.0,18102,205,60,-448,-163,20.5,1572.9,15,4,0,6,4,6,1,1,0,0,16177,7.0,18265,232,43,448,163,23.2,1617.7
4524620492,0,18,0,0,5,8,5,0,0,0,0,16045,7.0,17324,208,55,-215,-165,20.8,1604.5,12,3,1,8,5,6,1,1,0,0,16260,7.0,17489,216,48,215,165,21.6,1626.0
4522477887,0,21,2,1,11,11,13,0,0,0,0,18878,6.8,18276,222,48,1212,-257,22.2,1887.8,18,2,0,11,11,8,0,0,0,0,17666,7.0,18533,212,40,-1212,257,21.2,1766.6
4512800157,1,17,5,1,10,9,9,1,1,0,0,18531,7.2,18550,217,44,1492,-676,21.7,1853.1,19,7,0,9,10,4,0,0,0,0,17039,7.0,19226,214,56,-1492,676,21.4,1703.9
4508492240,0,18,5,1,8,3,9,1,1,0,0,17073,6.8,16988,195,60,2939,993,19.5,1707.3,15,3,0,3,8,3,0,0,0,0,14134,6.6,15995,197,44,-2939,-993,19.7,1413.4
4456927812,1,17,1,1,8,1,9,1,1,0,0,18177,7.4,19922,256,48,3710,2326,25.6,1817.7,16,2,0,1,8,2,0,0,0,0,14467,7.0,17596,226,58,-3710,-2326,22.6,1446.7
4500739258,0,16,1,0,3,4,3,0,0,0,0,14494,6.4,15922,224,41,-1610,-1393,22.4,1449.4,15,3,1,4,3,2,1,1,0,0,16104,6.8,17315,239,53,1610,1393,23.9,1610.4
4524434375,1,38,4,0,9,9,14,1,1,0,0,17630,7.0,18364,230,50,13,2012,23.0,1763.0,15,2,1,9,9,10,0,0,0,0,17617,6.4,16352,165,42,-13,-2012,16.5,1761.7
4508820253,1,16,3,1,6,4,2,1,1,0,0,16027,7.0,18775,231,52,276,-106,23.1,1602.7,13,0,0,4,6,4,0,0,0,0,15751,7.2,18881,239,56,-276,106,23.9,1575.1
4514309643,0,16,4,0,5,7,6,0,0,0,0,15337,6.6,16528,198,39,-646,-148,19.8,1533.7,17,3,1,7,5,9,0,0,0,0,15983,6.6,16676,197,36,646,148,19.7,1598.3
4508769864,0,50,4,0,5,2,7,2,1,1,0,16444,7.4,18995,229,63,1415,1951,22.9,1644.4,16,3,1,2,5,3,0,0,0,0,15029,6.8,17044,225,53,-1415,-1951,22.5,1502.9
4497469413,1,16,1,0,8,6,8,0,0,0,0,16963,6.8,17360,203,56,1479,1002,20.3,1696.3,15,2,1,6,8,10,1,1,0,0,15484,6.6,16358,173,56,-1479,-1002,17.3,1548.4
4497834161,1,20,0,1,10,5,8,1,1,0,1,17979,7.0,17675,194,48,3112,535,19.4,1797.9,16,1,0,5,10,2,0,0,0,0,14867,6.4,17140,189,52,-3112,-535,18.9,1486.7
4527674741,0,17,5,1,3,3,5,1,0,1,0,15079,6.6,15930,212,44,607,-1168,21.2,1507.9,55,3,0,3,3,5,1,1,0,0,14472,6.8,17098,210,38,-607,1168,21.0,1447.2
4420435152,0,14,0,0,1,11,0,0,0,0,0,13511,6.6,16013,200,46,-5087,-2795,20.0,1351.1,117,0,1,11,1,18,0,0,0,0,18598,7.2,18808,226,55,5087,2795,22.6,1859.8
4511030012,1,18,2,1,8,4,9,0,0,0,0,17917,6.8,17609,239,33,2992,258,23.9,1791.7,15,2,0,4,8,3,0,0,0,0,14925,6.8,17351,205,44,-2992,-258,20.5,1492.5
4487935586,0,43,0,0,4,6,4,0,0,0,0,14844,7.0,17089,187,51,-933,-636,18.7,1484.4,18,2,1,6,4,6,1,0,1,0,15777,7.0,17725,217,31,933,636,21.7,1577.7
4445294621,0,13,1,0,4,13,5,0,0,0,0,15878,6.8,16945,203,43,-2835,-2821,20.3,1587.8,15,3,1,13,4,14,1,1,0,0,18713,7.2,19766,209,45,2835,2821,20.9,1871.3
4497605485,1,23,4,0,3,5,2,1,1,0,0,15213,6.8,17861,252,47,-388,-325,25.2,1521.3,17,4,1,5,3,3,0,0,0,0,15601,7.0,18186,209,62,388,325,20.9,1560.1
4526104672,1,21,4,1,8,4,8,2,1,1,0,18230,7.4,20125,246,65,2627,1759,24.6,1823.0,17,6,0,4,8,4,0,0,0,0,15603,7.0,18366,241,52,-2627,-1759,24.1,1560.3
4513996246,0,20,1,0,6,2,7,1,1,0,0,15949,6.6,17392,198,42,919,-36,19.8,1594.9,13,1,1,2,6,2,0,0,0,0,15030,6.8,17428,211,57,-919,36,21.1,1503.0
4511245334,0,36,1,1,2,7,5,0,0,0,0,14766,6.8,16685,236,47,-1174,-1478,23.6,1476.6,43,0,0,7,2,7,1,1,0,0,15940,7.0,18163,190,64,1174,1478,19.0,1594.0
4508312193,1,16,4,0,2,5,2,1,1,0,0,15103,7.0,18559,246,66,-1761,-881,24.6,1510.3,18,2,1,5,2,6,1,0,1,0,16864,7.4,19440,268,52,1761,881,26.8,1686.4
4512968570,1,18,5,1,4,2,5,1,1,0,0,15704,6.8,18292,236,58,1012,519,23.6,1570.4,18,6,0,2,4,0,0,0,0,0,14692,7.0,17773,234,63,-1012,-519,23.4,1469.2
4417362254,0,13,2,1,5,4,5,1,0,1,0,17564,7.4,20203,257,73,1369,1440,25.7,1756.4,19,4,0,4,5,5,1,1,0,0,16195,7.2,18763,233,43,-1369,-1440,23.3,1619.5
4498469396,1,14,3,1,6,7,6,1,1,0,0,16398,7.2,17998,217,47,-940,-1019,21.7,1639.8,37,2,0,7,6,9,0,0,0,0,17338,7.0,19017,220,56,940,1019,22.0,1733.8
4498876812,0,16,0,0,3,10,1,0,0,0,0,14689,6.6,16533,195,52,-3089,-2151,19.5,1468.9,14,2,1,10,3,16,1,1,0,0,17778,7.0,18684,219,48,3089,2151,21.9,1777.8
4523328817,0,18,4,1,5,7,8,2,1,1,0,15674,6.6,17096,215,52,-622,59,21.5,1567.4,18,6,0,7,5,8,0,0,0,0,16296,6.8,17037,189,35,622,-59,18.9,1629.6
4518516978,1,16,1,1,16,0,17,1,1,0,0,20603,7.4,20443,245,44,7873,5225,24.5,2060.3,12,1,0,0,16,0,0,0,0,0,12730,6.6,15218,188,44,-7873,-5225,18.8,1273.0
4485633247,1,14,0,1,8,5,7,1,1,0,0,17981,7.2,19233,245,64,2565,1634,24.5,1798.1,14,1,0,5,8,3,0,0,0,0,15416,6.6,17599,199,48,-2565,-1634,19.9,1541.6
4525939080,1,15,3,0,10,7,12,0,0,0,0,17892,7.0,18432,197,52,1017,547,19.7,1789.2,15,2,1,7,10,7,1,1,0,0,16875,7.0,17885,201,48,-1017,-547,20.1,1687.5
4493375568,1,14,1,1,6,4,5,0,0,0,0,16600,7.0,18970,208,60,735,161,20.8,1660.0,14,1,0,4,6,0,1,1,0,0,15865,7.2,18809,252,64,-735,-161,25.2,1586.5
4515247521,1,14,5,1,11,6,5,1,1,0,0,17943,6.8,18261,220,60,1493,33,22.0,1794.3,17,1,0,6,11,2,0,0,0,0,16450,7.0,18228,197,60,-1493,-33,19.7,1645.0
4440210667,0,15,2,1,2,7,1,0,0,0,0,14624,6.8,17333,225,44,-2794,-2624,22.5,1462.4,39,5,0,7,2,13,0,0,0,0,17418,7.4,19957,231,60,2794,2624,23.1,1741.8
4475734964,1,35,4,1,10,5,14,2,1,1,0,18009,7.2,18763,200,55,2911,1378,20.0,1800.9,15,3,0,5,10,5,0,0,0,0,15098,6.8,17385,212,52,-2911,-1378,21.2,1509.8
4496156643,0,15,1,1,6,3,7,0,0,0,0,15721,6.8,17191,180,47,-24,-1070,18.0,1572.1,24,4,0,3,6,4,0,0,0,0,15745,7.0,18261,238,45,24,1070,23.8,1574.5
4526405624,0,16,0,1,10,8,12,1,1,0,0,17281,7.0,17509,203,39,-1125,-1326,20.3,1728.1,13,1,0,8,10,6,1,0,1,1,18406,7.0,18835,229,40,1125,1326,22.9,1840.6
4509689834,1,12,2,0,7,1,8,1,1,0,0,17056,7.0,18608,232,51,3515,2156,23.2,1705.6,14,0,1,1,7,1,1,0,1,0,13541,6.6,16452,208,49,-3515,-2156,20.8,1354.1
4499235579,0,15,2,0,4,7,5,1,1,0,0,14717,6.4,16410,205,38,-3025,-1823,20.5,1471.7,21,3,1,7,4,5,1,0,1,1,17742,7.0,18233,211,41,3025,1823,21.1,1774.2
4512604685,0,18,0,1,4,16,5,0,0,0,0,14366,6.0,14866,171,30,-5395,-5287,17.1,1436.6,51,3,0,16,4,18,2,1,1,0,19761,7.4,20153,217,42,5395,5287,21.7,1976.1
4523046488,0,14,4,0,7,3,10,1,1,0,0,16657,7.0,18425,231,43,1131,1518,23.1,1665.7,15,4,1,3,7,3,0,0,0,0,15526,6.6,16907,233,60,-1131,-1518,23.3,1552.6
4512957425,0,88,2,1,2,2,2,1,0,1,0,14505,7.0,18312,224,48,-838,-593,22.4,1450.5,15,6,0,2,2,1,1,1,0,0,15343,7.2,18905,253,67,838,593,25.3,1534.3
4521838243,0,19,1,0,9,10,12,1,1,0,0,17063,7.2,18195,200,44,-1220,-203,20.0,1706.3,18,3,1,10,9,13,0,0,0,0,18283,7.2,18398,217,43,1220,203,21.7,1828.3
4515360934,1,14,7,1,8,6,12,1,1,0,0,17357,7.0,18244,222,48,1031,829,22.2,1735.7,16,2,0,6,8,10,1,0,1,0,16326,6.8,17415,208,36,-1031,-829,20.8,1632.6
4514601877,1,41,5,1,4,2,5,1,1,0,0,15770,7.0,17426,229,60,669,-483,22.9,1577.0,20,2,0,2,4,1,0,0,0,0,15101,7.0,17909,261,43,-669,483,26.1,1510.1
4526044694,1,14,4,0,3,3,3,0,0,0,0,16002,7.2,19380,230,64,787,1089,23.0,1600.2,15,1,1,3,3,2,1,1,0,0,15215,7.2,18291,231,60,-787,-1089,23.1,1521.5
4510904711,0,10,0,1,8,8,6,1,0,1,0,16830,7.0,18264,203,48,257,1183,20.3,1683.0,29,1,0,8,8,9,1,1,0,0,16573,7.0,17081,180,56,-257,-1183,18.0,1657.3
4472271945,0,89,3,0,2,8,2,0,0,0,0,14370,6.4,16473,228,48,-3180,-3196,22.8,1437.0,16,3,1,8,2,8,1,1,0,0,17550,7.6,19669,211,53,3180,3196,21.1,1755.0
4527589405,1,31,1,1,11,9,11,1,1,0,0,18464,7.0,18681,234,54,1259,1454,23.4,1846.4,17,1,0,9,11,10,0,0,0,0,17205,6.8,17227,192,47,-1259,-1454,19.2,1720.5
4499628579,0,17,4,1,6,9,6,0,0,0,0,15487,6.0,14798,187,36,-1796,-2222,18.7,1548.7,17,4,0,9,6,7,0,0,0,0,17283,6.8,17020,213,40,1796,2222,21.3,1728.3
4451962379,0,82,3,0,2,10,1,0,0,0,0,14675,6.8,17184,207,44,-3911,-2728,20.7,1467.5,15,1,1,10,2,10,2,1,1,0,18586,7.4,19912,254,40,3911,2728,25.4,1858.6
4438426870,0,18,0,0,6,7,2,0,0,0,0,15141,6.8,17975,196,33,-770,196,19.6,1514.1,17,2,1,7,6,10,1,1,0,0,15911,6.8,17779,178,40,770,-196,17.8,1591.1
4523992851,0,15,1,1,4,6,4,0,0,0,0,15865,7.0,18437,238,59,-418,34,23.8,1586.5,15,2,0,6,4,8,1,1,0,0,16283,7.0,18403,231,52,418,-34,23.1,1628.3
4514151915,0,15,3,0,8,6,9,1,1,0,0,16511,7.0,18106,199,48,300,1722,19.9,1651.1,17,0,1,6,8,7,0,0,0,0,16211,6.6,16384,225,44,-300,-1722,22.5,1621.1
4520990102,1,33,2,1,6,4,5,1,1,0,0,17327,7.4,19938,240,68,2060,1621,24.0,1732.7,19,4,0,4,6,2,0,0,0,0,15267,7.0,18317,226,48,-2060,-1621,22.6,1526.7
4520919497,0,12,3,0,8,8,8,1,1,0,0,16028,6.6,16233,187,36,-728,-608,18.7,1602.8,16,0,1,8,8,7,0,0,0,0,16756,6.8,16841,184,43,728,608,18.4,1675.6
4454170468,0,18,0,1,8,5,7,1,1,0,0,17727,7.2,18993,217,64,1521,1915,21.7,1772.7,11,2,0,5,8,7,1,0,1,0,16206,6.8,17078,198,60,-1521,-1915,19.8,1620.6
4516210841,1,15,3,1,9,6,17,1,1,0,0,18249,7.0,18327,222,57,1909,-108,22.2,1824.9,22,2,0,6,9,10,0,0,0,0,16340,7.0,18435,231,34,-1909,108,23.1,1634.0
4515536584,0,16,3,1,4,4,4,1,0,1,0,15420,6.6,16188,185,61,-634,-1526,18.5,1542.0,21,3,0,4,4,4,1,1,0,0,16054,6.8,17714,236,52,634,1526,23.6,1605.4
4522214427,0,44,3,0,4,6,2,1,1,0,0,15044,7.0,17888,214,48,-2127,-997,21.4,1504.4,33,5,1,6,4,8,0,0,0,0,17171,7.2,18885,228,59,2127,997,22.8,1717.1
4501853954,1,13,18,1,8,2,8,0,0,0,0,17263,7.0,18277,222,41,2622,1080,22.2,1726.3,37,1,0,2,8,0,1,1,0,0,14641,6.8,17197,212,54,-2622,-1080,21.2,1464.1
4494508204,1,46,3,1,8,3,9,2,1,1,0,17226,7.2,18458,193,59,2061,1693,19.3,1722.6,17,5,0,3,8,5,0,0,0,0,15165,6.4,16765,220,43,-2061,-1693,22.0,1516.5
4475781870,0,19,4,0,3,5,3,0,0,0,0,15242,7.2,17856,216,44,-774,334,21.6,1524.2,33,0,1,5,3,4,0,0,0,0,16016,6.8,17522,243,45,774,-334,24.3,1601.6
4524125619,0,21,1,0,5,5,4,0,0,0,0,15068,6.8,17487,203,45,-321,272,20.3,1506.8,17,5,1,5,5,5,2,1,1,0,15389,6.6,17215,211,45,321,-272,21.1,1538.9
4527284987,1,17,2,1,6,3,7,1,1,0,1,17780,7.2,18440,221,48,3170,2080,22.1,1778.0,12,2,0,3,6,4,0,0,0,0,14610,6.4,16360,213,41,-3170,-2080,21.3,1461.0
4523645725,1,15,3,0,3,6,3,0,0,0,0,15736,6.8,18798,232,72,-259,555,23.2,1573.6,15,2,1,6,3,5,2,1,1,0,15995,6.8,18243,220,48,259,-555,22.0,1599.5
4493865570,1,13,1,1,4,1,3,2,1,1,0,17220,7.4,19745,233,52,3373,2086,23.3,1722.0,13,0,0,1,4,0,0,0,0,0,13847,7.0,17659,225,51,-3373,-2086,22.5,1384.7
4521774958,1,22,1,0,3,7,2,1,0,1,0,15932,6.8,17831,238,48,-1111,679,23.8,1593.2,8,1,1,7,3,7,1,1,0,0,17043,6.8,17152,191,44,1111,-679,19.1,1704.3
4525979085,0,15,2,1,8,6,10,1,0,1,0,17237,6.6,17508,226,40,1932,168,22.6,1723.7,16,0,0,6,8,3,1,1,0,0,15305,6.8,17340,182,48,-1932,-168,18.2,1530.5
4519287844,1,37,3,1,5,1,11,2,1,1,0,16506,7.0,17981,213,52,2663,864,21.3,1650.6,16,2,0,1,5,0,0,0,0,0,13843,6.6,17117,224,46,-2663,-864,22.4,1384.3
4464495832,1,203,2,1,6,7,12,1,1,0,0,17397,7.0,18389,235,48,751,615,23.5,1739.7,11,2,0,7,6,11,0,0,0,0,16646,6.8,17774,210,48,-751,-615,21.0,1664.6
4448303779,1,38,3,1,10,2,10,1,0,1,0,18822,7.2,20135,253,59,4577,3717,25.3,1882.2,17,3,0,2,10,2,1,1,0,0,14245,6.6,16418,192,48,-4577,-3717,19.2,1424.5
4495003373,0,22,4,0,5,7,3,1,0,1,0,15475,7.0,18145,198,59,-810,-305,19.8,1547.5,13,5,1,7,5,11,1,1,0,0,16285,7.0,18450,212,52,810,305,21.2,1628.5
4522238390,0,52,2,0,9,4,8,0,0,0,0,17991,7.4,20130,219,59,1350,2355,21.9,1799.1,13,1,1,4,9,6,2,1,1,1,16641,6.8,17775,208,49,-1350,-2355,20.8,1664.1
4496136877,0,15,3,0,3,3,6,1,1,0,0,16042,7.2,19220,255,72,580,709,25.5,1604.2,20,2,1,3,3,2,1,0,1,0,15462,7.0,18511,231,51,-580,-709,23.1,1546.2
4526830750,1,19,3,0,7,6,12,1,1,0,0,17737,7.0,18873,220,48,1126,549,22.0,1773.7,51,0,1,6,7,10,0,0,0,0,16611,7.2,18324,228,55,-1126,-549,22.8,1661.1
4520790076,1,19,5,1,6,2,9,1,1,0,0,16737,6.8,17593,243,44,2423,295,24.3,1673.7,19,1,0,2,6,2,1,0,1,0,14314,6.8,17298,232,52,-2423,-295,23.2,1431.4
4523862114,1,22,3,0,7,2,4,1,1,0,0,16031,6.8,17458,218,55,1643,882,21.8,1603.1,21,3,1,2,7,0,0,0,0,0,14388,6.6,16576,225,48,-1643,-882,22.5,1438.8
4524796098,0,41,3,1,2,3,0,0,0,0,0,14312,6.8,17694,216,52,-980,-684,21.6,1431.2,17,3,0,3,2,0,0,0,0,0,15292,7.0,18378,236,52,980,684,23.6,1529.2
4504683209,0,16,1,1,7,6,9,1,1,0,0,17844,7.2,18825,232,56,1037,111,23.2,1784.4,12,2,0,6,7,5,0,0,0,0,16807,7.2,18714,243,55,-1037,-111,24.3,1680.7
4520510756,0,18,2,0,6,5,6,0,0,0,0,15566,6.8,17340,211,52,-1951,-872,21.1,1556.6,12,4,1,5,6,6,1,1,0,0,17517,7.2,18212,233,68,1951,872,23.3,1751.7
4524281018,0,17,3,1,3,2,3,2,1,1,0,15207,7.0,18559,234,54,-211,843,23.4,1520.7,19,4,0,2,3,4,0,0,0,0,15418,7.0,17716,211,48,211,-843,21.1,1541.8
4526060339,0,16,4,1,10,7,12,2,1,1,0,16677,6.6,15835,168,56,-503,-790,16.8,1667.7,17,2,0,7,10,10,0,0,0,0,17180,6.6,16625,191,50,503,790,19.1,1718.0
4483926766,1,15,4,0,5,10,5,1,0,1,0,14982,6.6,15862,171,48,-2690,-743,17.1,1498.2,81,5,1,10,5,14,0,0,0,0,17672,6.6,16605,187,36,2690,743,18.7,1767.2
4501013460,0,27,0,0,6,10,4,1,0,1,0,16171,7.0,17902,202,54,-1682,-71,20.2,1617.1,14,2,1,10,6,8,1,1,0,0,17853,7.0,17973,226,52,1682,71,22.6,1785.3
4516777697,1,14,0,1,9,7,7,0,0,0,0,17607,7.2,19309,212,50,716,601,21.2,1760.7,14,1,0,7,9,6,1,1,0,0,16891,7.2,18708,204,73,-716,-601,20.4,1689.1
4524150838,1,18,5,1,3,1,3,1,1,0,0,15928,7.4,19109,266,53,1468,1205,26.6,1592.8,37,3,0,1,3,2,0,0,0,0,14460,6.8,17904,228,68,-1468,-1205,22.8,1446.0
4518172684,0,31,1,1,3,4,4,1,0,1,1,17064,7.0,18451,263,52,1167,-1436,26.3,1706.4,15,1,0,4,3,5,1,1,0,0,15897,7.2,19887,214,72,-1167,1436,21.4,1589.7
4466191823,0,15,6,0,8,4,9,1,1,0,0,16804,7.2,18899,206,60,2290,1865,20.6,1680.4,10,2,1,4,8,2,0,0,0,0,14514,6.6,17034,180,40,-2290,-1865,18.0,1451.4
4496639955,0,14,3,1,6,6,7,1,1,0,0,16630,7.0,18540,225,48,253,-453,22.5,1663.0,15,3,0,6,6,3,0,0,0,0,16377,7.0,18993,213,56,-253,453,21.3,1637.7
4526899481,0,18,2,0,4,10,2,0,0,0,0,15777,6.6,18203,221,58,-2713,-1456,22.1,1577.7,20,6,1,10,4,12,1,1,0,0,18490,7.4,19659,219,65,2713,1456,21.9,1849.0
4494781192,1,16,3,0,9,7,13,2,1,1,0,17906,6.8,18001,178,60,510,142,17.8,1790.6,14,1,1,7,9,4,0,0,0,0,17396,6.8,17859,215,56,-510,-142,21.5,1739.6
4523501423,0,81,0,0,6,12,6,0,0,0,0,16020,6.8,17180,215,39,-2618,-2637,21.5,1602.0,15,3,1,12,6,7,0,0,0,0,18638,7.6,19817,212,52,2618,2637,21.2,1863.8
4518248972,0,15,4,1,4,6,7,0,0,0,0,15399,7.0,17209,217,47,-1589,-575,21.7,1539.9,18,3,0,6,4,11,1,1,0,0,16988,7.0,17784,210,48,1589,575,21.0,1698.8
4525028145,0,48,3,1,3,5,2,0,0,0,0,14349,6.6,16271,205,36,-1005,-251,20.5,1434.9,17,4,0,5,3,3,0,0,0,0,15354,6.4,16522,228,40,1005,251,22.8,1535.4
4525969441,1,17,4,0,4,3,1,1,1,0,0,15116,7.0,18375,228,64,-434,673,22.8,1511.6,18,7,1,3,4,4,0,0,0,0,15550,7.0,17702,246,53,434,-673,24.6,1555.0
4455643326,1,15,2,0,5,3,4,1,1,0,0,16093,7.2,19191,245,49,517,222,24.5,1609.3,14,4,1,3,5,1,0,0,0,0,15576,7.0,18969,213,78,-517,-222,21.3,1557.6
4492974122,0,18,4,1,5,4,6,0,0,0,0,16166,7.0,17990,198,47,180,-192,19.8,1616.6,18,4,0,4,5,2,1,1,0,0,15986,7.0,18182,212,80,-180,192,21.2,1598.6
4518870146,0,13,2,0,1,7,2,0,0,0,0,14490,7.0,17638,222,60,-2987,-2017,22.2,1449.0,14,4,1,7,1,10,1,1,0,0,17477,7.4,19655,235,56,2987,2017,23.5,1747.7
4496490767,0,16,2,0,2,4,3,0,0,0,0,15242,7.0,18202,260,56,-1497,-778,26.0,1524.2,17,2,1,4,2,9,1,0,1,0,16739,7.2,18980,257,52,1497,778,25.7,1673.9
4526305174,0,17,4,1,7,4,11,0,0,0,0,17308,7.2,18538,213,44,1589,-197,21.3,1730.8,16,3,0,4,7,1,2,1,1,0,15719,7.0,18735,232,70,-1589,197,23.2,1571.9
4463212406,1,91,3,0,7,5,5,1,1,0,0,16424,7.2,18793,217,56,-158,-688,21.7,1642.4,14,5,1,5,7,2,0,0,0,0,16582,7.2,19481,243,77,158,688,24.3,1658.2
4519298162,1,14,2,0,8,4,11,0,0,0,0,17726,7.2,18294,218,50,1654,1097,21.8,1772.6,10,4,1,4,8,5,0,0,0,0,16072,6.8,17197,219,48,-1654,-1097,21.9,1607.2
4522544095,0,13,3,0,4,10,5,0,0,0,0,16205,6.8,17509,234,52,-3102,-2025,23.4,1620.5,17,4,1,10,4,12,1,1,0,0,19307,7.4,19534,235,51,3102,2025,23.5,1930.7
4450404129,0,17,8,1,8,5,12,1,1,0,0,17551,6.6,17463,237,43,1763,-239,23.7,1755.1,20,4,0,5,8,6,0,0,0,0,15788,7.0,17702,213,45,-1763,239,21.3,1578.8
4524364516,1,46,3,0,10,6,11,0,0,0,0,18582,7.4,19549,222,51,2230,2112,22.2,1858.2,42,17,1,6,10,8,1,0,1,0,16352,6.8,17437,196,43,-2230,-2112,19.6,1635.2
4526855429,0,10,0,1,7,9,10,0,0,0,0,17447,7.0,17850,216,55,705,1616,21.6,1744.7,18,3,0,9,7,13,0,0,0,0,16742,6.6,16234,194,36,-705,-1616,19.4,1674.2
4518246910,1,17,0,0,10,3,5,1,1,0,0,18863,7.2,19070,228,68,4747,2924,22.8,1886.3,11,0,1,3,10,5,0,0,0,0,14116,6.6,16146,189,43,-4747,-2924,18.9,1411.6
4496622570,1,17,1,0,7,8,3,1,0,1,0,16653,7.0,17618,227,40,23,306,22.7,1665.3,12,1,1,8,7,8,0,0,0,0,16630,7.0,17312,193,48,-23,-306,19.3,1663.0
4506295504,0,13,2,0,3,6,1,1,1,0,0,14411,6.8,16806,210,54,-1864,-1945,21.0,1441.1,19,0,1,6,3,6,1,0,1,0,16275,7.2,18751,198,66,1864,1945,19.8,1627.5
4472103382,0,14,3,1,8,3,8,1,1,0,0,16378,6.8,16837,178,44,393,-1055,17.8,1637.8,16,2,0,3,8,3,0,0,0,0,15985,6.8,17892,227,56,-393,1055,22.7,1598.5
4517660206,1,39,2,1,2,3,2,1,1,0,0,15185,6.8,18437,231,70,-419,-428,23.1,1518.5,16,9,0,3,2,2,1,0,1,0,15604,7.0,18865,241,53,419,428,24.1,1560.4
4523513281,1,15,0,0,8,5,12,0,0,0,0,17327,7.0,18655,203,65,1568,611,20.3,1732.7,14,2,1,5,8,5,0,0,0,0,15759,7.0,18044,212,44,-1568,-611,21.2,1575.9
4520857294,0,38,3,0,4,7,3,0,0,0,0,16213,7.2,18890,208,68,-3035,188,20.8,1621.3,15,1,1,7,4,5,2,1,1,1,19248,7.0,18702,217,68,3035,-188,21.7,1924.8
4511152514,0,40,4,1,5,9,5,0,0,0,0,15184,6.2,15748,199,35,-2098,-1464,19.9,1518.4,18,7,0,9,5,9,2,1,1,0,17282,6.8,17212,220,50,2098,1464,22.0,1728.2
4468138311,0,14,3,0,4,13,1,0,0,0,0,14003,6.6,16419,195,24,-5945,-2122,19.5,1400.3,17,5,1,13,4,15,0,0,0,0,19948,7.0,18541,232,31,5945,2122,23.2,1994.8
4524695455,0,37,3,0,3,7,0,0,0,0,0,13967,7.0,16908,197,48,-2681,-834,19.7,1396.7,13,4,1,7,3,6,1,1,0,0,16648,6.6,17742,193,61,2681,834,19.3,1664.8
4458668503,0,15,2,1,2,7,2,0,0,0,0,14270,6.4,15513,215,39,-3519,-4275,21.5,1427.0,14,3,0,7,2,8,1,1,0,0,17789,7.4,19788,241,56,3519,4275,24.1,1778.9
4500075336,1,26,1,1,8,1,12,1,1,0,0,16974,7.2,18550,182,56,2906,2360,18.2,1697.4,10,3,0,1,8,1,0,0,0,0,14068,6.4,16190,201,48,-2906,-2360,20.1,1406.8
4427770144,1,13,0,0,7,5,5,0,0,0,0,17491,7.2,19044,251,60,2026,460,25.1,1749.1,11,2,1,5,7,3,1,0,1,0,15465,7.2,18584,189,73,-2026,-460,18.9,1546.5
4527505866,1,16,3,0,6,3,7,1,1,0,0,16079,6.6,17138,225,40,1769,1175,22.5,1607.9,18,1,1,3,6,5,0,0,0,0,14310,6.2,15963,185,53,-1769,-1175,18.5,1431.0
4427468467,1,13,4,0,5,2,5,1,1,0,0,15182,7.0,17949,205,44,246,759,20.5,1518.2,20,1,1,2,5,2,1,0,1,0,14936,7.0,17190,230,56,-246,-759,23.0,1493.6
4526750578,0,36,4,0,7,10,8,0,0,0,0,15265,6.0,14533,161,28,-2627,-2458,16.1,1526.5,18,2,1,10,7,16,0,0,0,0,17892,6.6,16991,218,37,2627,2458,21.8,1789.2
4468603101,1,17,4,0,9,4,6,1,0,1,1,19663,7.2,19052,247,48,4043,1803,24.7,1966.3,15,0,1,4,9,5,0,0,0,0,15620,6.8,17249,214,51,-4043,-1803,21.4,1562.0
4451375141,1,43,4,0,7,3,8,1,0,1,0,16463,6.8,17675,223,44,1305,1032,22.3,1646.3,14,6,1,3,7,3,0,0,0,0,15158,6.6,16643,244,48,-1305,-1032,24.4,1515.8
4524697287,1,17,4,1,6,6,5,1,0,1,0,17052,6.6,17392,210,54,1917,-179,21.0,1705.2,14,2,0,6,6,3,1,1,0,0,15135,7.0,17571,194,51,-1917,179,19.4,1513.5
4495729689,0,16,3,0,5,8,3,0,0,0,0,15967,6.4,16964,223,44,-1578,-598,22.3,1596.7,276,1,1,8,5,10,2,1,1,0,17545,7.0,17562,206,40,1578,598,20.6,1754.5
4526220423,0,39,4,0,4,8,5,0,0,0,0,15124,6.6,16323,185,50,-2588,-1355,18.5,1512.4,16,6,1,8,4,9,0,0,0,0,17712,6.8,17678,217,43,2588,1355,21.7,1771.2
4490790295,0,18,1,0,4,7,4,1,1,0,0,14562,6.2,15997,206,35,-1857,-1976,20.6,1456.2,17,4,1,7,4,6,0,0,0,0,16419,7.0,17973,214,53,1857,1976,21.4,1641.9
4496865743,0,16,3,0,3,15,3,0,0,0,0,14281,6.2,13851,183,28,-7666,-5484,18.3,1428.1,19,0,1,15,3,15,1,0,1,1,21947,7.2,19335,231,80,7666,5484,23.1,2194.7
4509102299,1,15,0,0,10,4,12,0,0,0,0,18480,7.4,19565,232,64,2547,2189,23.2,1848.0,12,1,1,4,10,4,0,0,0,0,15933,6.6,17376,247,41,-2547,-2189,24.7,1593.3
4515435281,0,12,1,0,4,5,5,0,0,0,0,14920,6.6,17571,186,45,-1670,-540,18.6,1492.0,12,2,1,5,4,1,2,1,1,0,16590,7.0,18111,233,56,1670,540,23.3,1659.0
4520844282,0,14,0,0,6,9,9,0,0,0,0,16240,7.2,18554,205,68,-2184,-1298,20.5,1624.0,85,1,1,9,6,9,1,1,0,0,18424,7.2,19852,250,56,2184,1298,25.0,1842.4
4512554804,0,18,1,0,5,9,5,0,0,0,0,15463,6.6,16939,206,44,-2791,-2246,20.6,1546.3,17,2,1,9,5,13,1,1,0,0,18254,7.4,19185,227,57,2791,2246,22.7,1825.4
4475174876,0,18,4,1,7,3,11,0,0,0,0,17320,7.0,18039,210,44,2199,459,21.0,1732.0,14,2,0,3,7,4,0,0,0,0,15121,6.8,17580,234,49,-2199,-459,23.4,1512.1
4523049172,1,22,2,1,3,4,1,0,0,0,0,15595,6.8,17779,241,64,65,-273,24.1,1559.5,12,2,0,4,3,4,1,1,0,0,15530,6.8,18052,228,57,-65,273,22.8,1553.0
4465119134,1,16,3,0,15,11,14,0,0,0,0,19767,6.6,17678,180,42,1915,2606,18.0,1976.7,15,3,1,11,15,11,0,0,0,0,17852,6.4,15072,176,41,-1915,-2606,17.6,1785.2
4446753486,1,16,5,0,6,8,8,1,1,0,0,15980,7.0,17313,207,48,-2565,-1593,20.7,1598.0,23,6,1,8,6,9,1,0,1,0,18545,7.0,18906,235,56,2565,1593,23.5,1854.5
4508822340,0,78,2,0,3,7,3,0,0,0,0,15623,7.0,17536,224,44,-1160,-592,22.4,1562.3,16,1,1,7,3,13,1,1,0,0,16783,7.2,18128,194,53,1160,592,19.4,1678.3
4506306912,1,16,4,1,7,5,7,1,1,0,0,17106,7.2,18424,231,48,450,-219,23.1,1710.6,17,6,0,5,7,5,1,0,1,0,16656,7.0,18643,241,62,-450,219,24.1,1665.6
4462226806,0,10,0,0,6,8,4,0,0,0,0,15446,6.4,16131,198,47,-1995,-1392,19.8,1544.6,13,0,1,8,6,7,1,1,0,0,17441,7.0,17523,216,44,1995,1392,21.6,1744.1
4521488040,0,32,4,1,9,6,11,0,0,0,0,18508,7.4,19340,239,51,2625,1026,23.9,1850.8,13,18,0,6,9,3,1,0,1,0,15883,7.0,18314,207,51,-2625,-1026,20.7,1588.3
4527447311,0,16,1,1,4,4,4,1,0,1,0,16389,6.6,17526,210,48,997,-1143,21.0,1638.9,15,3,0,4,4,4,1,1,0,0,15392,7.2,18669,204,72,-997,1143,20.4,1539.2
4520983823,0,18,5,0,3,8,3,0,0,0,0,14790,6.4,16619,217,37,-1967,-1292,21.7,1479.0,19,2,1,8,3,11,1,1,0,0,16757,7.0,17911,204,52,1967,1292,20.4,1675.7
4522167652,0,18,0,0,3,6,4,0,0,0,0,14364,6.8,16898,204,48,-2845,-1461,20.4,1436.4,18,2,1,6,3,5,1,1,0,0,17209,7.0,18359,208,55,2845,1461,20.8,1720.9
4502014751,0,36,0,1,4,8,3,0,0,0,0,14521,6.6,16346,186,40,-4413,-5071,18.6,1452.1,18,2,0,8,4,12,1,1,0,0,18934,7.8,21417,234,79,4413,5071,23.4,1893.4
4460913296,0,17,1,0,5,8,8,0,0,0,0,14642,6.4,15759,189,35,-3133,-3803,18.9,1464.2,15,3,1,8,5,8,0,0,0,0,17775,7.4,19562,213,59,3133,3803,21.3,1777.5
4507879201,1,18,4,0,9,11,11,1,1,0,0,17909,7.0,18562,214,43,-292,-506,21.4,1790.9,16,3,1,11,9,13,0,0,0,0,18201,7.2,19068,205,52,292,506,20.5,1820.1
4491385625,1,16,3,0,6,11,7,1,1,0,0,15990,6.4,16813,191,44,-1800,-1035,19.1,1599.0,23,5,1,11,6,11,0,0,0,0,17790,7.0,17848,217,47,1800,1035,21.7,1779.0
4493176020,0,16,2,1,3,8,2,0,0,0,0,14566,7.0,16999,190,45,-2414,-959,19.0,1456.6,17,4,0,8,3,12,0,0,0,0,16980,6.8,17958,218,45,2414,959,21.8,1698.0
4519368335,0,18,4,1,3,8,2,0,0,0,0,14711,6.8,16559,222,40,-3156,-3287,22.2,1471.1,18,4,0,8,3,6,0,0,0,0,17867,7.2,19846,238,54,3156,3287,23.8,1786.7
4492188937,1,37,1,1,5,3,6,1,1,0,0,16871,7.4,19422,213,71,1308,1371,21.3,1687.1,12,2,0,3,5,5,0,0,0,0,15563,7.0,18051,210,64,-1308,-1371,21.0,1556.3
4519106569,0,18,6,1,5,3,4,1,1,0,0,16379,6.8,18268,240,44,1429,1224,24.0,1637.9,20,4,0,3,5,4,0,0,0,0,14950,6.8,17044,226,52,-1429,-1224,22.6,1495.0
4469947346,1,14,2,0,5,6,8,0,0,0,0,15577,6.6,16572,197,45,-1218,-1528,19.7,1557.7,16,2,1,6,5,11,2,1,1,0,16795,7.0,18100,239,64,1218,1528,23.9,1679.5
4494773072,1,37,15,0,6,6,9,0,0,0,0,15754,6.6,16844,198,36,-708,-1311,19.8,1575.4,104,3,1,6,6,5,0,0,0,0,16462,7.0,18155,207,36,708,1311,20.7,1646.2
4445812835,1,15,0,0,8,10,8,0,0,0,0,16622,6.6,16799,170,32,-1129,-1742,17.0,1662.2,36,5,1,10,8,10,1,1,0,0,17751,7.2,18541,211,45,1129,1742,21.1,1775.1
4520718276,0,16,3,1,4,10,4,1,0,1,0,15773,6.6,16701,216,44,-2175,-2305,21.6,1577.3,23,3,0,10,4,12,1,1,0,0,17948,7.2,19006,216,42,2175,2305,21.6,1794.8
4513831840,1,16,1,1,6,6,7,0,0,0,0,16784,7.0,17848,228,40,941,129,22.8,1678.4,16,1,0,6,6,4,0,0,0,0,15843,6.8,17719,176,55,-941,-129,17.6,1584.3
4518160396,1,12,3,1,3,5,4,1,1,0,0,14323,6.6,16834,184,55,-2546,-2542,18.4,1432.3,14,3,0,5,3,5,1,0,1,0,16869,7.6,19376,243,70,2546,2542,24.3,1686.9
4507588254,1,18,2,1,10,0,16,0,0,0,0,18059,7.0,18165,218,44,5224,2715,21.8,1805.9,15,1,0,0,10,0,1,1,0,0,12835,6.4,15450,200,41,-5224,-2715,20.0,1283.5
4524987939,0,17,3,1,2,0,3,0,0,0,0,14112,6.6,16664,223,30,-174,-35,22.3,1411.2,18,4,0,0,2,0,0,0,0,0,14286,6.6,16699,226,44,174,35,22.6,1428.6
4521188250,0,40,4,0,6,9,5,0,0,0,0,15499,6.8,17298,222,28,-1937,-1514,22.2,1549.9,13,5,1,9,6,12,1,1,0,0,17436,7.0,18812,204,59,1937,1514,20.4,1743.6
4452176098,1,14,3,1,7,4,8,1,1,0,0,16866,6.8,17217,220,27,789,-1212,22.0,1686.6,12,1,0,4,7,5,0,0,0,0,16077,6.8,18429,224,52,-789,1212,22.4,1607.7
4523538705,1,13,2,0,12,3,12,1,1,0,0,19226,7.4,20579,228,61,4389,5412,22.8,1922.6,17,2,1,3,12,5,0,0,0,0,14837,6.4,15167,217,35,-4389,-5412,21.7,1483.7
4492897739,0,14,1,1,7,9,9,0,0,0,0,15888,6.6,15944,195,36,-1696,-2535,19.5,1588.8,11,3,0,9,7,7,0,0,0,0,17584,7.2,18479,186,52,1696,2535,18.6,1758.4
4471166821,1,13,5,0,5,5,5,2,1,1,0,16122,7.2,19143,236,59,-221,1274,23.6,1612.2,15,2,1,5,5,7,0,0,0,0,16343,7.0,17869,225,41,221,-1274,22.5,1634.3
4472737059,1,15,5,1,5,4,6,1,0,1,0,17402,7.4,19335,246,60,2067,2098,24.6,1740.2,17,3,0,4,5,4,1,1,0,0,15335,7.0,17237,230,40,-2067,-2098,23.0,1533.5
4508671448,1,18,5,0,5,8,5,1,1,0,0,15359,6.8,17087,197,64,-2039,-484,19.7,1535.9,18,2,1,8,5,11,0,0,0,0,17398,7.2,17571,230,44,2039,484,23.0,1739.8
4460560219,0,16,0,0,8,6,9,1,1,0,0,18206,7.2,19094,224,56,1137,-92,22.4,1820.6,12,4,1,6,8,6,0,0,0,0,17069,7.4,19186,220,68,-1137,92,22.0,1706.9
4481879494,1,15,0,0,3,4,3,1,1,0,1,17437,7.2,18302,255,59,3156,3919,25.5,1743.7,11,1,1,4,3,6,0,0,0,0,14281,6.0,14383,196,31,-3156,-3919,19.6,1428.1
4513008281,0,15,5,1,6,2,6,0,0,0,0,16835,7.0,17368,235,42,2251,-284,23.5,1683.5,90,1,0,2,6,2,2,1,1,0,14584,7.0,17652,248,49,-2251,284,24.8,1458.4
4525224342,1,13,2,1,3,1,4,0,0,0,0,16372,7.2,18954,279,58,2590,1325,27.9,1637.2,19,4,0,1,3,0,1,1,0,0,13782,7.0,17629,226,53,-2590,-1325,22.6,1378.2
4500400815,0,8,1,1,4,12,4,0,0,0,0,14370,6.4,15153,167,38,-5228,-6488,16.7,1437.0,55,2,0,12,4,9,0,0,0,0,19598,7.8,21641,250,69,5228,6488,25.0,1959.8
4513374819,1,110,0,0,6,10,8,0,0,0,0,16506,6.8,16828,216,45,-2535,-2654,21.6,1650.6,40,1,1,10,6,10,1,1,0,0,19041,7.4,19482,228,55,2535,2654,22.8,1904.1
4521266857,0,18,4,1,3,6,1,0,0,0,0,15177,6.8,17645,220,52,-1716,-2811,22.0,1517.7,21,1,0,6,3,4,0,0,0,0,16893,7.4,20456,241,64,1716,2811,24.1,1689.3
4489234827,1,10,0,1,2,1,1,1,0,1,1,14780,6.0,14277,188,44,3568,2926,18.8,1478.0,6,0,0,1,2,0,0,0,0,0,11212,4.8,11351,132,27,-3568,-2926,13.2,1121.2
4494610937,1,16,1,1,9,3,7,1,1,0,0,17764,7.4,19589,235,60,2617,2411,23.5,1776.4,32,3,0,3,9,2,0,0,0,0,15147,6.6,17178,220,56,-2617,-2411,22.0,1514.7
4467262571,1,12,0,0,7,9,4,1,0,1,0,17075,6.8,17991,218,54,-372,177,21.8,1707.5,45,2,1,9,7,11,0,0,0,0,17447,7.0,17814,217,36,372,-177,21.7,1744.7
4524919895,0,19,4,1,12,7,13,2,1,1,0,17810,6.6,16753,150,50,532,-883,15.0,1781.0,16,4,0,7,12,8,0,0,0,0,17278,6.8,17636,255,28,-532,883,25.5,1727.8
4526199821,0,16,3,1,4,6,8,1,1,0,0,14345,6.4,15396,172,41,-2053,-2608,17.2,1434.5,16,0,0,6,4,10,0,0,0,0,16398,6.8,18004,208,56,2053,2608,20.8,1639.8
4522166127,0,34,1,0,10,6,8,0,0,0,0,17335,7.4,19512,208,56,364,1705,20.8,1733.5,16,1,1,6,10,6,0,0,0,0,16971,7.0,17807,218,48,-364,-1705,21.8,1697.1
4475483826,1,17,0,0,9,10,7,0,0,0,0,17206,6.8,16783,216,44,-621,-428,21.6,1720.6,15,2,1,10,9,10,0,0,0,0,17827,6.8,17211,211,42,621,428,21.1,1782.7
4474674368,0,19,2,0,6,5,7,1,1,0,0,15529,7.0,17721,204,39,-413,-1004,20.4,1552.9,13,3,1,5,6,2,1,0,1,0,15942,7.0,18725,237,48,413,1004,23.7,1594.2
4519646184,1,13,2,0,4,4,6,0,0,0,0,15800,7.4,19395,231,72,-302,764,23.1,1580.0,10,5,1,4,4,4,0,0,0,0,16102,7.2,18631,236,49,302,-764,23.6,1610.2
4434531631,0,19,1,1,5,10,3,0,0,0,0,15266,6.6,17065,209,51,-3446,-1168,20.9,1526.6,13,3,0,10,5,13,1,1,0,0,18712,7.0,18233,222,68,3446,1168,22.2,1871.2
4523312152,1,17,0,0,9,7,4,0,0,0,0,17354,6.8,18013,239,32,966,969,23.9,1735.4,15,5,1,7,9,4,1,1,0,0,16388,6.8,17044,208,39,-966,-969,20.8,1638.8
4477353070,0,18,2,0,4,6,5,1,1,0,0,15785,6.8,17629,210,51,-522,-1014,21.0,1578.5,17,2,1,6,4,4,0,0,0,0,16307,7.0,18643,221,52,522,1014,22.1,1630.7
4516032625,0,16,4,1,8,3,12,0,0,0,0,17059,7.2,18162,200,37,1601,1229,20.0,1705.9,13,1,0,3,8,3,2,1,1,0,15458,6.8,16933,206,52,-1601,-1229,20.6,1545.8
4474968452,0,18,4,1,4,4,7,0,0,0,0,16487,7.0,18146,229,60,995,-458,22.9,1648.7,16,3,0,4,4,2,0,0,0,0,15492,7.0,18604,230,56,-995,458,23.0,1549.2
4524209230,1,9,1,1,7,2,10,2,1,1,0,18507,7.2,19423,245,52,3756,1754,24.5,1850.7,16,1,0,2,7,3,0,0,0,0,14751,6.6,17669,247,48,-3756,-1754,24.7,1475.1
4519995734,0,20,6,0,8,6,10,1,0,1,1,18909,7.2,18843,237,40,3023,2115,23.7,1890.9,18,3,1,6,8,7,1,1,0,0,15886,6.6,16728,211,44,-3023,-2115,21.1,1588.6
4527650398,1,12,0,1,7,7,9,0,0,0,0,17155,7.0,18002,231,36,756,1,23.1,1715.5,60,3,0,7,7,8,1,1,0,0,16399,7.0,18001,216,58,-756,-1,21.6,1639.9
4526438582,1,12,2,0,8,1,15,1,1,0,0,17040,6.8,18270,191,60,2402,2023,19.1,1704.0,15,2,1,1,8,1,0,0,0,0,14638,6.6,16247,228,40,-2402,-2023,22.8,1463.8
4470743478,0,15,3,1,9,10,9,1,1,0,0,17633,7.0,18304,218,51,-811,-410,21.8,1763.3,23,3,0,10,9,11,0,0,0,0,18444,7.0,18714,230,44,811,410,23.0,1844.4
4523397279,1,20,13,0,3,7,1,0,0,0,0,14068,6.8,17057,206,40,-3083,-2239,20.6,1406.8,41,6,1,7,3,6,0,0,0,0,17151,7.0,19296,252,32,3083,2239,25.2,1715.1
4447441297,1,28,18,0,8,4,11,0,0,0,0,17225,6.8,18183,222,57,2559,2593,22.2,1722.5,42,2,1,4,8,4,0,0,0,0,14666,6.2,15590,209,36,-2559,-2593,20.9,1466.6
4451346822,1,15,4,0,5,7,7,1,0,1,0,16111,6.8,17724,211,61,-1090,555,21.1,1611.1,16,4,1,7,5,16,1,1,0,0,17201,7.0,17169,196,52,1090,-555,19.6,1720.1
4447467809,0,16,3,0,8,6,15,1,0,1,0,15941,6.8,17256,162,51,-1870,-1732,16.2,1594.1,12,4,1,6,8,5,1,1,0,0,17811,7.4,18988,245,48,1870,1732,24.5,1781.1
4504998560,1,13,1,1,9,10,10,0,0,0,0,17827,7.2,18573,216,35,24,983,21.6,1782.7,16,3,0,10,9,11,1,0,1,0,17803,6.8,17590,204,52,-24,-983,20.4,1780.3
4518912050,1,15,3,0,8,9,8,2,1,1,0,18339,7.2,19765,233,62,-59,1231,23.3,1833.9,17,1,1,9,8,9,0,0,0,0,18398,7.0,18534,212,60,59,-1231,21.2,1839.8
4507369591,1,11,2,0,1,2,1,2,1,1,1,16616,7.0,19052,253,68,1384,201,25.3,1661.6,35,0,1,2,1,4,0,0,0,0,15232,7.2,18851,241,61,-1384,-201,24.1,1523.2
4474906958,1,17,5,0,6,7,10,1,0,1,0,16027,6.6,16856,212,44,-177,-113,21.2,1602.7,16,5,1,7,6,8,1,1,0,0,16204,6.4,16969,183,48,177,113,18.3,1620.4
4497704754,1,19,2,1,3,4,3,0,0,0,0,15268,6.2,15740,202,60,460,-952,20.2,1526.8,14,5,0,4,3,9,1,1,0,0,14808,6.6,16692,209,40,-460,952,20.9,1480.8
4519411213,1,15,2,0,4,7,4,0,0,0,0,15953,6.8,17960,260,44,-477,-513,26.0,1595.3,13,3,1,7,4,9,0,0,0,0,16430,7.0,18473,234,40,477,513,23.4,1643.0
4494319705,1,16,3,1,6,1,9,1,1,0,0,16544,6.8,17551,208,56,2151,726,20.8,1654.4,55,3,0,1,6,3,0,0,0,0,14393,6.6,16825,222,51,-2151,-726,22.2,1439.3
4498029734,0,15,3,0,7,6,7,0,0,0,0,17055,7.2,19405,230,55,567,1254,23.0,1705.5,19,2,1,6,7,7,1,1,0,0,16488,7.0,18151,201,60,-567,-1254,20.1,1648.8
4515825606,1,10,4,1,7,5,4,0,0,0,0,16478,7.0,18363,224,71,707,-788,22.4,1647.8,16,1,0,5,7,3,1,1,0,0,15771,7.2,19151,225,60,-707,788,22.5,1577.1
4467354917,1,22,0,0,6,5,6,1,1,0,0,16273,7.2,19013,237,44,464,1383,23.7,1627.3,14,5,1,5,6,2,1,0,1,0,15809,7.0,17630,235,43,-464,-1383,23.5,1580.9
4500865627,0,38,4,1,3,6,3,0,0,0,0,15541,7.0,18700,236,48,-376,-71,23.6,1554.1,14,0,0,6,3,5,1,1,0,0,15917,7.0,18771,226,48,376,71,22.6,1591.7
4379951765,0,79,3,0,4,7,4,0,0,0,0,16017,6.6,17524,202,55,-1031,-570,20.2,1601.7,16,1,1,7,4,7,0,0,0,0,17048,7.0,18094,226,52,1031,570,22.6,1704.8
4526758106,1,20,2,1,9,6,10,2,1,1,0,18302,7.2,18292,228,64,2397,958,22.8,1830.2,15,3,0,6,9,8,0,0,0,0,15905,7.0,17334,202,40,-2397,-958,20.2,1590.5
4515573007,0,18,3,0,4,7,6,0,0,0,0,16112,7.2,18339,247,46,-692,-758,24.7,1611.2,38,2,1,7,4,7,2,1,1,0,16804,7.2,19097,223,50,692,758,22.3,1680.4
4492740731,1,23,8,1,4,6,3,0,0,0,0,15888,6.8,17305,229,57,-209,-732,22.9,1588.8,17,7,0,6,4,8,1,1,0,0,16097,6.8,18037,232,43,209,732,23.2,1609.7
4513978363,0,15,3,0,7,9,7,0,0,0,0,16422,6.8,17598,206,46,-2606,-3164,20.6,1642.2,41,3,1,9,7,8,1,1,0,0,19028,7.6,20762,243,75,2606,3164,24.3,1902.8
4524920197,1,17,2,1,6,4,14,1,1,0,1,18529,7.0,18907,252,64,3048,472,25.2,1852.9,16,0,0,4,6,6,0,0,0,0,15481,7.0,18435,203,60,-3048,-472,20.3,1548.1
4469904395,1,16,0,0,4,7,5,1,1,0,0,15524,7.0,17843,228,56,-629,-209,22.8,1552.4,24,1,1,7,4,7,0,0,0,0,16153,6.8,18052,192,55,629,209,19.2,1615.3
4484464676,0,45,5,0,3,4,3,0,0,0,0,15128,6.8,18400,215,54,-279,577,21.5,1512.8,17,3,1,4,3,5,1,1,0,0,15407,7.0,17823,244,48,279,-577,24.4,1540.7
4523446704,1,17,2,1,4,4,4,0,0,0,0,15296,6.6,17179,221,40,-112,-812,22.1,1529.6,14,3,0,4,4,4,1,1,0,0,15408,6.8,17991,222,50,112,812,22.2,1540.8
4505836757,0,15,1,1,4,9,6,1,0,1,0,15391,6.6,16275,189,46,-2746,-2775,18.9,1539.1,24,4,0,9,4,7,0,0,0,0,18137,7.0,19050,247,43,2746,2775,24.7,1813.7
4522683845,0,11,2,0,3,7,5,0,0,0,0,15052,6.6,16956,204,48,-2077,-2457,20.4,1505.2,16,2,1,7,3,5,1,1,0,0,17129,7.2,19413,242,72,2077,2457,24.2,1712.9
4449048397,0,37,3,0,0,5,0,0,0,0,0,13256,6.4,16464,202,43,-4149,-3222,20.2,1325.6,17,4,1,5,0,4,1,0,1,0,17405,7.0,19686,272,48,4149,3222,27.2,1740.5
4491793322,0,14,2,0,0,11,0,1,0,1,0,13475,6.2,15686,206,71,-5840,-2412,20.6,1347.5,16,6,1,11,0,16,1,1,0,0,19315,7.0,18098,262,49,5840,2412,26.2,1931.5
4518337928,1,19,3,1,13,4,12,1,1,0,1,21986,7.4,20283,263,58,7242,4995,26.3,2198.6,38,4,0,4,13,5,1,0,1,0,14744,6.2,15288,168,40,-7242,-4995,16.8,1474.4
4470281349,1,16,1,1,6,4,6,1,1,0,0,16496,7.0,17575,213,61,615,12,21.3,1649.6,15,2,0,4,6,4,0,0,0,0,15881,6.8,17563,227,40,-615,-12,22.7,1588.1
4475558628,0,14,2,1,8,4,6,1,1,0,0,17858,7.2,18694,267,52,1886,460,26.7,1785.8,15,3,0,4,8,4,0,0,0,0,15972,7.0,18234,219,52,-1886,-460,21.9,1597.2
4505403710,0,15,3,1,7,2,13,1,1,0,0,16739,7.0,17995,229,56,1569,664,22.9,1673.9,16,0,0,2,7,2,0,0,0,0,15170,6.8,17331,250,48,-1569,-664,25.0,1517.0
4521403114,1,15,2,1,7,8,8,1,1,0,0,16142,6.8,17610,197,62,-563,-812,19.7,1614.2,24,4,0,8,7,12,0,0,0,0,16705,7.0,18422,207,48,563,812,20.7,1670.5
4463038794,1,17,0,0,4,6,4,1,1,0,0,15613,7.0,17643,229,56,-716,637,22.9,1561.3,15,3,1,6,4,3,0,0,0,0,16329,6.8,17006,213,45,716,-637,21.3,1632.9
4524535912,1,14,0,1,9,8,9,0,0,0,0,16818,6.6,16998,208,44,-141,222,20.8,1681.8,14,0,0,8,9,11,1,1,0,0,16959,6.8,16776,164,48,141,-222,16.4,1695.9
4499984272,0,21,3,0,4,8,7,0,0,0,0,14655,6.6,16541,208,37,-3142,-2633,20.8,1465.5,20,3,1,8,4,17,1,0,1,0,17797,7.2,19174,216,56,3142,2633,21.6,1779.7
4491104040,0,12,5,0,6,6,8,1,1,0,0,16744,6.8,18061,231,59,-615,-150,23.1,1674.4,22,2,1,6,6,7,0,0,0,0,17359,7.0,18211,237,48,615,150,23.7,1735.9
4521076774,1,12,3,1,15,4,17,0,0,0,1,20828,7.2,19032,250,28,6375,3949,25.0,2082.8,15,0,0,4,15,5,0,0,0,0,14453,6.2,15083,164,54,-6375,-3949,16.4,1445.3
4485856450,0,21,3,0,8,8,10,0,0,0,0,17544,7.2,18246,213,53,-375,-547,21.3,1754.4,20,5,1,8,8,9,1,1,0,0,17919,7.0,18793,230,62,375,547,23.0,1791.9
4518544844,0,15,1,0,8,6,9,0,0,0,0,16112,6.6,16844,201,32,276,377,20.1,1611.2,29,3,1,6,8,7,1,1,0,0,15836,6.6,16467,167,57,-276,-377,16.7,1583.6
4519903603,0,17,1,0,5,10,3,0,0,0,0,15687,6.6,17057,210,58,-1655,-1323,21.0,1568.7,16,2,1,10,5,12,1,1,0,0,17342,7.2,18380,215,45,1655,1323,21.5,1734.2
4517831692,0,35,0,0,4,6,7,0,0,0,0,14800,7.0,18190,207,52,-1808,-259,20.7,1480.0,17,2,1,6,4,9,1,1,0,0,16608,7.2,18449,231,60,1808,259,23.1,1660.8
4519250621,0,14,7,1,5,6,4,0,0,0,0,15693,6.8,17493,230,48,-1285,-2097,23.0,1569.3,39,3,0,6,5,7,2,1,1,0,16978,7.4,19590,236,58,1285,2097,23.6,1697.8
4526486328,0,17,2,1,3,10,2,0,0,0,0,13655,6.4,15392,179,36,-5221,-4220,17.9,1365.5,13,4,0,10,3,12,1,1,0,0,18876,7.6,19612,239,60,5221,4220,23.9,1887.6
4494315859,1,11,3,0,9,4,14,0,0,0,0,18587,7.4,19265,223,52,2851,1140,22.3,1858.7,17,2,1,4,9,3,1,1,0,0,15736,6.8,18125,226,68,-2851,-1140,22.6,1573.6
4477261749,0,15,4,0,1,4,1,2,1,1,0,14142,6.8,16922,229,52,-1691,-1608,22.9,1414.2,25,1,1,4,1,4,0,0,0,0,15833,7.0,18530,234,59,1691,1608,23.4,1583.3
4460529664,1,13,4,1,11,8,14,1,1,0,0,18159,6.8,17740,238,46,818,-165,23.8,1815.9,61,4,0,8,11,10,0,0,0,0,17341,6.8,17905,192,53,-818,165,19.2,1734.1
4435041315,0,53,2,0,3,8,3,0,0,0,0,14438,6.6,17107,199,39,-2502,-1811,19.9,1443.8,16,6,1,8,3,6,1,1,0,0,16940,7.0,18918,232,50,2502,1811,23.2,1694.0
4510804992,0,19,3,0,3,4,1,0,0,0,0,15537,7.2,18116,239,56,-294,-531,23.9,1553.7,15,5,1,4,3,4,1,0,1,0,15831,7.2,18647,244,48,294,531,24.4,1583.1
4523621040,1,12,4,0,4,4,2,1,1,0,0,15488,7.2,18538,240,51,-344,1361,24.0,1548.8,16,1,1,4,4,4,0,0,0,0,15832,6.6,17177,241,48,344,-1361,24.1,1583.2
4474929449,1,18,6,0,5,5,7,2,1,1,0,16947,7.2,18756,226,68,980,403,22.6,1694.7,207,1,1,5,5,3,0,0,0,0,15967,6.8,18353,243,48,-980,-403,24.3,1596.7
4520909804,1,40,3,1,9,5,3,2,1,1,0,17669,7.4,20105,218,64,2227,2792,21.8,1766.9,15,2,0,5,9,4,0,0,0,0,15442,6.8,17313,203,40,-2227,-2792,20.3,1544.2
4521862362,1,15,4,0,9,11,4,0,0,0,0,17525,7.0,16972,202,48,-437,-1284,20.2,1752.5,29,3,1,11,9,12,1,1,0,0,17962,6.8,18256,190,44,437,1284,19.0,1796.2
4510930403,0,20,3,1,3,11,3,0,0,0,0,14731,6.6,16187,193,36,-3804,-2878,19.3,1473.1,43,5,0,11,3,17,1,1,0,0,18535,7.4,19065,217,44,3804,2878,21.7,1853.5
4473966825,1,36,5,0,4,4,6,1,1,0,0,16112,7.2,18545,240,62,451,1068,24.0,1611.2,14,1,1,4,4,2,0,0,0,0,15661,7.0,17477,236,53,-451,-1068,23.6,1566.1
4463387399,1,15,5,0,6,7,6,0,0,0,0,16682,7.2,19047,209,68,-257,1379,20.9,1668.2,19,4,1,7,6,8,1,1,0,0,16939,6.8,17668,209,55,257,-1379,20.9,1693.9
4487407222,0,11,1,0,3,12,3,0,0,0,0,14202,6.4,16159,200,42,-4552,-2289,20.0,1420.2,14,3,1,12,3,16,1,1,0,0,18754,7.2,18448,223,35,4552,2289,22.3,1875.4
4502643526,1,34,5,1,2,1,4,0,0,0,0,15379,7.0,18530,238,57,995,1649,23.8,1537.9,12,7,0,1,2,1,0,0,0,0,14384,6.6,16881,232,49,-995,-1649,23.2,1438.4
4515979175,1,15,1,1,4,4,5,1,0,1,0,15547,7.2,17921,208,44,256,241,20.8,1554.7,22,6,0,4,4,2,1,1,0,0,15291,6.8,17680,222,49,-256,-241,22.2,1529.1
4502939535,1,15,2,1,9,3,9,0,0,0,0,16963,7.0,18341,245,37,2609,681,24.5,1696.3,17,3,0,3,9,2,1,1,0,0,14354,7.0,17660,209,52,-2609,-681,20.9,1435.4
4524901696,0,35,2,1,6,9,8,0,0,0,0,16099,6.8,17169,200,31,-1063,-1027,20.0,1609.9,11,1,0,9,6,7,1,1,0,0,17162,7.2,18196,215,49,1063,1027,21.5,1716.2
4490954687,1,57,2,1,8,5,7,1,0,1,0,16776,7.0,18113,207,64,907,-86,20.7,1677.6,18,2,0,5,8,8,1,1,0,0,15869,7.0,18199,228,42,-907,86,22.8,1586.9
4481210597,0,17,2,0,7,4,8,0,0,0,0,16887,7.0,17187,215,40,1270,-1625,21.5,1688.7,12,4,1,4,7,4,1,1,0,0,15617,7.0,18812,212,66,-1270,1625,21.2,1561.7
4526974139,0,13,1,1,7,7,9,0,0,0,0,16956,7.0,18267,229,28,399,1148,22.9,1695.6,15,1,0,7,7,12,2,1,1,0,16557,6.8,17119,187,55,-399,-1148,18.7,1655.7
4518276531,0,17,4,0,1,9,0,0,0,0,0,13806,6.4,15551,216,47,-4145,-3714,21.6,1380.6,20,5,1,9,1,12,2,1,1,0,17951,7.6,19265,232,50,4145,3714,23.2,1795.1
4478417424,0,15,3,0,6,11,3,0,0,0,0,16225,7.0,17831,203,49,-2741,-425,20.3,1622.5,20,4,1,11,6,16,1,1,0,1,18966,7.0,18256,220,34,2741,425,22.0,1896.6
4452084615,0,19,1,0,3,4,2,0,0,0,0,14317,6.8,17076,224,45,-2155,-1351,22.4,1431.7,20,2,1,4,3,4,1,0,1,0,16472,7.0,18427,239,52,2155,1351,23.9,1647.2
4522806389,0,17,1,1,2,4,1,0,0,0,0,14947,7.0,17628,241,52,-2088,-2417,24.1,1494.7,16,4,0,4,2,4,1,1,0,0,17035,7.2,20045,280,68,2088,2417,28.0,1703.5
4512918864,1,16,1,0,7,9,5,0,0,0,0,16862,6.8,18123,206,44,-542,-254,20.6,1686.2,15,3,1,9,7,8,2,1,1,0,17404,7.2,18377,222,41,542,254,22.2,1740.4
4498654804,0,15,1,0,4,8,5,1,1,0,0,15375,7.0,18057,220,60,-1489,-2144,22.0,1537.5,17,1,1,8,4,3,0,0,0,0,16864,7.6,20201,230,52,1489,2144,23.0,1686.4
4476131958,1,41,0,0,6,3,5,0,0,0,0,16495,7.2,18530,232,59,1037,922,23.2,1649.5,33,2,1,3,6,2,0,0,0,0,15458,6.6,17608,238,48,-1037,-922,23.8,1545.8
4505413315,1,21,3,1,5,4,3,0,0,0,0,16660,6.8,18272,252,48,1574,1067,25.2,1666.0,11,5,0,4,5,6,0,0,0,0,15086,6.8,17205,197,45,-1574,-1067,19.7,1508.6
4470529446,0,11,0,0,4,7,4,0,0,0,0,16182,7.0,18355,216,46,-925,-360,21.6,1618.2,15,0,1,7,4,7,2,1,1,0,17107,7.0,18715,212,67,925,360,21.2,1710.7
4512893188,0,17,0,1,8,10,8,0,0,0,0,17180,6.8,17696,216,42,-1249,-1518,21.6,1718.0,20,3,0,10,8,10,1,1,0,0,18429,7.4,19214,183,54,1249,1518,18.3,1842.9
4524424750,1,18,2,1,8,6,6,0,0,0,0,16691,6.8,16656,191,64,-1421,-1364,19.1,1669.1,25,6,0,6,8,7,0,0,0,1,18112,7.0,18020,237,51,1421,1364,23.7,1811.2
4519469738,1,35,3,1,6,2,9,1,1,0,0,16501,6.6,18428,221,44,2761,1659,22.1,1650.1,15,1,0,2,6,1,0,0,0,0,13740,6.6,16769,201,40,-2761,-1659,20.1,1374.0
4412978193,1,15,0,1,10,7,11,2,1,1,0,16743,6.6,17531,189,44,52,221,18.9,1674.3,14,2,0,7,10,5,0,0,0,0,16691,6.8,17310,208,38,-52,-221,20.8,1669.1
4525614725,1,15,1,1,8,4,7,0,0,0,0,17972,7.4,19649,254,37,2455,2080,25.4,1797.2,14,0,0,4,8,3,0,0,0,0,15517,6.8,17569,214,57,-2455,-2080,21.4,1551.7
4470453534,0,14,3,1,5,8,5,0,0,0,0,16574,6.8,18040,231,48,-37,-382,23.1,1657.4,14,0,0,8,5,10,0,0,0,0,16611,7.0,18422,209,50,37,382,20.9,1661.1
4479732841,0,26,3,0,4,6,5,0,0,0,0,15554,7.0,18372,242,52,-1232,-1020,24.2,1555.4,16,1,1,6,4,5,1,1,0,0,16786,7.4,19392,230,52,1232,1020,23.0,1678.6
4434527560,1,17,3,0,9,9,7,1,1,0,0,17442,7.0,18411,219,33,557,1853,21.9,1744.2,16,1,1,9,9,8,0,0,0,0,16885,6.6,16558,190,42,-557,-1853,19.0,1688.5
4522776236,1,15,2,0,8,8,5,0,0,0,0,17618,7.2,19023,227,41,457,692,22.7,1761.8,17,1,1,8,8,5,1,1,0,0,17161,7.0,18331,225,49,-457,-692,22.5,1716.1
4521462133,0,57,2,0,4,9,3,0,0,0,0,14640,6.6,17333,224,36,-3116,-1994,22.4,1464.0,16,0,1,9,4,14,1,1,0,0,17756,7.2,19327,215,55,3116,1994,21.5,1775.6
4513059451,0,15,3,1,5,5,9,1,1,0,0,16983,7.0,18017,238,46,-851,-115,23.8,1698.3,17,2,0,5,5,5,1,0,1,1,17834,6.8,18132,228,59,851,115,22.8,1783.4
4517721130,1,15,3,1,6,3,6,1,1,0,0,17202,7.4,19917,229,64,1360,2274,22.9,1720.2,83,0,0,3,6,3,0,0,0,0,15842,7.0,17643,220,52,-1360,-2274,22.0,1584.2
4454879809,0,16,2,0,8,4,9,0,0,0,0,17547,7.0,18409,214,67,2425,1426,21.4,1754.7,55,1,1,4,8,6,0,0,0,0,15122,6.6,16983,233,38,-2425,-1426,23.3,1512.2
4526299418,0,11,6,1,7,11,10,1,0,1,1,18142,6.8,16864,209,43,1051,-1411,20.9,1814.2,20,3,0,11,7,8,1,1,0,0,17091,7.2,18275,183,48,-1051,1411,18.3,1709.1
4522199667,0,10,0,0,8,10,10,0,0,0,0,17051,7.0,17619,208,42,-530,485,20.8,1705.1,13,3,1,10,8,9,1,1,0,0,17581,6.8,17134,191,40,530,-485,19.1,1758.1
4511994182,1,15,0,0,11,5,9,1,1,0,1,19632,7.0,18732,222,60,4648,2498,22.2,1963.2,12,0,1,5,11,7,0,0,0,0,14984,6.4,16234,181,37,-4648,-2498,18.1,1498.4
4513558845,1,16,3,1,9,6,10,2,1,1,0,17757,7.0,18305,218,48,1818,1761,21.8,1775.7,18,4,0,6,9,7,0,0,0,0,15939,6.8,16544,204,50,-1818,-1761,20.4,1593.9
4526608631,1,20,3,1,2,1,3,1,1,0,0,15426,7.4,19072,230,79,711,1245,23.0,1542.6,15,3,0,1,2,1,0,0,0,0,14715,6.8,17827,255,54,-711,-1245,25.5,1471.5
4525140164,1,14,2,1,8,9,7,0,0,0,0,17047,7.0,17601,200,47,-97,165,20.0,1704.7,16,3,0,9,8,6,1,1,0,0,17144,6.8,17436,198,48,97,-165,19.8,1714.4
4477883317,1,19,1,1,12,5,11,1,0,1,0,18732,7.2,18910,222,44,2292,1022,22.2,1873.2,14,4,0,5,12,8,0,0,0,0,16440,7.0,17888,213,59,-2292,-1022,21.3,1644.0
4446183119,1,13,1,1,13,3,8,1,1,0,0,20389,7.4,20574,235,52,6512,3981,23.5,2038.9,14,2,0,3,13,0,0,0,0,0,13877,6.8,16593,185,44,-6512,-3981,18.5,1387.7
4508663861,1,15,3,0,6,6,6,0,0,0,0,15967,6.8,17567,222,56,-844,-640,22.2,1596.7,16,2,1,6,6,6,0,0,0,0,16811,7.0,18207,234,48,844,640,23.4,1681.1
4494347491,0,17,2,1,4,5,2,0,0,0,0,15598,7.0,18672,204,72,-518,868,20.4,1559.8,17,4,0,5,4,10,0,0,0,0,16116,7.0,17804,225,40,518,-868,22.5,1611.6
4492999384,1,21,2,1,17,7,17,2,1,1,0,20983,7.2,19590,220,32,5372,4626,22.0,2098.3,14,2,0,7,17,8,0,0,0,0,15611,6.4,14964,156,40,-5372,-4626,15.6,1561.1
4518920313,0,16,0,0,5,12,8,1,1,0,0,15376,6.6,16791,206,41,-4864,-3336,20.6,1537.6,66,4,1,12,5,11,0,0,0,0,20240,7.6,20127,247,48,4864,3336,24.7,2024.0
4499844894,1,40,1,0,6,8,10,1,0,1,0,18012,7.2,19837,250,70,832,1330,25.0,1801.2,12,1,1,8,6,11,1,1,0,0,17180,7.0,18507,186,48,-832,-1330,18.6,1718.0
4511080723,0,55,4,0,1,14,1,1,1,0,0,12747,6.0,14396,180,39,-6435,-5116,18.0,1274.7,15,1,1,14,1,10,0,0,0,0,19182,7.4,19512,227,57,6435,5116,22.7,1918.2
4526234148,1,18,5,0,8,7,6,1,0,1,0,17498,7.2,19132,240,34,744,927,24.0,1749.8,19,5,1,7,8,7,0,0,0,0,16754,7.2,18205,199,47,-744,-927,19.9,1675.4
4524333896,0,15,2,0,7,6,7,0,0,0,0,15778,6.2,15796,213,19,-1578,-2563,21.3,1577.8,13,1,1,6,7,3,2,1,1,1,17356,7.2,18359,201,56,1578,2563,20.1,1735.6
4523351869,0,36,5,1,3,2,3,1,1,0,0,15951,7.0,19210,247,70,1151,1753,24.7,1595.1,48,4,0,2,3,1,1,0,1,0,14800,6.8,17457,236,45,-1151,-1753,23.6,1480.0
4475507866,0,22,2,1,8,7,9,1,0,1,0,17977,7.2,18586,255,49,1062,445,25.5,1797.7,16,4,0,7,8,8,1,1,0,0,16915,7.2,18141,203,62,-1062,-445,20.3,1691.5
4475415564,0,24,1,0,9,5,4,1,0,1,0,17535,7.2,19338,236,60,1782,2856,23.6,1753.5,13,2,1,5,9,6,1,1,0,0,15753,6.8,16482,207,40,-1782,-2856,20.7,1575.3
4511833279,1,15,5,1,6,6,6,0,0,0,0,16223,6.8,17419,233,52,135,-338,23.3,1622.3,17,4,0,6,6,9,1,1,0,0,16088,6.8,17757,202,56,-135,338,20.2,1608.8
4508253654,1,19,2,1,11,4,6,0,0,0,0,17702,7.2,18597,216,30,1741,675,21.6,1770.2,15,4,0,4,11,2,0,0,0,0,15961,6.8,17922,211,63,-1741,-675,21.1,1596.1
4515619374,1,15,2,1,6,4,4,2,1,1,0,16044,7.2,19133,214,48,-100,-1205,21.4,1604.4,15,4,0,4,6,2,0,0,0,0,16144,7.6,20338,234,75,100,1205,23.4,1614.4
4522518445,0,42,6,0,8,7,8,0,0,0,0,16699,7.0,17881,240,40,320,-743,24.0,1669.9,38,13,1,7,8,6,1,1,0,0,16379,7.2,18624,216,48,-320,743,21.6,1637.9
4515415337,1,47,3,0,6,5,5,0,0,0,0,16789,7.0,18276,233,48,904,164,23.3,1678.9,18,2,1,5,6,4,1,1,0,0,15885,6.8,18112,234,56,-904,-164,23.4,1588.5
4464807345,1,15,4,1,8,3,6,2,1,1,0,17415,7.2,19432,246,48,2148,1502,24.6,1741.5,15,1,0,3,8,1,0,0,0,0,15267,6.8,17930,212,64,-2148,-1502,21.2,1526.7
4523849418,0,56,2,0,4,5,5,0,0,0,0,15574,7.0,17489,219,52,-616,-1349,21.9,1557.4,14,3,1,5,4,3,1,1,0,0,16190,7.2,18838,232,72,616,1349,23.2,1619.0
4526474246,1,15,2,0,10,3,12,0,0,0,0,18904,7.4,18979,236,52,4879,3774,23.6,1890.4,16,1,1,3,10,7,0,0,0,0,14025,6.2,15205,162,55,-4879,-3774,16.2,1402.5
4523038174,0,14,1,1,2,12,3,0,0,0,0,13126,6.0,14222,175,46,-4394,-3817,17.5,1312.6,12,4,0,12,2,11,1,1,0,0,17520,7.0,18039,195,44,4394,3817,19.5,1752.0
4525145363,0,16,8,0,5,2,5,0,0,0,0,16441,7.2,19798,243,50,1218,1167,24.3,1644.1,36,2,1,2,5,2,1,0,1,0,15223,7.0,18631,252,51,-1218,-1167,25.2,1522.3
4486112923,0,15,2,0,2,7,2,1,0,1,0,14864,6.6,16742,249,41,-2219,-1498,24.9,1486.4,19,3,1,7,2,15,1,1,0,0,17083,7.0,18240,229,52,2219,1498,22.9,1708.3
4514314077,0,15,2,0,5,7,6,0,0,0,0,15888,7.0,18305,239,47,-1157,-51,23.9,1588.8,14,4,1,7,5,7,1,0,1,0,17045,7.0,18356,216,56,1157,51,21.6,1704.5
4522644977,1,18,5,0,5,4,8,1,1,0,0,15283,7.0,17676,223,48,230,-105,22.3,1528.3,16,4,1,4,5,5,0,0,0,0,15053,6.8,17781,212,52,-230,105,21.2,1505.3
4423018162,0,18,2,1,8,2,11,0,0,0,0,17399,7.0,19449,232,44,3194,2534,23.2,1739.9,13,3,0,2,8,2,1,1,0,0,14205,6.6,16915,208,51,-3194,-2534,20.8,1420.5
4516959189,1,13,1,0,6,6,5,0,0,0,0,16248,7.4,19928,204,64,131,1207,20.4,1624.8,14,1,1,6,6,4,0,0,0,0,16117,7.0,18721,211,44,-131,-1207,21.1,1611.7
4423902202,1,16,2,1,6,2,8,0,0,0,0,16636,7.4,19834,245,56,1394,1368,24.5,1663.6,24,2,0,2,6,3,0,0,0,0,15242,7.0,18466,225,68,-1394,-1368,22.5,1524.2
4518732690,0,18,3,1,3,5,7,1,1,0,0,14966,7.0,17656,227,44,-1966,-1549,22.7,1496.6,13,3,0,5,3,4,1,0,1,0,16932,7.2,19205,247,48,1966,1549,24.7,1693.2
4506060701,1,31,2,0,5,4,3,0,0,0,0,15678,7.0,18321,221,65,-394,1166,22.1,1567.8,16,1,1,4,5,6,0,0,0,0,16072,6.6,17155,230,46,394,-1166,23.0,1607.2
4519085208,1,15,0,1,4,1,5,1,1,0,0,15942,7.2,19003,232,71,486,865,23.2,1594.2,20,4,0,1,4,2,0,0,0,0,15456,7.0,18138,242,64,-486,-865,24.2,1545.6
4520602146,1,15,2,0,6,5,10,0,0,0,0,15852,6.8,17369,192,43,66,-57,19.2,1585.2,17,5,1,5,6,5,1,1,0,0,15786,6.8,17426,232,48,-66,57,23.2,1578.6
4506175906,1,21,5,1,13,3,9,1,1,0,0,19329,7.0,19021,246,36,6000,5033,24.6,1932.9,36,3,0,3,13,5,1,0,1,0,13329,6.0,13988,142,56,-6000,-5033,14.2,1332.9
4521533129,0,11,2,0,4,7,5,1,1,0,0,14559,6.8,16634,200,52,-1833,-2171,20.0,1455.9,48,2,1,7,4,4,0,0,0,0,16392,7.4,18805,215,48,1833,2171,21.5,1639.2
4515422041,0,14,2,1,5,8,4,0,0,0,0,15353,7.0,17812,189,46,-2332,-2671,18.9,1535.3,14,1,0,8,5,5,0,0,0,0,17685,7.6,20483,217,60,2332,2671,21.7,1768.5
4521070100,0,14,1,0,8,5,8,0,0,0,0,16945,7.4,18652,218,53,1978,1936,21.8,1694.5,26,1,1,5,8,7,0,0,0,0,14967,6.6,16716,188,44,-1978,-1936,18.8,1496.7
4501802834,0,10,2,0,1,6,1,0,0,0,0,14012,6.8,17304,230,45,-2670,-1395,23.0,1401.2,17,0,1,6,1,6,1,1,0,0,16682,7.0,18699,218,59,2670,1395,21.8,1668.2
4521974813,1,47,3,1,10,1,18,2,1,1,0,19008,7.2,19021,239,68,4319,2388,23.9,1900.8,13,3,0,1,10,2,0,0,0,0,14689,6.6,16633,240,56,-4319,-2388,24.0,1468.9
4520399820,1,15,3,0,8,6,6,0,0,0,0,18188,7.4,20313,252,76,1667,3434,25.2,1818.8,17,4,1,6,8,8,1,1,0,0,16521,6.4,16879,188,51,-1667,-3434,18.8,1652.1
4524538444,0,16,4,0,6,15,7,0,0,0,0,15484,6.6,16418,165,46,-4879,-3465,16.5,1548.4,44,5,1,15,6,16,1,1,0,0,20363,7.4,19883,250,39,4879,3465,25.0,2036.3
4522338058,1,38,1,1,7,5,8,2,1,1,0,16839,6.6,17206,209,53,1211,355,20.9,1683.9,8,18,0,5,7,9,0,0,0,0,15628,6.8,16851,191,51,-1211,-355,19.1,1562.8
4491473852,0,18,3,0,3,7,5,0,0,0,0,15144,6.8,17285,224,50,-2283,-1969,22.4,1514.4,47,2,1,7,3,9,1,1,0,0,17427,7.2,19254,259,62,2283,1969,25.9,1742.7
4471303802,1,18,3,0,15,9,14,0,0,0,0,20134,7.4,19414,183,52,2445,1767,18.3,2013.4,11,3,1,9,15,7,0,0,0,0,17689,7.0,17647,221,36,-2445,-1767,22.1,1768.9
4449279281,1,15,2,1,6,3,4,1,1,0,0,16980,7.0,18593,241,44,2642,1346,24.1,1698.0,16,3,0,3,6,5,0,0,0,0,14338,6.6,17247,188,54,-2642,-1346,18.8,1433.8
4509271270,1,12,1,0,3,8,6,1,1,0,0,15159,6.6,17161,221,65,-2341,-2034,22.1,1515.9,15,1,1,8,3,12,0,0,0,0,17500,7.2,19195,214,63,2341,2034,21.4,1750.0
4522845066,0,21,5,1,5,4,5,0,0,0,0,16022,7.0,17853,219,60,511,-678,21.9,1602.2,78,1,0,4,5,9,1,0,1,0,15511,7.0,18531,242,42,-511,678,24.2,1551.1
4524647930,0,39,1,0,8,10,9,1,1,0,0,16650,7.0,18077,199,63,-1968,-469,19.9,1665.0,15,3,1,10,8,11,0,0,0,0,18618,7.2,18546,224,44,1968,469,22.4,1861.8
4489899716,1,14,9,1,8,4,6,1,0,1,0,17187,7.0,18382,232,39,1546,61,23.2,1718.7,23,4,0,4,8,3,0,0,0,0,15641,7.2,18321,240,55,-1546,-61,24.0,1564.1
4517729652,1,35,2,1,7,5,4,0,0,0,0,17214,7.0,18791,241,64,1892,1261,24.1,1721.4,21,5,0,5,7,5,0,0,0,0,15322,6.8,17530,214,43,-1892,-1261,21.4,1532.2
4464561037,1,17,5,1,5,9,5,1,1,0,0,15585,6.6,16636,200,35,-2864,-3491,20.0,1558.5,18,3,0,9,5,8,0,0,0,0,18449,7.2,20127,224,71,2864,3491,22.4,1844.9
4521921939,0,15,3,0,6,6,7,2,1,1,0,15908,7.2,18702,208,63,-1035,-442,20.8,1590.8,25,2,1,6,6,2,0,0,0,0,16943,7.2,19144,229,64,1035,442,22.9,1694.3
4524014762,0,19,4,0,1,6,2,0,0,0,0,14307,6.4,16295,211,44,-3418,-3733,21.1,1430.7,17,3,1,6,1,5,2,1,1,0,17725,7.4,20028,234,72,3418,3733,23.4,1772.5
4487949921,0,18,2,0,5,5,9,0,0,0,0,15454,6.8,16466,210,40,-824,-976,21.0,1545.4,49,7,1,5,5,8,0,0,0,0,16278,6.8,17442,240,56,824,976,24.0,1627.8
4484936763,0,12,4,0,5,8,7,0,0,0,0,16265,7.0,17407,217,56,-1195,-1492,21.7,1626.5,17,3,1,8,5,6,1,1,0,0,17460,7.2,18899,244,59,1195,1492,24.4,1746.0
4464979859,0,61,2,0,3,10,4,0,0,0,0,13539,6.6,15736,163,48,-5293,-3777,16.3,1353.9,31,2,1,10,3,13,0,0,0,0,18832,7.4,19513,236,63,5293,3777,23.6,1883.2
4474160523,1,17,1,1,8,4,9,2,1,1,0,18293,7.4,19340,228,76,2406,2284,22.8,1829.3,14,3,0,4,8,7,0,0,0,0,15887,6.8,17056,224,52,-2406,-2284,22.4,1588.7
4502875704,0,16,2,0,1,10,2,1,0,1,0,14727,6.6,16272,219,52,-3581,-2467,21.9,1472.7,14,6,1,10,1,15,1,1,0,0,18308,7.0,18739,248,31,3581,2467,24.8,1830.8
4521185772,1,15,2,1,7,8,4,1,0,1,0,16420,7.0,18391,224,49,-1250,-1034,22.4,1642.0,17,2,0,8,7,6,1,1,0,0,17670,7.2,19425,239,55,1250,1034,23.9,1767.0
4523554856,1,19,2,1,7,6,7,0,0,0,1,19367,7.2,19595,259,61,4507,2090,25.9,1936.7,11,3,0,6,7,2,1,1,0,0,14860,6.8,17505,202,45,-4507,-2090,20.2,1486.0
4459583409,1,25,7,0,4,6,4,1,1,0,0,15883,6.8,17317,235,53,-426,-323,23.5,1588.3,17,4,1,6,4,6,0,0,0,0,16309,7.0,17640,238,42,426,323,23.8,1630.9
4469723831,1,13,1,1,6,1,2,2,1,1,3,21051,7.4,20745,276,70,8776,8348,27.6,2105.1,14,1,0,1,6,1,0,0,0,0,12275,5.4,12397,176,20,-8776,-8348,17.6,1227.5
4523758251,0,15,1,0,5,7,8,1,1,0,0,16112,6.4,16747,215,52,-1031,-760,21.5,1611.2,17,1,1,7,5,10,0,0,0,0,17143,6.8,17507,211,56,1031,760,21.1,1714.3
4519670030,0,18,2,0,8,7,7,0,0,0,0,17123,6.8,17730,190,51,1110,974,19.0,1712.3,16,3,1,7,8,9,1,1,0,0,16013,6.8,16756,161,52,-1110,-974,16.1,1601.3
4519896224,0,20,3,1,6,10,8,1,1,0,0,15614,6.4,16000,196,27,-2683,-3323,19.6,1561.4,15,5,0,10,6,7,1,0,1,0,18297,7.4,19323,223,52,2683,3323,22.3,1829.7
4523512356,1,12,1,0,8,6,14,1,1,0,0,16980,6.8,18629,218,48,-53,559,21.8,1698.0,19,2,1,6,8,4,0,0,0,0,17033,7.0,18070,240,59,53,-559,24.0,1703.3
4523089972,1,16,4,0,6,7,6,0,0,0,0,16473,7.0,17992,204,64,-628,-582,20.4,1647.3,18,3,1,7,6,4,1,1,0,0,17101,7.2,18574,218,64,628,582,21.8,1710.1
4527297466,1,16,3,1,4,5,4,1,1,0,0,15070,6.6,17424,218,44,-124,253,21.8,1507.0,14,0,0,5,4,6,0,0,0,0,15194,6.8,17171,198,52,124,-253,19.8,1519.4
4504658470,1,14,5,0,7,6,10,1,1,0,0,17070,6.8,18022,232,47,365,356,23.2,1707.0,16,1,1,6,7,10,0,0,0,0,16705,7.0,17666,201,50,-365,-356,20.1,1670.5
4518035453,0,9,1,0,5,9,5,0,0,0,0,15942,6.8,17493,215,48,-1590,-1375,21.5,1594.2,40,3,1,9,5,13,1,1,0,0,17532,7.0,18868,221,70,1590,1375,22.1,1753.2
4462822910,1,16,3,1,6,2,7,1,0,1,0,16898,7.2,19309,247,57,2927,3135,24.7,1689.8,15,4,0,2,6,2,0,0,0,0,13971,6.6,16174,212,49,-2927,-3135,21.2,1397.1
4527018824,0,21,2,0,2,5,6,1,1,0,0,15476,6.8,17429,237,64,-781,-1559,23.7,1547.6,17,6,1,5,2,3,1,0,1,0,16257,7.2,18988,227,48,781,1559,22.7,1625.7
4519881669,0,23,4,1,3,8,6,1,0,1,1,15698,6.4,16251,189,47,-1838,-1430,18.9,1569.8,68,4,0,8,3,9,1,1,0,0,17536,6.8,17681,211,58,1838,1430,21.1,1753.6
4520518114,0,18,0,0,4,10,8,1,0,1,0,15316,6.4,17001,215,52,-2882,-1423,21.5,1531.6,14,6,1,10,4,14,1,1,0,0,18198,6.8,18424,218,44,2882,1423,21.8,1819.8
4494870999,1,17,3,1,5,0,4,1,0,1,1,17606,7.6,20053,229,60,4027,3285,22.9,1760.6,17,3,0,0,5,0,0,0,0,0,13579,6.6,16768,220,52,-4027,-3285,22.0,1357.9
4431218839,1,13,3,1,6,4,6,1,1,0,0,17089,7.2,18072,232,52,2387,1690,23.2,1708.9,33,1,0,4,6,3,0,0,0,0,14702,6.6,16382,191,44,-2387,-1690,19.1,1470.2
4477418951,0,20,3,0,7,10,11,0,0,0,0,16699,7.0,17566,195,51,-967,-263,19.5,1669.9,20,5,1,10,7,8,0,0,0,0,17666,7.2,17829,208,54,967,263,20.8,1766.6
4466899490,1,12,3,1,5,6,7,1,1,0,0,16209,7.0,18162,231,52,55,-1918,23.1,1620.9,15,5,0,6,5,3,0,0,0,0,16154,7.2,20080,228,64,-55,1918,22.8,1615.4
4464945993,0,15,1,1,8,7,8,2,1,1,0,17898,7.4,19411,232,58,942,1300,23.2,1789.8,16,2,0,7,8,6,0,0,0,0,16956,7.0,18111,245,43,-942,-1300,24.5,1695.6
4469635375,0,13,2,0,3,9,1,0,0,0,0,14100,6.4,16543,189,52,-4603,-3046,18.9,1410.0,17,4,1,9,3,8,2,1,1,0,18703,7.2,19589,241,65,4603,3046,24.1,1870.3
4489785734,0,37,3,0,4,5,6,0,0,0,0,15531,7.0,17609,218,44,-1814,-2306,21.8,1553.1,15,2,1,5,4,5,1,1,0,0,17345,7.4,19915,256,80,1814,2306,25.6,1734.5
4513150611,0,13,3,0,6,10,5,0,0,0,0,15796,6.6,17324,195,59,-2815,-2607,19.5,1579.6,14,6,1,10,6,11,1,1,0,0,18611,7.6,19931,243,72,2815,2607,24.3,1861.1
4521255103,0,24,3,0,6,7,5,0,0,0,0,16505,7.0,17667,208,70,-49,500,20.8,1650.5,17,2,1,7,6,10,1,1,0,0,16554,6.8,17167,207,45,49,-500,20.7,1655.4
4523062555,0,15,2,0,4,8,2,0,0,0,0,15200,6.6,17118,228,49,-1806,-541,22.8,1520.0,16,4,1,8,4,10,0,0,0,0,17006,7.0,17659,224,49,1806,541,22.4,1700.6
4521254867,0,12,2,1,4,8,4,2,1,1,0,14998,6.6,16127,185,45,-1430,147,18.5,1499.8,14,1,0,8,4,7,0,0,0,0,16428,6.6,15980,196,48,1430,-147,19.6,1642.8
4457030522,1,14,3,1,7,4,7,1,1,0,0,17676,7.4,20228,233,57,2296,3462,23.3,1767.6,16,2,0,4,7,4,0,0,0,0,15380,6.8,16766,212,41,-2296,-3462,21.2,1538.0
4463332138,0,15,2,0,7,7,8,1,1,0,0,16106,7.0,18323,207,52,-84,570,20.7,1610.6,106,1,1,7,7,4,0,0,0,0,16190,7.0,17753,207,49,84,-570,20.7,1619.0
4522637303,1,21,5,1,12,4,16,1,1,0,0,19628,7.2,18889,229,38,4801,2127,22.9,1962.8,21,3,0,4,12,4,0,0,0,0,14827,6.8,16762,198,60,-4801,-2127,19.8,1482.7
4518254989,0,14,2,1,3,7,3,0,0,0,0,14936,6.6,16574,225,30,-1703,-2550,22.5,1493.6,19,2,0,7,3,7,0,0,0,0,16639,7.2,19124,221,48,1703,2550,22.1,1663.9
4518452503,1,16,3,1,9,5,10,1,1,0,0,16819,6.8,17163,197,40,459,-1147,19.7,1681.9,13,4,0,5,9,3,1,0,1,0,16360,6.8,18310,235,57,-459,1147,23.5,1636.0
4497457937,1,41,3,1,4,8,4,0,0,0,0,16059,7.0,18190,221,41,-1521,-2185,22.1,1605.9,19,24,0,8,4,14,1,1,0,0,17580,7.4,20375,246,50,1521,2185,24.6,1758.0
4486889900,0,18,3,0,1,10,1,0,0,0,0,14666,6.2,16186,233,49,-3480,-1368,23.3,1466.6,45,2,1,10,1,22,1,1,0,0,18146,7.0,17554,193,46,3480,1368,19.3,1814.6
4519262585,1,18,3,1,14,5,12,1,1,0,0,20979,7.6,20534,250,68,4091,3392,25.0,2097.9,18,4,0,5,14,8,0,0,0,0,16888,6.8,17142,215,48,-4091,-3392,21.5,1688.8
4477708439,1,48,0,0,4,5,6,1,1,0,0,15969,7.0,18868,195,72,-876,389,19.5,1596.9,13,2,1,5,4,9,0,0,0,0,16845,7.0,18479,228,63,876,-389,22.8,1684.5
4479618265,0,14,4,1,1,10,1,0,0,0,0,14041,6.4,15172,226,48,-5162,-3610,22.6,1404.1,20,2,0,10,1,19,0,0,0,1,19203,7.2,18782,196,46,5162,3610,19.6,1920.3
4474862370,0,28,6,0,8,8,8,1,1,0,0,16601,6.2,16246,196,44,103,63,19.6,1660.1,81,3,1,8,8,6,0,0,0,0,16498,6.4,16183,194,46,-103,-63,19.4,1649.8
4466524457,0,19,5,1,3,5,5,1,0,1,0,14838,6.8,16485,208,44,-1278,-1387,20.8,1483.8,21,4,0,5,3,9,0,0,0,0,16116,7.0,17872,221,39,1278,1387,22.1,1611.6
4521986656,1,29,4,0,2,8,3,0,0,0,0,14948,6.8,17592,226,48,-3669,-2489,22.6,1494.8,17,4,1,8,2,14,1,1,0,0,18617,7.6,20081,255,76,3669,2489,25.5,1861.7
4447656785,1,23,3,1,2,6,1,1,1,0,0,14702,6.8,17961,212,60,-1626,-849,21.2,1470.2,19,5,0,6,2,5,1,0,1,0,16328,7.2,18810,243,48,1626,849,24.3,1632.8
4524699601,1,15,4,0,8,5,7,0,0,0,0,16239,6.8,17856,200,48,36,1099,20.0,1623.9,15,3,1,5,8,6,0,0,0,0,16203,6.6,16757,215,44,-36,-1099,21.5,1620.3
4523323599,1,20,10,0,9,11,10,1,0,1,0,17298,6.8,17146,198,40,-98,-169,19.8,1729.8,47,5,1,11,9,13,1,1,0,0,17396,7.0,17315,182,36,98,169,18.2,1739.6
4497788373,1,15,2,1,11,3,13,1,1,0,0,19267,7.6,20141,230,58,4538,3583,23.0,1926.7,12,1,0,3,11,3,0,0,0,0,14729,6.4,16558,201,57,-4538,-3583,20.1,1472.9
4495369305,0,13,1,0,2,6,2,0,0,0,0,15392,7.0,18126,238,60,-1045,406,23.8,1539.2,14,2,1,6,2,7,2,1,1,0,16437,6.8,17720,205,64,1045,-406,20.5,1643.7
4518116410,0,16,2,1,2,8,1,1,0,1,0,15157,6.8,16829,228,52,-1082,-1819,22.8,1515.7,16,4,0,8,2,4,1,1,0,0,16239,7.0,18648,229,40,1082,1819,22.9,1623.9
4489963680,0,77,3,1,8,11,12,1,0,1,0,16842,6.4,16280,210,28,-1725,-2264,21.0,1684.2,39,1,0,11,8,13,1,1,0,0,18567,7.0,18544,192,56,1725,2264,19.2,1856.7
4513270155,0,64,5,0,5,13,4,1,1,0,0,15680,6.8,18107,197,64,-3865,-1779,19.7,1568.0,12,8,1,13,5,15,0,0,0,0,19545,7.2,19886,223,43,3865,1779,22.3,1954.5
4488120738,0,19,2,0,8,11,5,0,0,0,0,17156,6.8,17559,195,61,-1534,-1425,19.5,1715.6,12,3,1,11,8,16,1,1,0,0,18690,7.2,18984,204,45,1534,1425,20.4,1869.0
4521830295,0,16,2,0,9,18,9,0,0,0,0,16331,6.4,14886,162,31,-3966,-2999,16.2,1633.1,18,2,1,18,9,16,1,0,1,0,20297,6.8,17885,169,38,3966,2999,16.9,2029.7
4525232223,0,17,5,1,9,5,8,0,0,0,0,17757,7.0,18821,217,48,2341,2225,21.7,1775.7,18,3,0,5,9,5,1,1,0,0,15416,6.8,16596,185,58,-2341,-2225,18.5,1541.6
4517823981,0,14,2,1,4,7,4,0,0,0,0,14663,6.6,16512,242,16,-2405,-2654,24.2,1466.3,13,4,0,7,4,5,1,1,0,0,17068,7.2,19166,235,64,2405,2654,23.5,1706.8
4523431479,1,17,3,1,9,4,4,0,0,0,0,16715,7.0,19011,227,48,911,713,22.7,1671.5,20,1,0,4,9,5,1,1,0,0,15804,6.8,18298,191,64,-911,-713,19.1,1580.4
4469192486,1,11,4,1,18,13,6,0,0,0,1,21132,7.2,19294,236,44,2658,2407,23.6,2113.2,166,0,0,13,18,16,0,0,0,0,18474,6.6,16887,154,31,-2658,-2407,15.4,1847.4
4509363217,0,30,5,1,5,7,4,0,0,0,0,15386,6.6,16591,188,44,-1739,-826,18.8,1538.6,21,7,0,7,5,9,1,0,1,0,17125,6.8,17417,222,48,1739,826,22.2,1712.5
4523591734,1,37,3,0,5,9,5,0,0,0,0,15440,6.4,15725,180,43,-1729,118,18.0,1544.0,17,2,1,9,5,8,0,0,0,0,17169,6.4,15607,185,44,1729,-118,18.5,1716.9
4474742854,0,15,4,1,6,7,2,0,0,0,0,15030,6.4,16763,204,36,-632,675,20.4,1503.0,17,4,0,7,6,8,1,1,0,0,15662,6.4,16088,192,45,632,-675,19.2,1566.2
4523384060,0,11,1,1,3,4,1,0,0,0,0,15336,7.0,17953,253,43,-761,-10,25.3,1533.6,14,1,0,4,3,5,1,0,1,0,16097,6.8,17963,219,52,761,10,21.9,1609.7
4522839614,1,16,1,1,6,6,7,1,1,0,0,16410,7.2,18288,211,60,96,-24,21.1,1641.0,15,2,0,6,6,5,0,0,0,0,16314,7.0,18312,203,48,-96,24,20.3,1631.4
4514105796,0,12,3,0,2,9,1,0,0,0,0,14933,6.6,16470,225,56,-3251,-3208,22.5,1493.3,16,1,1,9,2,7,0,0,0,0,18184,7.4,19678,241,43,3251,3208,24.1,1818.4
4508101367,1,14,2,0,6,4,5,0,0,0,0,16637,7.0,19339,245,49,1530,2305,24.5,1663.7,25,3,1,4,6,5,1,1,0,0,15107,6.6,17034,216,48,-1530,-2305,21.6,1510.7
4524763167,1,19,2,0,17,10,21,0,0,0,1,22745,6.8,17394,205,23,4999,1094,20.5,2274.5,14,3,1,10,17,11,1,1,0,0,17746,6.4,16300,175,58,-4999,-1094,17.5,1774.6
4462172750,0,15,4,0,5,10,5,0,0,0,0,15600,6.6,16412,169,50,-2689,-1566,16.9,1560.0,27,1,1,10,5,12,1,1,0,0,18289,7.0,17978,223,49,2689,1566,22.3,1828.9
4418117776,1,16,6,1,9,10,11,1,1,0,0,17292,6.8,17127,200,50,-606,-1487,20.0,1729.2,17,2,0,10,9,10,0,0,0,0,17898,7.0,18614,197,50,606,1487,19.7,1789.8
4517848263,1,16,1,1,5,3,5,2,1,1,2,17645,7.0,18081,224,52,2864,1182,22.4,1764.5,74,3,0,3,5,3,0,0,0,0,14781,6.6,16899,207,40,-2864,-1182,20.7,1478.1
4522183138,1,18,5,0,9,10,11,2,1,1,1,19003,6.6,16349,226,31,503,-222,22.6,1900.3,19,1,1,10,9,14,0,0,0,0,18500,6.6,16571,209,43,-503,222,20.9,1850.0
4519749529,1,16,3,1,5,7,4,1,1,0,0,16318,7.2,18452,234,56,-67,-481,23.4,1631.8,17,5,0,7,5,4,0,0,0,0,16385,7.2,18933,200,66,67,481,20.0,1638.5
4497843332,1,14,6,1,9,4,13,0,0,0,0,17408,7.2,19121,204,56,2091,1359,20.4,1740.8,79,3,0,4,9,2,0,0,0,0,15317,6.8,17762,227,48,-2091,-1359,22.7,1531.7
4516583288,0,12,2,0,4,10,4,1,1,0,0,15994,7.0,18031,229,64,-2519,-1610,22.9,1599.4,15,4,1,10,4,15,0,0,0,0,18513,7.2,19641,238,39,2519,1610,23.8,1851.3
4513670045,0,16,3,0,4,4,6,0,0,0,0,15641,7.2,17857,244,40,-1136,-1235,24.4,1564.1,61,2,1,4,4,3,1,1,0,0,16777,7.2,19092,234,71,1136,1235,23.4,1677.7
4525101831,1,22,1,0,9,7,7,0,0,0,0,17518,7.2,19434,212,52,731,1627,21.2,1751.8,13,1,1,7,9,4,1,1,0,0,16787,7.0,17807,192,47,-731,-1627,19.2,1678.7
4465024701,0,22,3,0,7,7,6,1,1,0,0,17597,7.2,18452,244,36,118,299,24.4,1759.7,14,3,1,7,7,7,0,0,0,0,17479,7.0,18153,224,62,-118,-299,22.4,1747.9
4526085370,1,21,5,1,12,6,8,1,1,0,0,18432,7.2,19560,224,41,2495,3183,22.4,1843.2,19,2,0,6,12,8,0,0,0,0,15937,6.8,16377,193,52,-2495,-3183,19.3,1593.7
4516845664,1,17,3,0,11,5,7,0,0,0,0,18415,7.4,20355,221,51,2862,3250,22.1,1841.5,12,2,1,5,11,7,0,0,0,0,15553,7.0,17105,223,44,-2862,-3250,22.3,1555.3
4498027358,0,14,4,0,5,7,4,0,0,0,0,14387,6.4,15777,158,48,-3214,-2195,15.8,1438.7,16,2,1,7,5,10,2,1,1,0,17601,7.0,17972,226,42,3214,2195,22.6,1760.1
4386507847,1,18,5,0,7,5,6,0,0,0,0,16750,6.8,17603,215,52,1221,462,21.5,1675.0,35,3,1,5,7,5,0,0,0,0,15529,6.8,17141,197,48,-1221,-462,19.7,1552.9
4520411490,1,16,2,0,4,5,7,0,0,0,0,16152,7.0,17881,260,44,-428,-432,26.0,1615.2,16,4,1,5,4,7,2,1,1,0,16580,7.2,18313,238,56,428,432,23.8,1658.0
4478297307,0,13,2,0,0,4,0,0,0,0,0,14102,6.6,16718,225,64,-1936,-2432,22.5,1410.2,12,3,1,4,0,4,1,1,0,0,16038,7.2,19150,236,56,1936,2432,23.6,1603.8
4452482397,1,15,4,1,4,4,3,0,0,0,0,14559,6.8,17491,191,44,-1348,-10,19.1,1455.9,91,2,0,4,4,6,1,0,1,0,15907,6.6,17501,202,54,1348,10,20.2,1590.7
4492057587,0,12,4,1,4,6,3,1,1,0,0,15660,7.0,17755,246,52,-2392,-2503,24.6,1566.0,21,1,0,6,4,7,0,0,0,0,18052,7.4,20258,266,68,2392,2503,26.6,1805.2
4520041745,0,20,1,0,7,11,10,0,0,0,0,16820,6.8,16714,202,40,-2234,-3264,20.2,1682.0,11,5,1,11,7,15,1,1,0,0,19054,7.2,19978,209,63,2234,3264,20.9,1905.4
4520033534,1,15,2,1,5,5,5,1,1,0,0,15781,6.8,17957,221,56,-535,-691,22.1,1578.1,14,4,0,5,5,7,0,0,0,0,16316,7.0,18648,240,54,535,691,24.0,1631.6
4521703092,1,16,4,1,8,5,16,1,1,0,0,17616,7.0,18517,235,68,1790,1220,23.5,1761.6,19,4,0,5,8,7,0,0,0,0,15826,6.8,17297,231,36,-1790,-1220,23.1,1582.6
4458497887,0,15,2,0,5,6,4,0,0,0,0,14448,6.8,17263,156,36,-2969,-1135,15.6,1444.8,38,1,1,6,5,8,1,1,0,0,17417,7.0,18398,225,70,2969,1135,22.5,1741.7
4515311611,0,39,5,0,8,11,6,1,0,1,1,18213,6.8,18240,217,55,-1538,-370,21.7,1821.3,21,8,1,11,8,16,1,1,0,1,19751,7.2,18610,225,48,1538,370,22.5,1975.1
4511067925,1,17,5,1,5,4,4,1,1,0,0,16498,6.8,17738,237,45,1699,638,23.7,1649.8,15,3,0,4,5,3,0,0,0,0,14799,6.8,17100,202,46,-1699,-638,20.2,1479.9
4496735855,1,16,3,1,7,2,9,0,0,0,0,16875,6.6,17964,222,49,2590,682,22.2,1687.5,15,1,0,2,7,1,1,1,0,0,14285,6.8,17282,225,54,-2590,-682,22.5,1428.5
4446121207,1,39,4,1,12,6,19,0,0,0,1,20560,7.4,19784,216,52,4426,2385,21.6,2056.0,15,3,0,6,12,6,0,0,0,0,16134,6.6,17399,206,60,-4426,-2385,20.6,1613.4
4480350578,1,18,1,1,7,3,6,0,0,0,0,17082,7.2,19192,224,59,2388,1600,22.4,1708.2,36,2,0,3,7,2,1,1,0,0,14694,7.0,17592,224,49,-2388,-1600,22.4,1469.4
4516123957,0,17,5,1,8,6,16,1,1,0,0,17252,7.0,18419,197,48,-22,-801,19.7,1725.2,19,4,0,6,8,10,1,0,1,0,17274,7.2,19220,228,64,22,801,22.8,1727.4
4471725979,1,14,1,1,5,6,4,1,0,1,0,15307,6.8,16772,205,47,-1618,-1224,20.5,1530.7,13,2,0,6,5,9,0,0,0,0,16925,7.0,17996,243,36,1618,1224,24.3,1692.5
4494820470,1,10,3,1,7,8,9,1,1,0,0,16890,6.8,17686,221,53,-1647,-1443,22.1,1689.0,11,1,0,8,7,9,1,0,1,0,18537,7.2,19129,223,60,1647,1443,22.3,1853.7
4481377931,0,16,3,0,4,9,5,1,0,1,0,15664,6.8,17373,208,60,-2078,-188,20.8,1566.4,16,2,1,9,4,10,1,1,0,0,17742,7.0,17561,214,44,2078,188,21.4,1774.2
4500088034,1,17,3,0,4,6,2,1,0,1,0,15374,6.8,17943,223,49,-780,107,22.3,1537.4,18,3,1,6,4,6,1,1,0,0,16154,7.2,17836,231,61,780,-107,23.1,1615.4
4503391789,0,14,3,0,2,7,1,1,1,0,0,13701,6.6,15431,183,59,-4095,-3017,18.3,1370.1,20,3,1,7,2,6,0,0,0,0,17796,7.2,18448,255,36,4095,3017,25.5,1779.6
4524260824,0,14,1,1,7,7,6,0,0,0,0,16346,7.0,18557,209,44,-346,-358,20.9,1634.6,33,1,0,7,7,7,0,0,0,0,16692,7.2,18915,182,67,346,358,18.2,1669.2
4386551439,0,18,2,1,6,4,11,0,0,0,0,15956,6.8,17199,215,44,-43,-1154,21.5,1595.6,13,3,0,4,6,4,0,0,0,0,15999,7.2,18353,226,69,43,1154,22.6,1599.9
4503636843,0,52,4,0,4,8,7,1,1,0,0,14766,6.6,16507,190,53,-2769,-820,19.0,1476.6,17,3,1,8,4,11,0,0,0,0,17535,6.8,17327,229,44,2769,820,22.9,1753.5
4517939505,1,38,5,1,2,1,4,1,0,1,0,14807,6.8,17246,214,56,1090,371,21.4,1480.7,16,2,0,1,2,1,1,1,0,0,13717,6.6,16875,197,52,-1090,-371,19.7,1371.7
4513018966,1,17,2,1,9,1,10,1,1,0,0,16988,7.0,18314,209,43,3222,2205,20.9,1698.8,15,3,0,1,9,0,0,0,0,0,13766,6.6,16109,218,47,-3222,-2205,21.8,1376.6
4524542194,1,21,3,1,9,9,11,1,1,0,0,17489,6.6,16724,221,40,-219,-1275,22.1,1748.9,40,5,0,9,9,13,0,0,0,0,17708,6.8,17999,226,44,219,1275,22.6,1770.8
4440191249,1,15,1,1,10,7,8,0,0,0,0,18126,7.2,18581,222,40,2361,2502,22.2,1812.6,10,1,0,7,10,4,1,1,0,0,15765,6.2,16079,176,40,-2361,-2502,17.6,1576.5
4508915149,0,14,1,0,0,5,0,0,0,0,0,13561,6.6,16518,220,51,-1958,-1775,22.0,1356.1,15,3,1,5,0,4,1,1,0,0,15519,7.0,18293,223,37,1958,1775,22.3,1551.9
4443967905,0,14,4,0,8,10,6,1,1,0,0,17035,7.0,17308,204,48,-1556,-3181,20.4,1703.5,25,1,1,10,8,9,0,0,0,0,18591,7.4,20489,213,67,1556,3181,21.3,1859.1
4487686105,1,12,4,1,8,4,11,0,0,0,0,16763,7.0,17757,216,34,147,-712,21.6,1676.3,14,2,0,4,8,8,0,0,0,0,16616,7.0,18469,240,64,-147,712,24.0,1661.6
4440874432,1,15,2,0,3,2,5,0,0,0,0,17194,7.2,19539,253,68,2330,2167,25.3,1719.4,15,1,1,2,3,3,0,0,0,0,14864,6.8,17372,219,52,-2330,-2167,21.9,1486.4
4524906792,0,49,2,0,6,5,2,0,0,0,0,15739,7.2,18231,193,54,154,159,19.3,1573.9,13,1,1,5,6,5,1,1,0,0,15585,7.0,18072,211,50,-154,-159,21.1,1558.5
4506779668,0,39,3,0,4,7,4,1,1,0,0,15722,6.8,17329,221,53,-3309,-2741,22.1,1572.2,17,5,1,7,4,9,0,0,0,1,19031,7.4,20070,230,60,3309,2741,23.0,1903.1
4495265791,0,17,2,1,4,2,4,0,0,0,0,16103,7.0,17909,238,60,1119,-12,23.8,1610.3,19,4,0,2,4,0,0,0,0,0,14984,6.8,17921,245,48,-1119,12,24.5,1498.4
4492762371,1,16,4,1,13,6,18,1,1,0,0,20169,7.0,17549,205,52,4453,337,20.5,2016.9,20,0,0,6,13,9,0,0,0,0,15716,6.6,17212,162,52,-4453,-337,16.2,1571.6
4514168279,0,16,1,1,5,6,3,1,1,0,0,14616,6.6,16844,183,40,-1313,-1476,18.3,1461.6,14,1,0,6,5,3,0,0,0,0,15929,7.0,18320,217,56,1313,1476,21.7,1592.9
4519393462,0,14,0,1,8,11,7,0,0,0,0,17509,7.2,18038,234,28,-2118,-2158,23.4,1750.9,11,2,0,11,8,9,1,1,0,0,19627,7.4,20196,209,89,2118,2158,20.9,1962.7
4518291052,1,12,4,0,7,4,12,0,0,0,0,16526,6.6,17213,211,54,562,249,21.1,1652.6,21,3,1,4,7,9,1,1,0,0,15964,6.8,16964,233,48,-562,-249,23.3,1596.4
4523594807,0,67,3,0,6,8,4,0,0,0,0,14795,6.4,15646,172,50,-2348,-1246,17.2,1479.5,15,3,1,8,6,10,1,1,0,0,17143,6.6,16892,193,37,2348,1246,19.3,1714.3
4523556317,0,18,2,0,6,8,9,0,0,0,0,15582,6.6,16182,190,45,-1780,-1378,19.0,1558.2,17,3,1,8,6,7,1,0,1,0,17362,7.0,17560,229,43,1780,1378,22.9,1736.2
4526078945,1,22,2,1,6,4,7,0,0,0,0,16655,7.0,18545,217,51,474,-102,21.7,1665.5,12,4,0,4,6,11,1,1,0,0,16181,7.2,18647,234,63,-474,102,23.4,1618.1
4524018091,1,16,3,1,13,5,12,1,1,0,0,18748,7.0,17735,181,44,2236,337,18.1,1874.8,14,2,0,5,13,2,0,0,0,0,16512,6.6,17398,194,63,-2236,-337,19.4,1651.2
4522529196,0,39,1,0,3,7,4,0,0,0,0,14503,6.8,16807,207,47,-2825,-2497,20.7,1450.3,46,2,1,7,3,9,2,1,1,0,17328,7.2,19304,221,68,2825,2497,22.1,1732.8
4520493215,1,54,5,1,5,1,9,0,0,0,0,15675,6.8,17474,198,48,994,-85,19.8,1567.5,15,2,0,1,5,1,1,1,0,0,14681,7.0,17559,243,66,-994,85,24.3,1468.1
4524765561,0,15,3,1,5,7,6,1,1,0,1,16609,6.8,16960,216,33,-265,-2101,21.6,1660.9,16,1,0,7,5,3,0,0,0,0,16874,7.2,19061,225,70,265,2101,22.5,1687.4
4511593517,1,22,4,0,8,6,7,1,1,0,0,18070,7.2,19549,237,53,1263,590,23.7,1807.0,50,1,1,6,8,9,0,0,0,0,16807,7.4,18959,205,72,-1263,-590,20.5,1680.7
4499972378,0,39,4,0,1,5,2,1,1,0,0,14032,6.4,16940,220,53,-1935,-1534,22.0,1403.2,15,3,1,5,1,5,0,0,0,0,15967,7.2,18474,231,45,1935,1534,23.1,1596.7
4526076411,0,18,3,0,5,9,2,0,0,0,0,15278,6.8,17274,219,44,-3315,-1641,21.9,1527.8,15,6,1,9,5,7,1,0,1,0,18593,7.2,18915,227,56,3315,1641,22.7,1859.3
4508068981,1,11,4,1,6,4,4,1,1,0,0,17361,7.2,19308,208,72,1670,1765,20.8,1736.1,14,1,0,4,6,6,0,0,0,0,15691,6.8,17543,217,55,-1670,-1765,21.7,1569.1
4523807202,0,17,1,0,2,12,1,0,0,0,0,13170,6.2,15312,162,57,-5455,-2144,16.2,1317.0,18,2,1,12,2,10,0,0,0,0,18625,6.8,17456,211,34,5455,2144,21.1,1862.5
4500702645,0,20,5,0,6,5,10,0,0,0,0,17160,7.0,18228,241,47,1497,717,24.1,1716.0,17,7,1,5,6,4,1,1,0,0,15663,6.8,17511,218,40,-1497,-717,21.8,1566.3
4526042120,0,13,1,0,5,9,5,1,1,0,0,17006,7.2,18416,245,52,-1682,-1153,24.5,1700.6,15,2,1,9,5,12,0,0,0,0,18688,7.2,19569,260,47,1682,1153,26.0,1868.8
4474956980,1,14,2,0,6,3,7,1,1,0,0,16319,7.2,18982,207,59,1589,1075,20.7,1631.9,14,2,1,3,6,2,0,0,0,0,14730,6.6,17907,215,49,-1589,-1075,21.5,1473.0
4525009804,0,14,1,1,7,6,7,1,1,0,0,16938,7.2,18493,223,60,206,-453,22.3,1693.8,17,0,0,6,7,3,1,0,1,0,16732,7.4,18946,234,56,-206,453,23.4,1673.2
4445163609,1,18,6,1,8,5,6,1,0,1,0,17142,7.0,18245,221,38,2301,2562,22.1,1714.2,16,1,0,5,8,8,1,1,0,0,14841,6.4,15683,177,50,-2301,-2562,17.7,1484.1
4523589488,0,13,3,0,9,10,6,0,0,0,0,16774,7.0,17746,176,64,-1130,275,17.6,1677.4,59,2,1,10,9,12,0,0,0,0,17904,6.8,17471,206,32,1130,-275,20.6,1790.4
4478190403,1,18,4,0,7,9,5,0,0,0,0,16709,7.2,19029,227,48,-629,180,22.7,1670.9,17,4,1,9,7,9,0,0,0,0,17338,7.2,18849,223,56,629,-180,22.3,1733.8
4512184541,0,10,1,1,7,7,5,0,0,0,0,16463,6.8,17576,215,42,-93,-561,21.5,1646.3,33,0,0,7,7,8,1,1,0,0,16556,7.0,18137,217,40,93,561,21.7,1655.6
4459652574,0,19,1,1,6,7,2,1,1,0,0,14668,6.6,16843,198,40,-3686,-2333,19.8,1466.8,19,2,0,7,6,7,1,0,1,1,18354,7.2,19176,232,46,3686,2333,23.2,1835.4
4522480570,0,12,3,1,7,6,6,0,0,0,0,17197,7.2,18196,238,45,1125,-141,23.8,1719.7,38,0,0,6,7,6,0,0,0,0,16072,7.0,18337,205,65,-1125,141,20.5,1607.2
4527413086,1,49,5,0,6,9,10,0,0,0,0,16600,6.8,17594,213,56,-629,-1232,21.3,1660.0,22,5,1,9,6,10,0,0,0,0,17229,7.0,18826,203,33,629,1232,20.3,1722.9
4526765875,0,12,1,1,11,3,15,0,0,0,0,18420,7.4,19497,214,49,3865,3559,21.4,1842.0,15,1,0,3,11,3,1,1,0,0,14555,6.4,15938,203,46,-3865,-3559,20.3,1455.5
4526480699,0,8,3,1,6,5,7,1,0,1,0,15964,6.8,18133,217,51,-68,963,21.7,1596.4,55,1,0,5,6,9,1,1,0,0,16032,6.8,17170,198,51,68,-963,19.8,1603.2
4505683852,1,16,4,1,13,3,14,1,1,0,1,20955,7.2,19806,225,64,5136,2785,22.5,2095.5,13,2,0,3,13,3,0,0,0,0,15819,6.8,17021,213,60,-5136,-2785,21.3,1581.9
4507561885,0,17,5,0,1,5,2,0,0,0,0,14297,6.6,16721,235,54,-2955,-3054,23.5,1429.7,59,2,1,5,1,4,1,1,0,0,17252,7.2,19775,257,68,2955,3054,25.7,1725.2
4485735117,1,19,6,0,4,5,4,1,0,1,0,15522,7.0,18317,214,63,-1071,-120,21.4,1552.2,30,10,1,5,4,7,1,1,0,0,16593,7.2,18437,246,64,1071,120,24.6,1659.3
4527811425,1,46,2,1,5,3,2,0,0,0,0,16923,7.2,19758,222,72,1974,1712,22.2,1692.3,11,0,0,3,5,5,1,1,0,0,14949,6.8,18046,202,64,-1974,-1712,20.2,1494.9
4456349492,0,45,2,1,9,4,6,2,1,1,0,18233,7.6,21650,244,58,3319,5284,24.4,1823.3,12,15,0,4,9,7,0,0,0,0,14914,6.6,16366,177,53,-3319,-5284,17.7,1491.4
4478771848,0,18,3,0,2,9,4,0,0,0,0,14599,6.8,17147,220,45,-4196,-1649,22.0,1459.9,18,2,1,9,2,7,1,0,1,1,18795,7.0,18796,244,52,4196,1649,24.4,1879.5
4519844480,0,41,0,0,4,17,4,0,0,0,0,14838,6.0,15075,180,44,-6265,-3518,18.0,1483.8,14,13,1,17,4,24,1,0,1,0,21103,7.0,18593,194,28,6265,3518,19.4,2110.3
4476303520,0,19,4,0,5,3,5,1,1,0,0,15959,7.2,18751,244,52,786,1155,24.4,1595.9,17,2,1,3,5,5,0,0,0,0,15173,6.8,17596,238,49,-786,-1155,23.8,1517.3
4492916042,1,19,2,1,8,3,10,1,0,1,0,18272,7.2,19342,233,58,3723,3777,23.3,1827.2,15,1,0,3,8,3,1,1,0,0,14549,6.4,15565,196,51,-3723,-3777,19.6,1454.9
4524785066,0,20,1,0,8,6,7,0,0,0,0,17137,7.2,18448,192,44,1025,-199,19.2,1713.7,13,4,1,6,8,4,1,1,0,0,16112,6.8,18647,187,56,-1025,199,18.7,1611.2
4524245111,0,16,2,0,6,5,4,1,1,0,0,16398,6.6,17974,236,53,768,505,23.6,1639.8,56,5,1,5,6,5,0,0,0,0,15630,7.0,17469,218,49,-768,-505,21.8,1563.0
4527203867,0,17,3,0,1,10,0,0,0,0,0,13881,6.6,16578,215,55,-3756,-1406,21.5,1388.1,40,3,1,10,1,10,1,1,0,0,17637,7.2,17984,184,40,3756,1406,18.4,1763.7
4525366511,1,18,2,0,1,3,3,0,0,0,0,14289,6.8,17513,246,41,-1222,-874,24.6,1428.9,11,4,1,3,1,3,2,1,1,0,15511,6.8,18387,248,60,1222,874,24.8,1551.1
4515483154,1,34,1,0,8,5,8,1,1,0,0,17204,7.2,19878,215,66,803,2597,21.5,1720.4,16,2,1,5,8,7,0,0,0,0,16401,6.8,17281,216,53,-803,-2597,21.6,1640.1
4442002416,1,18,3,0,5,2,3,0,0,0,0,16337,7.2,19371,259,48,1795,1933,25.9,1633.7,15,6,1,2,5,2,0,0,0,0,14542,6.8,17438,238,48,-1795,-1933,23.8,1454.2
4522792539,0,16,2,1,5,3,3,0,0,0,0,14818,6.4,16417,204,28,-1460,-2414,20.4,1481.8,13,2,0,3,5,3,0,0,0,0,16278,7.4,18831,231,59,1460,2414,23.1,1627.8
4441457542,1,15,2,1,9,6,10,1,1,0,0,17592,7.4,19457,213,52,1572,2134,21.3,1759.2,16,4,0,6,9,9,1,0,1,0,16020,6.8,17323,211,42,-1572,-2134,21.1,1602.0
4524145810,1,17,6,1,10,8,12,1,1,0,0,17756,7.0,18320,201,40,-145,-28,20.1,1775.6,21,3,0,8,10,5,0,0,0,0,17901,7.0,18348,219,59,145,28,21.9,1790.1
4514486650,1,15,2,1,4,7,7,0,0,0,0,15662,6.8,17214,202,42,-130,-624,20.2,1566.2,16,3,0,7,4,9,1,1,0,0,15792,6.8,17838,200,35,130,624,20.0,1579.2
4489494920,0,13,0,0,2,9,4,0,0,0,0,13916,6.2,15087,166,49,-6286,-4733,16.6,1391.6,34,1,1,9,2,8,2,1,1,1,20202,7.6,19820,259,58,6286,4733,25.9,2020.2
4523900693,1,17,3,1,8,5,8,2,1,1,0,17523,7.0,18222,240,51,1928,1805,24.0,1752.3,13,3,0,5,8,7,0,0,0,0,15595,6.8,16417,209,45,-1928,-1805,20.9,1559.5
4483094981,1,16,3,0,6,4,8,1,1,0,0,17505,7.2,18661,240,66,791,1138,24.0,1750.5,16,2,1,4,6,5,0,0,0,0,16714,6.6,17523,234,49,-791,-1138,23.4,1671.4
4510215799,0,14,1,1,9,8,8,1,1,0,0,18239,7.2,19135,228,54,640,411,22.8,1823.9,9,4,0,8,9,8,0,0,0,0,17599,7.2,18724,240,35,-640,-411,24.0,1759.9
4458138022,1,39,6,1,6,3,5,1,1,0,0,15829,7.2,17888,205,61,265,241,20.5,1582.9,18,2,0,3,6,1,1,0,1,0,15564,6.8,17647,204,48,-265,-241,20.4,1556.4
4518992502,1,11,4,1,4,3,3,1,0,1,1,17143,7.2,18702,237,57,2043,1866,23.7,1714.3,14,2,0,3,4,4,1,1,0,0,15100,6.4,16836,236,45,-2043,-1866,23.6,1510.0
4521081622,0,14,2,1,8,10,5,1,1,0,0,16589,6.8,17707,221,44,-1302,-90,22.1,1658.9,18,6,0,10,8,14,0,0,0,0,17891,7.0,17797,207,50,1302,90,20.7,1789.1
4522804961,1,39,4,1,2,8,3,0,0,0,0,14952,6.8,17963,264,43,-2262,-668,26.4,1495.2,19,4,0,8,2,4,0,0,0,0,17214,7.4,18631,244,49,2262,668,24.4,1721.4
4454458141,0,16,2,0,4,7,4,0,0,0,0,16216,7.0,17978,233,40,-872,-432,23.3,1621.6,86,5,1,7,4,8,1,0,1,0,17088,7.0,18410,213,53,872,432,21.3,1708.8
4525237424,1,17,2,1,13,2,10,1,0,1,1,21046,7.4,19706,250,45,7995,4733,25.0,2104.6,15,0,0,2,13,0,0,0,0,0,13051,6.4,14973,179,49,-7995,-4733,17.9,1305.1
4494913568,0,16,3,1,7,11,11,0,0,0,0,17037,7.0,18710,243,47,-1896,-1756,24.3,1703.7,15,2,0,11,7,13,1,1,0,0,18933,7.4,20466,243,50,1896,1756,24.3,1893.3
4526872931,0,14,4,1,3,4,5,0,0,0,0,15776,7.0,17726,261,52,969,1563,26.1,1577.6,26,1,0,4,3,5,1,1,0,0,14807,6.8,16163,207,44,-969,-1563,20.7,1480.7
4497467967,0,14,3,1,8,6,7,0,0,0,0,16451,6.6,16842,191,34,359,-772,19.1,1645.1,38,2,0,6,8,6,0,0,0,0,16092,7.0,17614,195,51,-359,772,19.5,1609.2
4500029436,1,14,2,1,9,3,12,0,0,0,1,19138,6.8,18317,239,40,3653,1553,23.9,1913.8,17,1,0,3,9,4,1,0,1,1,15485,6.6,16764,193,50,-3653,-1553,19.3,1548.5
4517836612,1,14,4,1,8,5,8,1,1,0,0,18021,7.2,19358,253,52,1790,1764,25.3,1802.1,25,1,0,5,8,4,0,0,0,0,16231,7.0,17594,237,47,-1790,-1764,23.7,1623.1
4503284837,0,17,3,0,7,7,5,1,1,0,0,16554,7.0,18512,235,33,-776,166,23.5,1655.4,16,3,1,7,7,14,0,0,0,0,17330,6.8,18346,259,36,776,-166,25.9,1733.0
4519740726,0,14,1,1,6,7,5,0,0,0,0,16688,6.8,17793,213,44,-214,-334,21.3,1668.8,36,2,0,7,6,8,1,1,0,0,16902,7.0,18127,201,71,214,334,20.1,1690.2
4488603223,1,14,6,1,7,3,7,0,0,0,0,16718,7.0,18415,200,48,558,-1308,20.0,1671.8,17,3,0,3,7,2,0,0,0,0,16160,7.2,19723,225,80,-558,1308,22.5,1616.0
4464352676,1,17,3,0,7,10,7,1,0,1,0,16375,6.8,17469,177,51,-3183,-1884,17.7,1637.5,15,5,1,10,7,9,0,0,0,1,19558,7.2,19353,236,72,3183,1884,23.6,1955.8
4516789805,1,17,2,0,9,4,8,1,0,1,1,19484,7.2,20010,267,52,3538,2904,26.7,1948.4,16,4,1,4,9,4,1,1,0,0,15946,6.6,17106,230,52,-3538,-2904,23.0,1594.6
4500335888,1,14,2,0,7,4,5,1,1,0,0,17052,7.2,19250,234,64,1648,1881,23.4,1705.2,16,3,1,4,7,4,0,0,0,0,15404,6.6,17369,223,38,-1648,-1881,22.3,1540.4
4518693297,0,14,0,0,6,7,9,0,0,0,0,16060,6.6,16426,187,50,-1776,-3265,18.7,1606.0,14,1,1,7,6,7,0,0,0,0,17836,7.2,19691,248,60,1776,3265,24.8,1783.6
4469108094,0,38,2,1,6,13,6,1,1,0,0,15230,6.6,16550,165,56,-4403,-3750,16.5,1523.0,14,1,0,13,6,14,0,0,0,0,19633,7.4,20300,238,40,4403,3750,23.8,1963.3
4493956476,1,18,2,1,10,7,8,1,1,0,1,19301,7.2,19342,212,68,3471,2708,21.2,1930.1,19,1,0,7,10,5,0,0,0,0,15830,6.6,16634,197,55,-3471,-2708,19.7,1583.0
4522273476,1,15,5,0,6,7,4,1,0,1,0,17248,7.0,19160,242,56,993,1759,24.2,1724.8,21,1,1,7,6,7,1,1,0,0,16255,6.8,17401,192,52,-993,-1759,19.2,1625.5
4468198399,0,13,0,1,1,3,2,2,1,1,0,14675,7.0,18039,231,75,-1749,-1502,23.1,1467.5,15,3,0,3,1,2,0,0,0,0,16424,7.4,19541,264,60,1749,1502,26.4,1642.4
4473400880,1,25,2,0,4,4,3,1,0,1,0,15551,6.8,17278,206,56,43,-1092,20.6,1555.1,17,5,1,4,4,2,1,1,0,0,15508,6.8,18370,218,65,-43,1092,21.8,1550.8
4413670399,0,20,3,0,9,8,14,1,1,0,0,17494,6.8,17832,201,44,14,202,20.1,1749.4,17,3,1,8,9,9,0,0,0,0,17480,7.0,17630,243,44,-14,-202,24.3,1748.0
4440516925,0,23,3,0,9,7,11,0,0,0,0,17616,7.0,18731,195,73,356,565,19.5,1761.6,39,7,1,7,9,8,0,0,0,0,17260,7.0,18166,208,55,-356,-565,20.8,1726.0
4523664992,0,42,5,1,10,5,11,0,0,0,0,19636,7.2,19567,247,55,4253,2731,24.7,1963.6,18,2,0,5,10,6,2,1,1,0,15383,6.6,16836,209,56,-4253,-2731,20.9,1538.3
4494893980,0,17,0,0,4,5,3,1,1,0,0,15041,7.0,16622,214,43,-1207,-1748,21.4,1504.1,13,3,1,5,4,3,0,0,0,0,16248,7.0,18370,228,60,1207,1748,22.8,1624.8
4506972533,0,9,0,1,2,5,3,1,1,0,0,14930,6.8,17328,231,61,-3418,-2689,23.1,1493.0,14,2,0,5,2,3,0,0,0,1,18348,7.4,20017,263,65,3418,2689,26.3,1834.8
4521070500,1,16,4,0,4,3,4,0,0,0,0,15616,6.8,18728,224,40,441,379,22.4,1561.6,15,2,1,3,4,2,0,0,0,0,15175,6.8,18349,230,48,-441,-379,23.0,1517.5
4527398202,0,64,4,0,7,9,13,1,1,0,0,17432,7.0,17080,200,52,-399,-1348,20.0,1743.2,29,4,1,9,7,11,0,0,0,0,17831,7.0,18428,203,48,399,1348,20.3,1783.1
4497085879,0,17,2,0,3,8,4,0,0,0,0,16004,7.2,18128,241,64,-966,-455,24.1,1600.4,12,4,1,8,3,9,0,0,0,0,16970,7.2,18583,213,48,966,455,21.3,1697.0
4511623078,1,42,3,0,1,4,1,1,1,0,0,14322,6.8,17759,236,48,-1970,-1177,23.6,1432.2,28,5,1,4,1,5,1,0,1,0,16292,7.0,18936,222,77,1970,1177,22.2,1629.2
4467388375,1,16,2,1,9,1,7,2,1,1,0,17710,7.2,19233,230,55,4311,3239,23.0,1771.0,12,1,0,1,9,0,0,0,0,0,13399,6.6,15994,201,44,-4311,-3239,20.1,1339.9
4515510441,0,72,4,1,6,5,5,1,0,1,0,16372,6.8,17570,234,42,1506,-265,23.4,1637.2,39,3,0,5,6,3,1,1,0,0,14866,6.8,17835,200,59,-1506,265,20.0,1486.6
4490168381,0,20,2,0,3,6,3,0,0,0,0,15487,7.0,18816,238,68,-1854,-817,23.8,1548.7,13,1,1,6,3,6,2,1,1,0,17341,7.2,19633,232,64,1854,817,23.2,1734.1
4525301191,1,12,2,0,6,8,6,0,0,0,0,16047,6.8,18460,250,32,-518,-268,25.0,1604.7,16,3,1,8,6,3,2,1,1,0,16565,7.2,18728,211,47,518,268,21.1,1656.5
4483835380,0,16,2,1,5,10,3,1,0,1,0,16199,6.8,17974,216,52,-2482,-2515,21.6,1619.9,14,3,0,10,5,13,1,1,0,0,18681,7.4,20489,219,60,2482,2515,21.9,1868.1
4452298627,1,14,4,1,15,4,19,1,1,0,0,21314,7.2,19360,245,32,6950,3536,24.5,2131.4,15,2,0,4,15,2,0,0,0,0,14364,6.4,15824,193,37,-6950,-3536,19.3,1436.4
4525135236,1,13,3,0,3,6,3,1,0,1,0,15742,7.0,18244,220,64,-873,-1792,22.0,1574.2,16,4,1,6,3,6,0,0,0,0,16615,7.4,20036,215,62,873,1792,21.5,1661.5
4477325608,1,16,2,1,8,3,9,2,1,1,0,17706,6.8,17285,221,52,3588,1289,22.1,1770.6,45,1,0,3,8,4,0,0,0,0,14118,6.6,15996,190,52,-3588,-1289,19.0,1411.8
4524629083,1,17,1,1,8,4,11,1,1,0,0,17008,7.2,18943,197,65,2135,1653,19.7,1700.8,17,2,0,4,8,3,0,0,0,0,14873,6.8,17290,205,40,-2135,-1653,20.5,1487.3
4520804983,0,15,0,0,3,12,2,0,0,0,0,14921,6.4,15556,196,54,-3640,-3482,19.6,1492.1,14,2,1,12,3,16,1,1,0,0,18561,7.2,19038,210,58,3640,3482,21.0,1856.1
4508188493,1,73,2,0,9,5,10,0,0,0,0,17578,7.2,19495,213,52,1989,2500,21.3,1757.8,16,0,1,5,9,5,1,1,0,0,15589,6.8,16995,218,44,-1989,-2500,21.8,1558.9
4475014594,1,19,0,0,9,1,8,0,0,0,0,18018,7.4,19634,234,60,4287,3536,23.4,1801.8,14,1,1,1,9,0,1,1,0,0,13731,6.6,16098,209,47,-4287,-3536,20.9,1373.1
4523916920,1,58,2,0,8,5,11,0,0,0,0,16748,6.8,17343,209,41,873,215,20.9,1674.8,143,2,1,5,8,5,0,0,0,0,15875,7.0,17128,235,48,-873,-215,23.5,1587.5
4450170058,0,19,4,1,8,3,11,1,0,1,0,16565,6.8,17417,204,45,1217,309,20.4,1656.5,74,4,0,3,8,2,0,0,0,0,15348,6.6,17108,214,45,-1217,-309,21.4,1534.8
4509319311,1,18,2,1,8,5,12,1,1,0,0,17846,7.0,18097,192,67,2425,824,19.2,1784.6,15,1,0,5,8,4,1,0,1,0,15421,6.8,17273,215,48,-2425,-824,21.5,1542.1
4468761566,0,15,1,1,4,8,6,0,0,0,0,14808,6.6,16376,180,42,-3363,-1920,18.0,1480.8,12,4,0,8,4,7,0,0,0,0,18171,7.0,18296,212,49,3363,1920,21.2,1817.1
4511865034,0,16,2,1,6,8,10,0,0,0,0,16661,7.0,18206,233,44,171,807,23.3,1666.1,18,3,0,8,6,10,0,0,0,0,16490,7.0,17399,229,29,-171,-807,22.9,1649.0
4506241300,0,24,1,1,4,5,5,0,0,0,0,15758,6.4,16906,211,50,628,-558,21.1,1575.8,52,1,0,5,4,9,1,1,0,0,15130,6.8,17464,205,37,-628,558,20.5,1513.0
4518928631,1,19,1,1,8,2,7,0,0,0,0,16424,6.8,17611,196,48,2588,1543,19.6,1642.4,14,4,0,2,8,0,1,0,1,0,13836,6.6,16068,185,60,-2588,-1543,18.5,1383.6
4527479817,1,36,3,0,3,5,2,2,1,1,0,15581,7.0,18847,233,72,-353,-280,23.3,1558.1,18,9,1,5,3,4,0,0,0,0,15934,7.4,19127,228,48,353,280,22.8,1593.4
4509431261,1,47,0,1,5,3,7,0,0,0,0,16329,6.8,17600,205,48,1320,-178,20.5,1632.9,12,3,0,3,5,4,0,0,0,0,15009,6.8,17778,218,48,-1320,178,21.8,1500.9
4524222412,1,14,2,1,7,7,5,1,1,0,0,16045,6.8,17256,216,48,-282,-79,21.6,1604.5,12,1,0,7,7,9,1,0,1,0,16327,7.0,17335,182,53,282,79,18.2,1632.7
4527441922,0,78,4,0,8,5,9,0,0,0,0,16785,6.8,17837,186,48,-860,214,18.6,1678.5,16,3,1,5,8,7,1,1,0,0,17645,6.6,17623,236,56,860,-214,23.6,1764.5
4499266500,0,19,6,0,3,6,3,1,1,0,0,15025,6.6,17533,234,44,-2963,-1630,23.4,1502.5,59,3,1,6,3,6,1,0,1,0,17988,7.2,19163,252,56,2963,1630,25.2,1798.8
4525845524,0,13,3,0,5,4,10,0,0,0,0,16386,7.2,18530,218,56,-167,309,21.8,1638.6,12,1,1,4,5,3,1,0,1,0,16553,7.0,18221,230,49,167,-309,23.0,1655.3
4514740327,0,14,2,1,5,7,7,0,0,0,0,17224,6.8,18105,229,60,631,-265,22.9,1722.4,84,2,0,7,5,6,1,1,0,0,16593,7.2,18370,218,46,-631,265,21.8,1659.3
4517972804,1,17,2,1,6,3,6,1,1,0,0,17427,7.0,19221,249,63,1975,1433,24.9,1742.7,14,6,0,3,6,2,0,0,0,0,15452,7.0,17788,234,60,-1975,-1433,23.4,1545.2
4525816909,1,15,5,0,4,7,4,1,1,0,0,16526,7.0,18314,237,63,-36,-752,23.7,1652.6,16,5,1,7,4,8,0,0,0,0,16562,7.2,19066,225,60,36,752,22.5,1656.2
4512096466,1,15,2,1,8,1,11,1,1,0,0,18178,7.0,18563,233,52,5174,3105,23.3,1817.8,11,0,0,1,8,0,0,0,0,0,13004,6.2,15458,182,54,-5174,-3105,18.2,1300.4
4516926779,1,17,3,1,5,5,6,1,1,0,0,16191,7.2,18795,238,46,290,617,23.8,1619.1,15,3,0,5,5,3,0,0,0,0,15901,7.2,18178,242,44,-290,-617,24.2,1590.1
4495401600,1,16,1,1,2,4,2,1,1,0,0,14402,7.0,17604,193,64,-1506,-500,19.3,1440.2,15,2,0,4,2,6,0,0,0,0,15908,6.8,18104,227,52,1506,500,22.7,1590.8
4523819154,1,14,2,0,13,7,14,0,0,0,1,20294,7.0,17966,216,45,3903,1239,21.6,2029.4,15,0,1,7,13,5,0,0,0,0,16391,6.8,16727,171,44,-3903,-1239,17.1,1639.1
4522124566,1,33,3,0,6,9,10,0,0,0,0,16515,6.8,17223,208,45,-1020,493,20.8,1651.5,18,3,1,9,6,13,0,0,0,0,17535,6.6,16730,197,36,1020,-493,19.7,1753.5
4469638547,1,12,1,0,5,4,0,0,0,0,0,15297,7.0,18319,202,57,17,1052,20.2,1529.7,17,1,1,4,5,2,1,1,0,0,15280,6.6,17267,210,48,-17,-1052,21.0,1528.0
4524920095,0,22,2,0,1,9,1,0,0,0,0,13802,6.2,15859,216,56,-3276,-2790,21.6,1380.2,142,5,1,9,1,9,1,1,0,0,17078,7.0,18649,217,47,3276,2790,21.7,1707.8
4484449974,1,16,2,1,5,0,4,1,0,1,0,16475,7.2,18879,231,55,2741,868,23.1,1647.5,12,2,0,0,5,0,1,1,0,0,13734,7.0,18011,233,60,-2741,-868,23.3,1373.4
4515233268,1,14,4,1,7,7,7,2,1,1,0,17381,7.2,20017,221,76,1542,2179,22.1,1738.1,17,2,0,7,7,4,0,0,0,0,15839,7.0,17838,204,48,-1542,-2179,20.4,1583.9
4424203287,1,19,1,1,13,6,13,0,0,0,0,18901,7.2,19110,244,36,2972,1799,24.4,1890.1,14,2,0,6,13,4,0,0,0,0,15929,6.8,17311,206,52,-2972,-1799,20.6,1592.9
4447426572,1,17,3,0,8,6,7,1,1,0,0,17131,7.4,19719,240,43,819,2149,24.0,1713.1,13,5,1,6,8,9,0,0,0,0,16312,7.0,17570,206,52,-819,-2149,20.6,1631.2
4446151894,1,12,4,0,2,8,1,1,1,0,0,14906,6.8,17928,229,55,-2361,-1663,22.9,1490.6,12,1,1,8,2,10,1,0,1,0,17267,7.0,19591,230,52,2361,1663,23.0,1726.7
4502187260,1,17,0,0,5,5,7,1,1,0,0,16398,7.0,17450,218,52,455,524,21.8,1639.8,34,3,1,5,5,10,0,0,0,0,15943,6.6,16926,184,56,-455,-524,18.4,1594.3
4515910036,0,18,2,0,4,3,4,0,0,0,0,15987,7.0,18632,252,52,1033,372,25.2,1598.7,15,3,1,3,4,3,0,0,0,0,14954,7.0,18260,231,52,-1033,-372,23.1,1495.4
4513553506,1,39,1,1,8,11,8,0,0,0,0,17072,6.8,17724,180,63,-2298,-730,18.0,1707.2,13,2,0,11,8,5,2,1,1,1,19370,7.0,18454,242,48,2298,730,24.2,1937.0
4507747871,1,18,1,1,6,5,6,0,0,0,0,16471,6.8,17952,246,36,1450,763,24.6,1647.1,18,2,0,5,6,3,0,0,0,0,15021,6.8,17189,200,40,-1450,-763,20.0,1502.1
4505960953,1,16,3,0,10,7,12,0,0,0,0,17839,7.0,18614,201,48,1452,689,20.1,1783.9,39,1,1,7,10,5,1,1,0,0,16387,7.2,17925,198,56,-1452,-689,19.8,1638.7
4519602935,1,39,1,0,8,5,11,0,0,0,0,17123,6.8,17944,223,52,1012,-620,22.3,1712.3,29,4,1,5,8,3,0,0,0,0,16111,7.4,18564,220,52,-1012,620,22.0,1611.1
4446790862,0,14,3,0,4,3,2,0,0,0,0,15744,7.6,20593,234,67,419,1790,23.4,1574.4,16,2,1,3,4,0,1,1,0,0,15325,7.2,18803,263,52,-419,-1790,26.3,1532.5
4515642835,1,13,2,1,16,5,17,1,1,0,0,21297,7.2,19371,221,42,6439,4362,22.1,2129.7,14,0,0,5,16,7,1,0,1,0,14858,6.2,15009,165,43,-6439,-4362,16.5,1485.8
4477228841,0,17,2,0,10,5,11,0,0,0,0,17505,6.8,17635,224,43,1841,-591,22.4,1750.5,48,3,1,5,10,2,1,1,0,0,15664,6.8,18226,197,88,-1841,591,19.7,1566.4
4447390730,1,17,1,0,8,6,13,0,0,0,0,17731,7.0,18478,256,34,709,1296,25.6,1773.1,13,1,1,6,8,5,0,0,0,0,17022,6.8,17182,229,54,-709,-1296,22.9,1702.2
4513334307,0,12,0,0,1,6,0,0,0,0,0,14748,6.8,17867,212,61,-2619,-1215,21.2,1474.8,45,0,1,6,1,8,1,1,0,0,17367,7.2,19082,237,65,2619,1215,23.7,1736.7
4512489838,1,13,3,1,8,3,12,1,1,0,0,19038,7.2,18856,239,44,4034,1938,23.9,1903.8,16,2,0,3,8,4,0,0,0,0,15004,6.8,16918,228,49,-4034,-1938,22.8,1500.4
4478467708,1,19,3,1,4,3,2,1,1,0,0,16029,7.4,19239,236,71,771,1255,23.6,1602.9,13,5,0,3,4,3,1,0,1,0,15258,7.0,17984,208,64,-771,-1255,20.8,1525.8
4514218237,1,17,5,1,9,13,11,0,0,0,0,17635,6.6,16554,175,42,-1430,-2349,17.5,1763.5,12,4,0,13,9,13,1,1,0,0,19065,7.2,18903,219,53,1430,2349,21.9,1906.5
4511803387,1,17,2,0,8,8,5,0,0,0,0,16918,6.8,18396,216,60,355,-336,21.6,1691.8,18,2,1,8,8,6,1,1,0,0,16563,6.8,18732,214,44,-355,336,21.4,1656.3
4491026919,0,17,3,0,7,12,5,0,0,0,0,15674,6.4,15931,206,42,-3878,-3868,20.6,1567.4,37,3,1,12,7,15,1,1,0,0,19552,7.2,19799,207,55,3878,3868,20.7,1955.2
4481234929,1,24,1,1,8,4,8,0,0,0,0,17448,6.8,18315,242,48,2551,1754,24.2,1744.8,17,1,0,4,8,7,0,0,0,0,14897,6.6,16561,195,46,-2551,-1754,19.5,1489.7
4511761586,1,45,5,0,6,7,8,1,1,0,0,17046,7.4,19783,217,67,307,2085,21.7,1704.6,16,7,1,7,6,7,0,0,0,0,16739,7.0,17698,256,40,-307,-2085,25.6,1673.9
4526364415,1,14,4,1,5,6,4,1,1,0,0,15063,6.6,16316,198,43,-1547,-1049,19.8,1506.3,19,1,0,6,5,3,0,0,0,0,16610,6.8,17365,229,40,1547,1049,22.9,1661.0
4527210853,0,15,1,1,6,5,4,0,0,0,0,16663,7.0,18493,227,64,-29,-997,22.7,1666.3,11,2,0,5,6,4,1,1,0,0,16692,7.4,19490,225,76,29,997,22.5,1669.2
4500845726,0,18,5,1,4,7,3,2,1,1,0,15420,6.8,17930,235,43,-2264,-1389,23.5,1542.0,18,7,0,7,4,7,0,0,0,0,17684,7.4,19319,237,69,2264,1389,23.7,1768.4
4527087399,1,13,1,0,6,7,6,0,0,0,0,16070,6.6,17613,194,48,-1245,-971,19.4,1607.0,13,2,1,7,6,10,1,1,0,0,17315,7.0,18584,237,60,1245,971,23.7,1731.5
4527547442,0,13,5,0,2,11,2,0,0,0,0,13794,6.4,15813,190,55,-4192,-3984,19.0,1379.4,41,2,1,11,2,9,1,1,0,0,17986,7.2,19797,220,56,4192,3984,22.0,1798.6
4508400080,0,13,1,1,7,7,7,1,0,1,0,17214,7.2,18232,219,44,1465,1232,21.9,1721.4,23,1,0,7,7,4,1,1,0,0,15749,6.8,17000,193,49,-1465,-1232,19.3,1574.9
4519598858,0,84,0,0,6,14,5,0,0,0,0,15740,6.4,15862,177,49,-4093,-2844,17.7,1574.0,22,1,1,14,6,16,1,1,0,0,19833,7.2,18706,208,41,4093,2844,20.8,1983.3
4520868941,0,16,2,1,7,3,12,0,0,0,0,16175,6.6,16320,202,45,1426,524,20.2,1617.5,13,0,0,3,7,2,0,0,0,0,14749,6.6,15796,204,53,-1426,-524,20.4,1474.9
4524102551,1,14,3,1,10,4,12,1,1,0,0,18246,7.0,18509,229,45,2914,2052,22.9,1824.6,20,0,0,4,10,3,0,0,0,0,15332,6.4,16457,209,40,-2914,-2052,20.9,1533.2
4509731255,0,34,0,0,8,9,5,2,1,1,0,15889,6.8,17078,177,36,-2212,-1682,17.7,1588.9,17,3,1,9,8,8,0,0,0,0,18101,7.2,18760,212,55,2212,1682,21.2,1810.1
4509649121,0,36,2,0,6,12,4,1,0,1,0,15727,6.2,15909,171,49,-2467,-1494,17.1,1572.7,15,3,1,12,6,13,0,0,0,0,18194,7.0,17403,202,35,2467,1494,20.2,1819.4
4527579733,1,15,2,1,5,4,5,2,1,1,1,17284,6.4,16215,185,56,2115,-207,18.5,1728.4,13,2,0,4,5,4,0,0,0,0,15169,6.4,16422,215,38,-2115,207,21.5,1516.9
4469404175,1,15,4,0,4,5,5,0,0,0,0,15329,6.8,17425,210,59,-486,180,21.0,1532.9,59,4,1,5,4,9,1,1,0,0,15815,6.8,17245,218,48,486,-180,21.8,1581.5
4490153462,1,12,0,0,5,6,8,1,1,0,0,16891,6.8,18030,185,48,286,17,18.5,1689.1,44,4,1,6,5,12,0,0,0,0,16605,6.8,18013,214,47,-286,-17,21.4,1660.5
4519757123,1,13,1,1,7,2,12,1,1,0,0,17196,7.0,18109,204,60,2177,186,20.4,1719.6,14,2,0,2,7,0,0,0,0,0,15019,7.0,17923,237,68,-2177,-186,23.7,1501.9
4503435524,0,35,3,0,2,5,1,0,0,0,0,14616,7.0,18564,242,48,-1441,55,24.2,1461.6,14,2,1,5,2,7,1,1,0,0,16057,6.8,18509,207,67,1441,-55,20.7,1605.7
4297422468,0,18,2,0,4,6,0,0,0,0,0,14827,6.6,17370,207,55,-2713,-1237,20.7,1482.7,20,6,1,6,4,11,2,1,1,0,17540,7.2,18607,247,56,2713,1237,24.7,1754.0
4525376845,0,31,2,0,4,1,5,2,1,1,0,15612,7.0,17678,234,61,1518,1208,23.4,1561.2,16,2,1,1,4,2,0,0,0,0,14094,6.8,16470,213,50,-1518,-1208,21.3,1409.4
4514375184,0,14,4,0,2,6,2,1,1,0,0,15300,7.0,18001,266,53,-978,-849,26.6,1530.0,17,2,1,6,2,8,0,0,0,0,16278,7.0,18850,228,48,978,849,22.8,1627.8
4524202231,1,14,2,1,9,4,6,1,1,0,0,18532,7.4,20134,231,55,3195,1370,23.1,1853.2,124,2,0,4,9,1,0,0,0,0,15337,7.2,18764,223,64,-3195,-1370,22.3,1533.7
4524898473,1,13,3,0,8,13,8,1,0,1,1,18954,6.8,17795,228,46,-664,-549,22.8,1895.4,14,3,1,13,8,13,1,1,0,1,19618,7.0,18344,182,57,664,549,18.2,1961.8
4515307399,0,18,1,1,5,8,5,0,0,0,0,16659,7.0,17777,234,60,-1003,-899,23.4,1665.9,15,1,0,8,5,7,2,1,1,0,17662,7.0,18676,217,59,1003,899,21.7,1766.2
4524432765,1,17,3,1,3,8,3,0,0,0,0,14650,6.8,16684,192,36,-2003,-1611,19.2,1465.0,19,5,0,8,3,11,0,0,0,0,16653,7.0,18295,195,43,2003,1611,19.5,1665.3
4519852110,0,12,3,0,4,8,5,1,0,1,0,14949,6.4,16818,180,44,-3238,-1130,18.0,1494.9,18,4,1,8,4,9,1,1,0,0,18187,7.0,17948,259,40,3238,1130,25.9,1818.7
4519431997,0,15,5,0,10,7,6,0,0,0,0,18269,7.2,19161,228,60,1974,861,22.8,1826.9,39,2,1,7,10,8,2,1,1,0,16295,7.0,18300,199,56,-1974,-861,19.9,1629.5
4521611009,0,13,2,1,7,12,9,0,0,0,0,15938,6.2,14724,194,36,-1985,-3666,19.4,1593.8,40,2,0,12,7,13,1,1,0,0,17923,7.2,18390,187,44,1985,3666,18.7,1792.3
4524538726,1,13,4,1,7,5,5,0,0,0,0,16704,7.0,18000,225,47,1002,-743,22.5,1670.4,15,1,0,5,7,8,2,1,1,0,15702,7.4,18743,212,62,-1002,743,21.2,1570.2
4526670419,0,41,3,0,6,10,3,0,0,0,0,16531,7.4,19310,226,59,-1114,-398,22.6,1653.1,37,3,1,10,6,10,1,1,0,0,17645,7.4,19708,199,58,1114,398,19.9,1764.5
4515398027,1,14,4,0,9,6,5,1,0,1,0,17025,7.4,19492,214,52,1399,2616,21.4,1702.5,37,3,1,6,9,5,0,0,0,0,15626,6.6,16876,181,45,-1399,-2616,18.1,1562.6
4505447619,1,16,6,0,4,9,8,1,1,0,0,16541,7.0,18666,225,60,-1514,-629,22.5,1654.1,20,1,1,9,4,8,0,0,0,0,18055,7.4,19295,239,45,1514,629,23.9,1805.5
4471258643,1,15,2,0,9,6,9,0,0,0,0,17174,6.8,18060,212,32,1514,1421,21.2,1717.4,37,1,1,6,9,6,1,0,1,0,15660,6.8,16639,187,44,-1514,-1421,18.7,1566.0
4511924460,1,17,3,1,9,8,10,0,0,0,0,17875,6.8,17347,212,45,1171,-841,21.2,1787.5,15,3,0,8,9,11,0,0,0,0,16704,7.2,18188,190,49,-1171,841,19.0,1670.4
4523038928,1,13,2,1,5,1,4,1,1,0,0,16733,7.2,19451,232,62,2685,2307,23.2,1673.3,20,1,0,1,5,2,0,0,0,0,14048,6.8,17144,207,63,-2685,-2307,20.7,1404.8
4493323952,1,17,4,0,8,3,14,0,0,0,1,18823,6.6,18188,245,47,4509,2253,24.5,1882.3,14,4,1,3,8,2,1,1,0,0,14314,6.6,15935,218,40,-4509,-2253,21.8,1431.4
4471300267,0,16,2,1,7,4,8,1,1,0,0,17788,7.2,19078,255,58,1969,1497,25.5,1778.8,16,2,0,4,7,4,1,0,1,0,15819,6.8,17581,234,49,-1969,-1497,23.4,1581.9
4519989854,1,22,3,1,10,3,8,2,1,1,0,19082,7.2,18868,231,60,5391,2596,23.1,1908.2,13,5,0,3,10,2,0,0,0,0,13691,6.2,16272,176,48,-5391,-2596,17.6,1369.1
4452485048,1,14,2,1,10,4,11,1,1,0,0,18969,7.6,20353,205,63,4139,3424,20.5,1896.9,18,0,0,4,10,2,0,0,0,0,14830,6.8,16929,172,61,-4139,-3424,17.2,1483.0
4523059418,0,19,1,1,10,8,12,1,0,1,0,17552,7.2,18284,222,39,1050,-1270,22.2,1755.2,35,2,0,8,10,5,1,1,0,0,16502,7.4,19554,192,46,-1050,1270,19.2,1650.2
4525985539,1,13,1,1,11,5,9,0,0,0,0,18590,7.0,18992,215,44,2945,2019,21.5,1859.0,14,1,0,5,11,7,1,0,1,0,15645,6.6,16973,202,48,-2945,-2019,20.2,1564.5
4492498778,0,46,1,0,8,11,7,0,0,0,0,17917,7.2,19033,234,55,39,-27,23.4,1791.7,30,2,1,11,8,13,1,1,0,0,17878,7.2,19060,180,59,-39,27,18.0,1787.8
4463166329,1,16,2,1,7,7,7,2,1,1,0,16559,7.2,18848,235,43,-167,39,23.5,1655.9,13,3,0,7,7,5,0,0,0,0,16726,7.0,18809,237,48,167,-39,23.7,1672.6
4524110261,0,12,0,0,6,10,4,0,0,0,0,15475,6.4,15944,205,42,-2395,-3117,20.5,1547.5,37,1,1,10,6,13,1,1,0,0,17870,7.2,19061,210,53,2395,3117,21.0,1787.0
4497473518,0,14,3,0,8,7,7,2,1,1,0,17996,7.0,18896,208,64,1295,435,20.8,1799.6,41,4,1,7,8,5,0,0,0,0,16701,7.0,18461,227,52,-1295,-435,22.7,1670.1
4521361583,0,16,4,0,8,9,8,0,0,0,0,15726,6.4,16968,176,45,-3796,-326,17.6,1572.6,17,7,1,9,8,7,0,0,0,1,19522,6.8,17294,219,40,3796,326,21.9,1952.2
4455419098,0,15,4,1,7,9,4,0,0,0,0,15947,7.0,17802,204,56,-2086,-2017,20.4,1594.7,18,4,0,9,7,10,1,1,0,0,18033,7.2,19819,188,64,2086,2017,18.8,1803.3
4421824314,0,41,3,0,10,4,8,1,0,1,0,17724,7.4,19917,210,43,3192,3351,21.0,1772.4,15,4,1,4,10,2,0,0,0,0,14532,6.6,16566,205,39,-3192,-3351,20.5,1453.2
4505623673,1,13,5,1,8,6,6,0,0,0,0,17520,7.0,18523,220,48,996,116,22.0,1752.0,20,1,0,6,8,6,1,1,0,0,16524,6.8,18407,221,43,-996,-116,22.1,1652.4
4504197539,0,13,2,0,3,5,3,0,0,0,0,15553,7.2,18934,244,55,-1449,-349,24.4,1555.3,41,5,1,5,3,3,0,0,0,0,17002,7.2,19283,250,76,1449,349,25.0,1700.2
4508091967,0,17,1,0,2,8,1,0,0,0,0,14467,6.6,16928,215,48,-3794,-1962,21.5,1446.7,16,2,1,8,2,11,1,1,0,0,18261,7.2,18890,234,76,3794,1962,23.4,1826.1
4505421525,0,14,3,0,4,9,2,0,0,0,0,14882,6.6,17103,192,36,-5337,-2474,19.2,1488.2,17,2,1,9,4,12,2,1,1,1,20219,7.2,19577,249,56,5337,2474,24.9,2021.9
4419100258,0,15,1,0,3,5,3,0,0,0,0,15820,6.8,17793,220,55,-306,-282,22.0,1582.0,17,4,1,5,3,8,2,1,1,0,16126,7.0,18075,222,52,306,282,22.2,1612.6
4524033878,1,23,3,0,9,10,7,0,0,0,0,18090,6.8,17730,229,36,1106,470,22.9,1809.0,18,2,1,10,9,12,1,0,1,0,16984,7.0,17260,204,38,-1106,-470,20.4,1698.4
4525306254,0,41,22,1,6,7,7,0,0,0,0,16528,6.8,17624,212,46,-449,-1347,21.2,1652.8,41,0,0,7,6,6,0,0,0,0,16977,7.2,18971,235,53,449,1347,23.5,1697.7
4524296354,0,13,1,0,9,15,8,1,1,0,0,17419,7.0,17316,178,46,-2587,-1470,17.8,1741.9,15,3,1,15,9,23,0,0,0,0,20006,7.2,18786,214,50,2587,1470,21.4,2000.6
4527534005,1,16,2,0,8,5,9,1,1,0,0,17636,7.2,19458,218,52,2360,2396,21.8,1763.6,48,3,1,5,8,4,0,0,0,0,15276,6.6,17062,188,48,-2360,-2396,18.8,1527.6
4521903062,1,41,1,1,8,8,7,0,0,0,0,17208,7.2,18748,197,48,87,435,19.7,1720.8,12,1,0,8,8,5,0,0,0,0,17121,7.0,18313,222,47,-87,-435,22.2,1712.1
4489369709,0,17,4,1,7,6,6,0,0,0,0,16457,7.0,18265,202,56,265,-267,20.2,1645.7,16,4,0,6,7,4,1,1,0,0,16192,7.0,18532,234,63,-265,267,23.4,1619.2
4524584974,0,15,2,0,4,11,3,0,0,0,0,14956,6.4,16656,216,49,-3532,-2062,21.6,1495.6,17,2,1,11,4,11,0,0,0,0,18488,7.2,18718,217,56,3532,2062,21.7,1848.8
4498725511,1,40,4,1,8,1,6,2,1,1,1,18375,7.2,19454,222,51,4941,3427,22.2,1837.5,15,2,0,1,8,2,0,0,0,0,13434,6.6,16027,200,48,-4941,-3427,20.0,1343.4
4524908921,1,14,1,1,7,10,4,0,0,0,0,16663,6.8,17192,214,55,-1514,-1142,21.4,1666.3,14,1,0,10,7,19,1,1,0,0,18177,7.0,18334,217,39,1514,1142,21.7,1817.7
4469994389,0,14,2,1,6,12,11,1,1,0,0,15863,7.0,17107,191,49,-3479,-2205,19.1,1586.3,12,3,0,12,6,18,0,0,0,0,19342,7.4,19312,222,58,3479,2205,22.2,1934.2
4499525448,0,13,3,0,3,9,5,1,1,0,0,14559,6.8,17148,193,56,-4140,-2177,19.3,1455.9,104,3,1,9,3,8,0,0,0,0,18699,7.4,19325,236,42,4140,2177,23.6,1869.9
4516541142,1,13,2,1,8,6,12,0,0,0,0,17106,7.0,17729,206,51,1192,779,20.6,1710.6,8,1,0,6,8,9,0,0,0,0,15914,6.8,16950,217,47,-1192,-779,21.7,1591.4
4459193358,0,13,4,0,4,5,2,1,0,1,0,14366,6.8,17267,207,37,-1614,15,20.7,1436.6,17,0,1,5,4,9,1,1,0,0,15980,7.0,17252,216,62,1614,-15,21.6,1598.0
4527458962,0,15,5,0,9,9,8,0,0,0,0,16526,6.6,17292,194,41,-609,-1011,19.4,1652.6,19,5,1,9,9,10,0,0,0,0,17135,7.0,18303,228,36,609,1011,22.8,1713.5
4466193418,0,15,13,0,5,5,7,1,0,1,0,16686,7.4,19183,240,55,-418,60,24.0,1668.6,43,2,1,5,5,3,1,1,0,0,17104,7.2,19123,273,58,418,-60,27.3,1710.4
4523734569,1,18,2,1,4,3,2,1,0,1,0,15668,7.0,18873,250,48,787,481,25.0,1566.8,18,2,0,3,4,1,1,1,0,0,14881,7.0,18392,221,60,-787,-481,22.1,1488.1
4480423528,0,17,4,0,7,5,9,0,0,0,0,17094,7.0,18539,220,67,1004,1446,22.0,1709.4,17,4,1,5,7,3,1,1,0,0,16090,6.6,17093,211,52,-1004,-1446,21.1,1609.0
4493848070,0,17,0,0,6,6,6,0,0,0,0,16237,7.0,18980,222,52,-958,-461,22.2,1623.7,78,1,1,6,6,6,2,1,1,0,17195,7.2,19441,232,65,958,461,23.2,1719.5
4524523672,1,41,6,0,4,7,4,1,1,0,0,14969,6.8,16927,195,45,-1404,-509,19.5,1496.9,19,4,1,7,4,6,0,0,0,0,16373,6.8,17436,206,46,1404,509,20.6,1637.3
4518457045,1,18,0,0,3,6,4,0,0,0,0,15224,7.0,18728,228,49,-1611,97,22.8,1522.4,40,5,1,6,3,11,0,0,0,0,16835,7.2,18631,247,44,1611,-97,24.7,1683.5
4422228615,1,15,3,0,12,9,11,0,0,0,0,19153,7.0,18170,217,40,1249,1879,21.7,1915.3,130,3,1,9,12,12,0,0,0,1,17904,6.4,16291,177,44,-1249,-1879,17.7,1790.4
4522541186,1,165,3,1,11,8,8,1,1,0,1,19556,7.0,18352,229,41,2585,1759,22.9,1955.6,14,1,0,8,11,9,0,0,0,0,16971,6.6,16593,169,63,-2585,-1759,16.9,1697.1
4477722184,1,19,5,1,2,4,2,0,0,0,0,14124,6.4,15978,229,32,-1155,-638,22.9,1412.4,18,2,0,4,2,7,0,0,0,0,15279,6.6,16616,215,42,1155,638,21.5,1527.9
4465212739,0,15,1,1,10,8,12,0,0,0,0,17767,7.4,18168,194,52,163,-368,19.4,1776.7,14,2,0,8,10,13,0,0,0,0,17604,7.0,18536,211,52,-163,368,21.1,1760.4
4474762590,1,17,3,1,6,3,5,0,0,0,0,17384,7.0,18045,241,45,2245,304,24.1,1738.4,16,3,0,3,6,3,1,1,0,0,15139,6.8,17741,223,57,-2245,-304,22.3,1513.9
4523279887,0,15,4,0,8,6,10,0,0,0,0,16325,6.8,17831,193,40,2,-345,19.3,1632.5,24,1,1,6,8,4,1,1,0,0,16323,7.0,18176,227,48,-2,345,22.7,1632.3
4509532137,0,21,4,1,5,14,3,0,0,0,0,15425,6.6,16296,204,31,-2904,-3121,20.4,1542.5,18,4,0,14,5,10,0,0,0,0,18329,7.2,19417,212,48,2904,3121,21.2,1832.9
4459778854,1,36,1,0,10,6,12,0,0,0,0,19226,7.4,20118,231,44,3004,2300,23.1,1922.6,16,2,1,6,10,7,0,0,0,0,16222,7.0,17818,185,39,-3004,-2300,18.5,1622.2
4480259472,1,34,18,1,9,4,9,1,1,0,0,19462,7.6,19955,239,68,4444,2813,23.9,1946.2,39,1,0,4,9,3,0,0,0,0,15018,6.6,17142,209,48,-4444,-2813,20.9,1501.8
4484826568,0,14,2,0,5,9,3,1,1,0,0,15908,6.8,16828,211,44,-2080,-1117,21.1,1590.8,17,4,1,9,5,10,0,0,0,0,17988,7.0,17945,247,44,2080,1117,24.7,1798.8
4518966647,0,12,2,0,3,7,2,1,1,0,0,14663,6.8,17795,206,59,-1984,-715,20.6,1466.3,13,1,1,7,3,9,0,0,0,0,16647,7.0,18510,205,52,1984,715,20.5,1664.7
4526274055,0,14,3,0,4,8,7,1,1,0,0,15299,6.6,16493,196,48,-2489,-2828,19.6,1529.9,38,2,1,8,4,8,0,0,0,0,17788,7.4,19321,233,43,2489,2828,23.3,1778.8
4522301091,1,18,5,1,7,6,6,0,0,0,0,15954,6.8,16128,211,27,654,823,21.1,1595.4,20,1,0,6,7,6,1,0,1,0,15300,6.2,15305,190,40,-654,-823,19.0,1530.0
4506840559,1,30,3,1,6,4,5,1,1,0,0,16541,6.8,17961,211,51,1568,2039,21.1,1654.1,20,3,0,4,6,5,0,0,0,0,14973,6.6,15922,208,46,-1568,-2039,20.8,1497.3
4507364273,1,14,1,1,12,2,8,1,0,1,0,18863,7.6,20134,238,52,4785,4475,23.8,1886.3,13,1,0,2,12,2,0,0,0,0,14078,6.4,15659,206,42,-4785,-4475,20.6,1407.8
4525099132,1,17,2,1,5,5,7,2,1,1,0,15726,7.0,17245,203,56,-252,77,20.3,1572.6,15,2,0,5,5,9,0,0,0,0,15978,6.6,17168,212,48,252,-77,21.2,1597.8
4437610399,0,53,1,0,7,7,9,1,1,0,0,17220,7.2,18678,202,64,135,794,20.2,1722.0,15,2,1,7,7,6,0,0,0,0,17085,6.8,17884,228,52,-135,-794,22.8,1708.5
4494396355,0,16,1,0,7,6,12,0,0,0,0,16582,6.4,15066,203,42,-157,-2594,20.3,1658.2,13,0,1,6,7,8,2,1,1,0,16739,7.0,17660,219,59,157,2594,21.9,1673.9
4496993021,1,12,4,0,4,4,1,0,0,0,0,15786,7.2,18637,246,60,987,1253,24.6,1578.6,17,1,1,4,4,4,1,1,0,0,14799,6.8,17384,200,47,-987,-1253,20.0,1479.9
4522393633,0,18,8,0,4,5,5,1,1,0,0,15453,6.8,17463,191,55,-839,-623,19.1,1545.3,46,6,1,5,4,6,0,0,0,0,16292,6.8,18086,201,49,839,623,20.1,1629.2
4516522462,1,17,1,0,7,10,5,0,0,0,0,16589,7.0,18188,188,57,-3242,-950,18.8,1658.9,14,3,1,10,7,11,1,1,0,1,19831,7.2,19138,253,54,3242,950,25.3,1983.1
4527291064,1,13,1,1,10,1,15,0,0,0,0,18697,7.2,19162,237,36,4695,2313,23.7,1869.7,11,1,0,1,10,1,0,0,0,0,14002,6.4,16849,235,44,-4695,-2313,23.5,1400.2
4510356766,0,16,3,0,1,3,2,0,0,0,0,13496,6.6,16421,186,50,-2452,-2422,18.6,1349.6,15,6,1,3,1,3,1,1,0,0,15948,7.2,18843,255,64,2452,2422,25.5,1594.8
4526030485,1,17,2,1,7,2,4,0,0,0,0,17047,7.0,19573,224,54,3135,1888,22.4,1704.7,15,4,0,2,7,1,1,1,0,0,13912,6.8,17685,201,50,-3135,-1888,20.1,1391.2
4500461426,1,18,1,0,9,5,6,0,0,0,0,17707,7.2,18993,205,46,2488,2913,20.5,1770.7,14,3,1,5,9,5,0,0,0,0,15219,6.4,16080,190,44,-2488,-2913,19.0,1521.9
4523060210,1,20,4,1,8,4,6,1,1,0,0,16678,6.6,16861,196,62,2367,-249,19.6,1667.8,22,7,0,4,8,3,0,0,0,0,14311,6.4,17110,219,42,-2367,249,21.9,1431.1
4479974478,1,36,0,1,5,4,6,0,0,0,0,15887,6.8,17591,200,32,1173,953,20.0,1588.7,12,1,0,4,5,3,1,1,0,0,14714,6.6,16638,186,63,-1173,-953,18.6,1471.4
4515297257,0,14,7,0,3,6,4,0,0,0,0,15227,7.0,17701,231,59,-1558,-1782,23.1,1522.7,20,3,1,6,3,6,2,1,1,0,16785,7.0,19483,244,44,1558,1782,24.4,1678.5
4470447299,0,17,3,0,4,7,6,0,0,0,0,15190,6.6,16345,196,47,-1903,-584,19.6,1519.0,42,4,1,7,4,14,1,1,0,0,17093,6.6,16929,206,64,1903,584,20.6,1709.3
4468624067,1,18,3,1,5,1,5,0,0,0,0,15735,7.0,17967,219,48,1558,1567,21.9,1573.5,17,5,0,1,5,1,1,0,1,0,14177,6.6,16400,202,63,-1558,-1567,20.2,1417.7
4507707770,0,14,2,0,6,13,5,0,0,0,0,15662,6.4,16109,191,36,-3983,-1784,19.1,1566.2,17,2,1,13,6,13,1,1,0,0,19645,7.2,17893,218,32,3983,1784,21.8,1964.5
4481909469,0,18,3,0,5,9,5,0,0,0,0,15468,7.0,17872,203,52,-2507,-1473,20.3,1546.8,16,3,1,9,5,7,1,1,0,0,17975,7.4,19345,243,48,2507,1473,24.3,1797.5
4499779252,1,59,2,1,2,0,2,0,0,0,0,15393,6.8,17028,230,47,1875,1361,23.0,1539.3,16,3,0,0,2,0,0,0,0,0,13518,6.4,15667,215,60,-1875,-1361,21.5,1351.8
4514713257,1,13,5,0,10,3,10,0,0,0,0,19476,7.8,20412,262,51,4774,3524,26.2,1947.6,15,4,1,3,10,3,1,1,0,0,14702,6.8,16888,211,43,-4774,-3524,21.1,1470.2
4477029310,1,12,2,1,5,5,3,0,0,0,0,15000,6.6,16493,233,16,-1036,-1423,23.3,1500.0,19,1,0,5,5,4,0,0,0,0,16036,7.0,17916,221,44,1036,1423,22.1,1603.6
4522349716,0,13,2,0,6,11,6,1,1,0,0,16543,7.0,17893,213,47,-3032,-1002,21.3,1654.3,16,2,1,11,6,16,0,0,0,0,19575,7.2,18895,240,39,3032,1002,24.0,1957.5
4524504083,1,38,4,1,8,5,9,1,1,0,0,16646,7.0,17451,188,51,1308,1296,18.8,1664.6,16,1,0,5,8,7,1,0,1,0,15338,6.4,16155,227,40,-1308,-1296,22.7,1533.8
4518387667,1,16,5,1,11,5,8,1,1,0,0,17522,7.0,18787,204,44,2123,1612,20.4,1752.2,37,2,0,5,11,3,0,0,0,0,15399,7.0,17175,194,52,-2123,-1612,19.4,1539.9
4459923671,0,13,2,0,10,9,9,0,0,0,0,17668,7.2,18625,194,43,-788,-203,19.4,1766.8,35,1,1,9,10,18,1,1,0,0,18456,7.0,18828,185,68,788,203,18.5,1845.6
4453994009,1,15,3,1,7,6,7,0,0,0,0,17406,7.2,19761,251,64,1140,705,25.1,1740.6,17,1,0,6,7,4,2,1,1,0,16266,7.2,19056,190,56,-1140,-705,19.0,1626.6
4460552380,1,10,0,1,16,9,11,2,1,1,3,23349,7.6,21214,223,52,7128,6117,22.3,2334.9,11,0,0,9,16,13,0,0,0,0,16221,6.2,15097,140,40,-7128,-6117,14.0,1622.1
4508188294,0,13,1,0,1,10,1,0,0,0,0,13340,6.2,15466,223,32,-3586,-2271,22.3,1334.0,37,1,1,10,1,16,1,1,0,0,16926,6.8,17737,189,32,3586,2271,18.9,1692.6
4495452428,1,16,2,0,8,9,7,1,1,0,0,17000,6.8,18009,190,60,-149,427,19.0,1700.0,15,3,1,9,8,8,0,0,0,0,17149,7.0,17582,211,48,149,-427,21.1,1714.9
4474642048,0,17,4,1,16,5,21,1,1,0,0,19234,7.0,18339,193,32,2899,1508,19.3,1923.4,16,4,0,5,16,7,0,0,0,0,16335,6.8,16831,211,61,-2899,-1508,21.1,1633.5
4526061513,1,14,2,0,9,10,9,1,0,1,0,17840,7.2,19273,226,45,-359,784,22.6,1784.0,16,3,1,10,9,9,1,1,0,0,18199,7.0,18489,207,50,359,-784,20.7,1819.9
4524924917,1,14,2,1,6,3,4,0,0,0,0,16249,6.6,17860,224,41,675,377,22.4,1624.9,14,2,0,3,6,4,1,1,0,0,15574,7.0,17483,220,56,-675,-377,22.0,1557.4
4491423800,0,16,0,0,6,8,5,1,1,0,0,15683,7.0,17335,186,54,-1906,-1476,18.6,1568.3,12,3,1,8,6,9,1,0,1,0,17589,7.0,18811,240,45,1906,1476,24.0,1758.9
4499860078,1,17,0,1,4,1,8,0,0,0,0,14298,6.4,15101,171,33,852,-26,17.1,1429.8,14,0,0,1,4,1,0,0,0,0,13446,6.4,15127,213,39,-852,26,21.3,1344.6
4513183319,1,14,2,0,5,3,4,0,0,0,0,16595,7.2,19727,220,59,1584,2449,22.0,1659.5,23,0,1,3,5,4,2,1,1,0,15011,6.8,17278,204,47,-1584,-2449,20.4,1501.1
4510700294,0,17,2,0,4,10,2,0,0,0,0,15106,6.8,16691,201,44,-3081,-1236,20.1,1510.6,18,3,1,10,4,14,0,0,0,0,18187,6.8,17927,192,51,3081,1236,19.2,1818.7
4520305649,0,14,2,0,3,8,3,0,0,0,0,14275,6.4,15474,180,56,-3414,-3747,18.0,1427.5,14,2,1,8,3,4,2,1,1,0,17689,7.2,19221,228,60,3414,3747,22.8,1768.9
4502881141,0,41,3,0,2,12,2,0,0,0,0,14789,6.6,16856,221,54,-5163,-3425,22.1,1478.9,22,5,1,12,2,13,1,1,0,1,19952,7.4,20281,237,41,5163,3425,23.7,1995.2
4526971501,0,13,2,0,3,3,1,0,0,0,0,14634,7.0,18284,213,48,-879,254,21.3,1463.4,15,3,1,3,3,3,1,1,0,0,15513,7.0,18030,248,48,879,-254,24.8,1551.3
4518526662,1,32,1,1,7,6,9,2,1,1,0,17140,6.8,18226,221,68,597,875,22.1,1714.0,15,3,0,6,7,7,0,0,0,0,16543,6.8,17351,226,57,-597,-875,22.6,1654.3
4487414658,1,15,2,1,4,2,3,1,1,0,0,16521,7.2,18785,261,48,2101,1400,26.1,1652.1,19,3,0,2,4,2,0,0,0,0,14420,6.6,17385,215,56,-2101,-1400,21.5,1442.0
4527305212,0,17,3,0,6,10,7,1,1,0,0,16024,6.4,15686,202,40,-1307,-814,20.2,1602.4,19,2,1,10,6,21,0,0,0,0,17331,6.6,16500,201,43,1307,814,20.1,1733.1
4520959679,0,16,4,1,8,8,9,0,0,0,0,17951,6.8,18517,219,56,680,-704,21.9,1795.1,54,9,0,8,8,9,1,1,0,0,17271,7.2,19221,216,68,-680,704,21.6,1727.1
4501754015,0,18,4,0,3,7,3,1,1,0,0,15689,6.8,17576,236,58,-2253,-1798,23.6,1568.9,87,1,1,7,3,8,0,0,0,0,17942,7.2,19374,238,58,2253,1798,23.8,1794.2
4506079101,0,16,3,1,8,9,11,1,1,0,0,16894,6.6,17233,203,50,-1529,82,20.3,1689.4,23,1,0,9,8,11,1,0,1,1,18423,6.8,17151,232,37,1529,-82,23.2,1842.3
4481415061,0,10,1,0,6,14,3,0,0,0,0,16142,6.8,16953,198,59,-3109,-1745,19.8,1614.2,13,1,1,14,6,16,2,1,1,0,19251,7.0,18698,201,37,3109,1745,20.1,1925.1
4526466806,1,15,11,1,6,11,8,0,0,0,0,16882,6.8,17922,204,43,-2059,-2345,20.4,1688.2,43,3,0,11,6,14,0,0,0,0,18941,7.4,20267,220,56,2059,2345,22.0,1894.1
4513157515,0,14,3,0,5,5,6,1,0,1,0,16249,7.0,18403,217,60,251,1074,21.7,1624.9,13,3,1,5,5,7,1,1,0,0,15998,7.0,17329,229,52,-251,-1074,22.9,1599.8
4515347067,1,59,1,1,5,2,3,1,0,1,0,16014,7.0,18969,225,58,476,467,22.5,1601.4,21,6,0,2,5,1,0,0,0,0,15538,7.2,18502,257,53,-476,-467,25.7,1553.8
4470512125,1,18,3,0,8,2,5,1,0,1,0,17235,7.4,19304,227,53,3613,3509,22.7,1723.5,105,3,1,2,8,1,0,0,0,0,13622,6.4,15795,182,50,-3613,-3509,18.2,1362.2
4499740164,0,14,2,0,8,10,4,0,0,0,0,15229,6.4,16071,213,4,-4493,-3830,21.3,1522.9,13,2,1,10,8,10,2,1,1,1,19722,7.4,19901,218,68,4493,3830,21.8,1972.2
4494787893,0,9,2,1,4,2,0,0,0,0,0,15555,7.4,19704,214,70,737,1094,21.4,1555.5,38,0,0,2,4,2,1,1,0,0,14818,7.2,18610,235,51,-737,-1094,23.5,1481.8
4508099028,1,13,2,0,1,6,2,0,0,0,0,14168,6.6,16884,217,56,-3344,-2671,21.7,1416.8,18,3,1,6,1,7,2,1,1,0,17512,7.6,19555,225,77,3344,2671,22.5,1751.2
4479373618,1,17,5,1,4,2,2,1,1,0,1,16577,6.8,17637,220,58,1830,-1232,22.0,1657.7,17,4,0,2,4,1,1,0,1,0,14747,7.0,18869,219,66,-1830,1232,21.9,1474.7
4520625705,0,12,0,0,6,9,4,1,0,1,1,16829,6.8,17978,198,48,-489,188,19.8,1682.9,21,0,1,9,6,11,1,1,0,0,17318,6.8,17790,216,47,489,-188,21.6,1731.8
4526015422,1,15,1,1,2,0,4,2,1,1,0,15919,6.6,17737,262,56,1935,411,26.2,1591.9,17,3,0,0,2,0,0,0,0,0,13984,6.6,17326,244,55,-1935,-411,24.4,1398.4
4525370217,0,54,8,0,5,7,10,1,1,0,0,15844,6.6,16971,209,51,-2270,-2033,20.9,1584.4,29,3,1,7,5,9,0,0,0,0,18114,7.2,19004,243,64,2270,2033,24.3,1811.4
4526279428,0,13,2,0,1,12,1,0,0,0,0,13517,6.4,15501,187,48,-5338,-5445,18.7,1351.7,15,3,1,12,1,13,1,0,1,0,18855,7.6,20946,243,43,5338,5445,24.3,1885.5
4505405578,0,22,1,1,5,11,4,0,0,0,0,16275,6.8,16965,221,40,-2001,-2536,22.1,1627.5,37,2,0,11,5,13,1,1,0,0,18276,7.2,19501,193,68,2001,2536,19.3,1827.6
4462114577,0,36,4,1,5,9,7,0,0,0,0,16942,7.0,17624,227,63,9,-1196,22.7,1694.2,16,1,0,9,5,9,1,1,0,0,16933,6.8,18820,215,47,-9,1196,21.5,1693.3
4391232237,0,17,1,1,10,13,6,0,0,0,0,18152,7.0,18229,245,41,-921,-1198,24.5,1815.2,17,5,0,13,10,16,1,1,0,0,19073,7.2,19427,206,44,921,1198,20.6,1907.3
4492130975,0,18,0,0,4,3,5,0,0,0,0,14769,6.8,17725,215,36,-1071,-843,21.5,1476.9,10,2,1,3,4,2,0,0,0,0,15840,7.0,18568,242,51,1071,843,24.2,1584.0
4507155035,0,14,3,0,3,4,3,0,0,0,0,15885,7.2,18620,252,60,-390,-52,25.2,1588.5,19,4,1,4,3,4,1,1,0,0,16275,7.2,18672,258,51,390,52,25.8,1627.5
4454127196,1,14,4,1,7,8,10,1,0,1,0,17257,6.8,17553,189,52,-429,-698,18.9,1725.7,88,3,0,8,7,9,1,1,0,0,17686,7.0,18251,223,60,429,698,22.3,1768.6
4486662543,1,19,2,0,3,6,5,1,0,1,0,14724,6.6,16522,195,52,-1858,-1476,19.5,1472.4,17,1,1,6,3,7,1,1,0,0,16582,7.0,17998,225,52,1858,1476,22.5,1658.2
4525186736,0,14,3,0,4,7,6,0,0,0,0,15706,7.0,17720,244,46,-1992,-1588,24.4,1570.6,43,3,1,7,4,11,2,1,1,0,17698,7.2,19308,256,56,1992,1588,25.6,1769.8
4476477033,1,13,2,1,7,3,1,2,1,1,1,18919,7.6,20248,252,73,3983,3375,25.2,1891.9,58,1,0,3,7,5,0,0,0,0,14936,6.8,16873,230,38,-3983,-3375,23.0,1493.6
4526112054,0,14,3,0,2,5,3,1,1,0,0,14606,7.0,17820,221,65,-1605,237,22.1,1460.6,23,2,1,5,2,7,0,0,0,0,16211,7.0,17583,235,44,1605,-237,23.5,1621.1
4523672153,0,19,3,1,10,7,10,1,1,0,0,18312,6.8,18057,239,46,1250,-226,23.9,1831.2,17,4,0,7,10,5,1,0,1,0,17062,6.8,18283,206,57,-1250,226,20.6,1706.2
4525209452,1,17,1,0,3,7,1,1,1,0,0,14970,6.6,16402,208,54,-1187,-1058,20.8,1497.0,16,3,1,7,3,6,0,0,0,0,16157,6.8,17460,208,55,1187,1058,20.8,1615.7
4525006118,0,19,3,0,4,3,4,0,0,0,0,15850,7.2,18831,233,51,1207,1885,23.3,1585.0,16,3,1,3,4,4,1,1,0,0,14643,6.6,16946,229,48,-1207,-1885,22.9,1464.3
4450431370,0,14,1,0,7,14,8,0,0,0,0,16336,6.8,16919,190,40,-3908,-2704,19.0,1633.6,17,2,1,14,7,17,1,1,0,0,20244,7.2,19623,208,66,3908,2704,20.8,2024.4
4527107365,0,15,1,1,4,8,0,0,0,0,0,13362,6.4,15531,155,34,-4968,-4165,15.5,1336.2,12,3,0,8,4,4,1,1,0,0,18330,7.2,19696,240,67,4968,4165,24.0,1833.0
4510817893,0,51,10,1,7,5,8,0,0,0,0,17149,7.0,17975,247,45,1547,611,24.7,1714.9,23,5,0,5,7,8,0,0,0,0,15602,6.8,17364,210,58,-1547,-611,21.0,1560.2
4506670762,0,11,0,1,2,4,3,0,0,0,0,14231,6.6,16339,201,56,-2259,-2256,20.1,1423.1,17,0,0,4,2,5,1,1,0,0,16490,7.0,18595,234,60,2259,2256,23.4,1649.0
4481998895,1,15,1,0,9,4,12,1,1,0,0,18055,6.8,17444,212,50,3332,2911,21.2,1805.5,14,0,1,4,9,8,0,0,0,0,14723,6.2,14533,186,41,-3332,-2911,18.6,1472.3
4460661408,1,17,5,0,7,4,8,1,1,0,0,17863,7.4,19967,257,39,3109,3007,25.7,1786.3,13,2,1,4,7,5,0,0,0,0,14754,6.4,16960,204,44,-3109,-3007,20.4,1475.4
4501457414,0,13,1,0,5,7,8,0,0,0,0,16334,7.0,18034,245,40,-1337,-1106,24.5,1633.4,85,1,1,7,5,9,2,1,1,0,17671,7.2,19140,245,60,1337,1106,24.5,1767.1
4496572597,1,16,3,1,9,4,11,0,0,0,0,17326,7.2,19014,226,44,1132,269,22.6,1732.6,38,3,0,4,9,5,1,1,0,0,16194,7.2,18745,203,59,-1132,-269,20.3,1619.4
4519045200,0,13,2,0,7,7,6,0,0,0,0,17064,7.0,18061,236,48,134,-396,23.6,1706.4,15,2,1,7,7,8,1,1,0,0,16930,7.0,18457,210,59,-134,396,21.0,1693.0
4527878058,1,18,2,1,12,6,13,0,0,0,0,18573,7.2,19391,207,46,2639,2364,20.7,1857.3,16,6,0,6,12,6,0,0,0,0,15934,6.6,17027,197,38,-2639,-2364,19.7,1593.4
4502350951,1,16,2,1,3,7,2,1,1,0,0,14857,6.6,17267,228,57,-2748,-2417,22.8,1485.7,16,1,0,7,3,8,1,0,1,0,17605,7.4,19684,208,64,2748,2417,20.8,1760.5
4527158569,1,18,5,1,10,4,11,0,0,0,0,18270,7.0,18656,249,41,3134,1069,24.9,1827.0,41,3,0,4,10,1,1,1,0,0,15136,7.0,17587,217,52,-3134,-1069,21.7,1513.6
4427765980,0,40,3,0,5,6,7,0,0,0,0,15628,7.0,17683,221,49,-623,-39,22.1,1562.8,18,5,1,6,5,6,1,1,0,0,16251,6.8,17722,223,42,623,39,22.3,1625.1
4502783648,0,14,1,0,5,10,5,0,0,0,0,15129,6.4,15915,176,56,-2921,-3196,17.6,1512.9,14,1,1,10,5,12,0,0,0,0,18050,7.0,19111,203,60,2921,3196,20.3,1805.0
4490919481,0,58,4,1,3,7,4,1,1,0,0,13957,6.4,16250,187,48,-2788,-1304,18.7,1395.7,15,5,0,7,3,10,0,0,0,0,16745,6.8,17554,210,48,2788,1304,21.0,1674.5
4523653027,1,19,3,1,5,4,7,0,0,0,0,16989,7.0,18031,256,60,2000,1065,25.6,1698.9,16,4,0,4,5,7,1,1,0,0,14989,6.8,16966,206,51,-2000,-1065,20.6,1498.9
4494489796,1,38,6,1,9,8,12,1,1,0,0,17396,7.0,17804,205,48,-377,842,20.5,1739.6,19,4,0,8,9,10,1,0,1,0,17773,6.6,16962,223,40,377,-842,22.3,1777.3
4467381838,0,38,3,0,2,9,2,0,0,0,0,14597,6.8,17317,220,44,-3805,-2559,22.0,1459.7,14,6,1,9,2,13,0,0,0,0,18402,7.4,19876,274,48,3805,2559,27.4,1840.2
4521893389,1,16,2,0,6,9,3,0,0,0,0,15845,6.6,16561,195,40,-1018,-981,19.5,1584.5,15,0,1,9,6,7,0,0,0,0,16863,7.2,17542,213,52,1018,981,21.3,1686.3
4452202569,1,53,4,0,7,11,10,0,0,0,0,16308,6.8,16771,189,44,-1751,-2784,18.9,1630.8,40,1,1,11,7,9,1,0,1,0,18059,7.4,19555,200,58,1751,2784,20.0,1805.9
4470033546,0,12,3,0,3,12,5,0,0,0,0,15978,6.2,15862,192,46,-2818,-3710,19.2,1597.8,17,0,1,12,3,11,1,1,0,0,18796,7.2,19572,211,66,2818,3710,21.1,1879.6
4513668536,0,15,2,1,3,7,3,1,1,0,0,15495,7.0,17827,226,60,-1972,-1613,22.6,1549.5,29,3,0,7,3,9,0,0,0,0,17467,7.2,19440,233,62,1972,1613,23.3,1746.7
4523056736,0,18,3,1,3,8,8,0,0,0,0,14451,6.8,16229,225,37,-3028,-3555,22.5,1445.1,33,5,0,8,3,8,1,0,1,0,17479,7.4,19784,223,60,3028,3555,22.3,1747.9
4521602868,0,20,5,1,8,6,13,1,1,0,0,17731,6.8,18132,232,47,1375,109,23.2,1773.1,19,1,0,6,8,4,0,0,0,0,16356,6.8,18023,206,48,-1375,-109,20.6,1635.6
4514173446,0,17,4,1,13,8,10,0,0,0,0,19657,7.0,18537,204,44,1675,-423,20.4,1965.7,15,1,0,8,13,9,1,1,0,0,17982,7.2,18960,202,64,-1675,423,20.2,1798.2
4518666221,1,16,4,1,2,3,3,0,0,0,0,15076,6.4,16299,196,51,-426,-2349,19.6,1507.6,14,2,0,3,2,3,1,0,1,0,15502,6.8,18648,218,64,426,2349,21.8,1550.2
4515601769,1,12,5,1,9,8,7,0,0,0,0,17670,7.0,18217,201,72,32,-952,20.1,1767.0,20,1,0,8,9,9,0,0,0,0,17638,7.4,19169,247,52,-32,952,24.7,1763.8
4527289282,1,13,4,0,3,9,3,0,0,0,0,15292,6.8,17170,223,55,-2513,-2247,22.3,1529.2,14,3,1,9,3,8,1,1,0,0,17805,7.2,19417,231,44,2513,2247,23.1,1780.5
4484729770,0,16,3,0,5,7,6,0,0,0,0,16043,6.8,17403,237,38,-689,-1668,23.7,1604.3,18,2,1,7,5,5,1,1,0,0,16732,7.0,19071,231,57,689,1668,23.1,1673.2
4484002514,1,18,4,1,4,1,3,2,1,1,0,16231,7.2,18511,271,52,693,-204,27.1,1623.1,15,4,0,1,4,1,0,0,0,0,15538,7.2,18715,245,59,-693,204,24.5,1553.8
4495435379,1,105,2,1,9,5,9,1,0,1,0,17795,7.4,19812,237,71,1367,1620,23.7,1779.5,29,2,0,5,9,4,1,1,0,0,16428,7.0,18192,217,60,-1367,-1620,21.7,1642.8
4483653964,1,71,1,0,6,10,7,1,1,0,0,16832,6.8,17641,222,60,-1467,-1504,22.2,1683.2,15,1,1,10,6,12,0,0,0,0,18299,7.4,19145,210,64,1467,1504,21.0,1829.9
4508697399,0,13,1,1,1,2,1,0,0,0,0,15094,6.8,18255,246,51,-92,-244,24.6,1509.4,12,0,0,2,1,3,1,1,0,0,15186,6.8,18499,226,64,92,244,22.6,1518.6
4499977236,1,15,6,0,6,1,3,2,1,1,1,17459,7.0,18810,226,52,3734,2743,22.6,1745.9,20,5,1,1,6,1,0,0,0,0,13725,6.4,16067,198,48,-3734,-2743,19.8,1372.5
4421794878,1,24,3,0,13,8,17,2,1,1,1,20860,7.2,19749,239,67,4299,3637,23.9,2086.0,20,4,1,8,13,10,0,0,0,0,16561,6.4,16112,192,33,-4299,-3637,19.2,1656.1
4514424102,1,16,2,0,6,3,5,1,1,0,0,15690,6.8,17299,214,44,903,1110,21.4,1569.0,13,2,1,3,6,3,0,0,0,0,14787,6.8,16189,199,52,-903,-1110,19.9,1478.7
4521939526,0,13,3,0,1,7,0,0,0,0,0,13828,6.6,16964,228,53,-3588,-2501,22.8,1382.8,17,2,1,7,1,6,0,0,0,0,17416,7.2,19465,258,60,3588,2501,25.8,1741.6
4524568896,1,18,6,0,5,7,9,0,0,0,0,15851,7.0,19296,215,61,-1341,445,21.5,1585.1,19,6,1,7,5,6,1,1,0,0,17192,7.0,18851,237,38,1341,-445,23.7,1719.2
4494647100,1,14,6,0,4,5,3,0,0,0,0,16581,7.0,19116,254,51,1103,1356,25.4,1658.1,21,3,1,5,4,3,0,0,0,0,15478,6.8,17760,205,52,-1103,-1356,20.5,1547.8
4470336918,0,16,1,1,7,8,11,1,1,0,0,17558,6.8,17445,241,48,-105,-1401,24.1,1755.8,18,4,0,8,7,9,1,0,1,0,17663,6.8,18846,232,50,105,1401,23.2,1766.3
4527448907,1,10,0,1,9,5,6,1,1,0,0,17775,6.8,18094,222,54,3629,5111,22.2,1777.5,6,0,0,5,9,5,0,0,0,0,14146,5.6,12983,123,55,-3629,-5111,12.3,1414.6
4527650807,1,47,3,1,2,4,3,1,1,0,0,14408,6.6,16534,212,49,-1147,-1842,21.2,1440.8,15,2,0,4,2,4,0,0,0,0,15555,6.8,18376,218,52,1147,1842,21.8,1555.5
4512196421,0,14,1,0,3,7,3,2,1,1,0,14548,6.6,17158,204,49,-2408,-2325,20.4,1454.8,13,0,1,7,3,5,0,0,0,0,16956,7.2,19483,253,52,2408,2325,25.3,1695.6
4521483085,1,16,4,1,6,3,6,1,1,0,0,17536,7.0,19253,266,48,2880,2785,26.6,1753.6,58,2,0,3,6,5,0,0,0,0,14656,6.6,16468,197,48,-2880,-2785,19.7,1465.6
4506113045,1,20,1,1,6,6,5,0,0,0,0,16291,6.8,18130,228,44,164,-222,22.8,1629.1,13,3,0,6,6,6,0,0,0,0,16127,7.0,18352,227,40,-164,222,22.7,1612.7
4483149221,1,15,5,0,4,4,6,0,0,0,0,16711,7.4,19807,233,72,1759,2524,23.3,1671.1,20,5,1,4,4,9,1,1,0,0,14952,6.8,17283,203,47,-1759,-2524,20.3,1495.2
4495516113,1,15,5,1,6,5,5,1,1,0,0,16364,6.8,17787,226,40,978,315,22.6,1636.4,18,2,0,5,6,5,0,0,0,0,15386,7.0,17472,194,44,-978,-315,19.4,1538.6
4520610371,1,17,3,0,9,3,11,0,0,0,0,16954,6.8,17771,221,32,2589,2509,22.1,1695.4,31,5,1,3,9,4,1,1,0,0,14365,6.4,15262,187,46,-2589,-2509,18.7,1436.5
4491591979,1,50,4,1,10,6,11,1,1,0,0,17592,6.8,17430,186,47,1417,1171,18.6,1759.2,15,1,0,6,10,11,0,0,0,0,16175,6.6,16259,220,32,-1417,-1171,22.0,1617.5
4499522050,1,20,2,0,3,3,1,1,0,1,1,17009,7.2,18492,238,78,862,1098,23.8,1700.9,19,9,1,3,3,5,1,1,0,0,16147,6.8,17394,252,69,-862,-1098,25.2,1614.7
4453463831,0,14,3,1,4,6,4,1,1,0,0,16209,7.2,18802,235,72,-907,-1159,23.5,1620.9,17,5,0,6,4,7,0,0,0,0,17116,7.2,19961,242,62,907,1159,24.2,1711.6
4512489523,0,50,4,0,5,4,8,1,1,0,0,16560,6.8,18049,220,49,1319,111,22.0,1656.0,37,2,1,4,5,5,1,0,1,0,15241,7.0,17938,190,51,-1319,-111,19.0,1524.1
4484406104,0,22,6,1,5,10,6,1,0,1,0,17677,7.0,18225,269,51,1285,1300,26.9,1767.7,18,5,0,10,5,9,1,1,0,0,16392,6.6,16925,173,44,-1285,-1300,17.3,1639.2
4518164964,1,16,1,0,8,2,9,1,1,0,0,17511,7.6,19617,220,60,2745,1800,22.0,1751.1,15,3,1,2,8,0,0,0,0,0,14766,6.8,17817,235,56,-2745,-1800,23.5,1476.6
4513397052,1,13,0,1,7,9,9,0,0,0,0,16538,6.8,17488,204,55,-571,-401,20.4,1653.8,17,1,0,9,7,12,1,1,0,0,17109,6.8,17889,222,40,571,401,22.2,1710.9
4525230162,0,16,4,1,5,3,5,1,1,0,0,16700,7.2,18574,242,52,1928,1297,24.2,1670.0,15,3,0,3,5,1,0,0,0,0,14772,6.6,17277,243,47,-1928,-1297,24.3,1477.2
4525194842,1,17,4,1,7,6,6,1,1,0,0,16717,7.2,18457,223,49,-450,-992,22.3,1671.7,18,5,0,6,7,5,0,0,0,0,17167,7.2,19449,247,48,450,992,24.7,1716.7
4505305847,1,17,7,1,9,7,7,1,1,0,0,16466,6.6,16716,188,44,-1099,-1318,18.8,1646.6,46,7,0,7,9,7,0,0,0,0,17565,7.0,18034,232,40,1099,1318,23.2,1756.5
4502134010,1,16,2,1,4,7,1,0,0,0,0,15764,6.8,17960,237,53,-1929,-655,23.7,1576.4,22,2,0,7,4,6,1,0,1,0,17693,7.2,18615,236,40,1929,655,23.6,1769.3
4486065632,1,40,1,0,6,6,6,0,0,0,0,15863,6.8,17012,221,29,46,881,22.1,1586.3,44,2,1,6,6,9,0,0,0,0,15817,6.4,16131,191,46,-46,-881,19.1,1581.7
4521886513,1,42,2,1,7,2,10,1,1,0,0,17267,7.2,18482,224,44,3107,2096,22.4,1726.7,16,5,0,2,7,0,0,0,0,0,14160,6.6,16386,218,40,-3107,-2096,21.8,1416.0
4517691436,0,14,2,0,11,8,12,0,0,0,0,17804,6.8,17743,210,41,1092,806,21.0,1780.4,14,1,1,8,11,10,0,0,0,0,16712,6.6,16937,208,23,-1092,-806,20.8,1671.2
4526610114,1,12,1,1,9,6,8,1,1,0,0,17469,7.2,18286,206,48,2278,2188,20.6,1746.9,40,3,0,6,9,11,0,0,0,0,15191,6.4,16098,174,28,-2278,-2188,17.4,1519.1
4512993311,0,16,1,0,4,12,3,0,0,0,0,15335,6.4,16838,187,71,-3983,-3676,18.7,1533.5,39,1,1,12,4,9,0,0,0,0,19318,7.4,20514,242,45,3983,3676,24.2,1931.8
4524164148,1,14,4,1,4,4,5,1,0,1,1,16938,7.0,18241,213,52,1881,635,21.3,1693.8,61,0,0,4,4,5,0,0,0,0,15057,6.8,17606,224,47,-1881,-635,22.4,1505.7
4526594026,1,41,4,0,9,4,11,1,1,0,0,18140,7.2,20250,204,79,2793,3324,20.4,1814.0,18,4,1,4,9,3,0,0,0,0,15347,6.8,16926,222,36,-2793,-3324,22.2,1534.7
4526838859,0,20,3,0,4,6,4,0,0,0,0,14053,6.6,16510,169,52,-3045,-810,16.9,1405.3,19,4,1,6,4,11,0,0,0,0,17098,6.8,17320,229,50,3045,810,22.9,1709.8
4503283064,0,14,6,0,1,7,2,0,0,0,0,14333,6.8,17362,222,46,-2671,-1258,22.2,1433.3,14,2,1,7,1,6,1,1,0,0,17004,6.8,18620,224,51,2671,1258,22.4,1700.4
4483792624,0,19,4,1,4,8,5,0,0,0,0,14799,6.8,16562,207,39,-3590,-3279,20.7,1479.9,18,2,0,8,4,9,1,1,0,0,18389,7.4,19841,259,56,3590,3279,25.9,1838.9
4498058442,0,38,2,1,3,5,2,0,0,0,0,14452,6.4,15418,186,49,-1404,-2296,18.6,1445.2,18,2,0,5,3,3,1,1,0,0,15856,6.8,17714,228,56,1404,2296,22.8,1585.6
4513442197,0,12,5,0,10,12,7,0,0,0,0,17431,6.8,17722,202,48,-1294,-267,20.2,1743.1,17,2,1,12,10,20,0,0,0,0,18725,6.8,17989,195,65,1294,267,19.5,1872.5
4516975993,0,10,1,0,11,8,9,0,0,0,0,19627,7.4,20041,237,56,2760,3641,23.7,1962.7,13,2,1,8,11,11,1,1,0,0,16867,6.6,16400,167,52,-2760,-3641,16.7,1686.7
4445344090,0,28,3,1,2,6,2,1,0,1,0,14896,6.8,17066,205,48,-1243,-635,20.5,1489.6,42,2,0,6,2,7,1,1,0,0,16139,6.6,17701,195,60,1243,635,19.5,1613.9
4489065955,1,15,1,0,4,12,8,0,0,0,0,15147,6.4,16605,188,50,-4559,-1851,18.8,1514.7,18,3,1,12,4,22,1,1,0,0,19706,7.2,18456,241,44,4559,1851,24.1,1970.6
4524928050,0,60,1,0,5,11,2,0,0,0,0,15346,6.4,15646,187,38,-2764,-2934,18.7,1534.6,12,5,1,11,5,13,1,1,0,0,18110,7.2,18580,202,44,2764,2934,20.2,1811.0
4526805303,1,17,4,1,7,7,6,1,0,1,0,16492,6.6,16905,202,32,-499,-295,20.2,1649.2,16,1,0,7,7,10,1,1,0,0,16991,6.8,17200,220,56,499,295,22.0,1699.1
4526481704,0,16,0,0,6,7,8,0,0,0,0,15779,6.8,17436,186,31,-1219,-737,18.6,1577.9,14,3,1,7,6,10,2,1,1,0,16998,7.2,18173,242,52,1219,737,24.2,1699.8
4472647396,1,44,7,0,3,4,1,1,1,0,0,15326,7.2,18992,226,59,-233,1969,22.6,1532.6,18,5,1,4,3,5,0,0,0,0,15559,6.6,17023,222,43,233,-1969,22.2,1555.9
4524264529,1,12,4,0,5,8,5,1,1,0,0,16245,7.0,17547,206,52,-1051,753,20.6,1624.5,18,2,1,8,5,11,0,0,0,0,17296,6.8,16794,206,48,1051,-753,20.6,1729.6
4525320313,1,16,4,0,3,4,2,0,0,0,0,15694,7.0,17920,241,48,764,-29,24.1,1569.4,18,2,1,4,3,1,1,1,0,0,14930,7.0,17949,221,47,-764,29,22.1,1493.0
4519612856,0,18,3,0,5,9,5,0,0,0,0,16093,6.8,17056,209,49,-700,-1781,20.9,1609.3,17,3,1,9,5,6,0,0,0,0,16793,7.0,18837,192,40,700,1781,19.2,1679.3
4501013939,0,15,3,1,6,2,7,1,1,0,0,17390,7.4,19841,239,68,1644,987,23.9,1739.0,14,2,0,2,6,4,1,0,1,0,15746,7.0,18854,250,60,-1644,-987,25.0,1574.6
4516351338,0,30,0,0,4,7,2,1,0,1,1,17040,7.2,18774,228,76,293,718,22.8,1704.0,15,1,1,7,4,7,1,1,0,0,16747,6.8,18056,204,56,-293,-718,20.4,1674.7
4481550615,0,17,3,0,9,18,8,0,0,0,0,17290,7.0,17418,223,48,-3502,-2187,22.3,1729.0,16,4,1,18,9,19,1,1,0,0,20792,7.4,19605,228,45,3502,2187,22.8,2079.2
4522772427,0,19,1,1,6,10,3,1,0,1,0,15222,6.4,16160,192,38,-2558,-2878,19.2,1522.2,56,7,0,10,6,15,1,1,0,0,17780,7.2,19038,205,49,2558,2878,20.5,1778.0
4518722458,0,27,4,0,4,7,3,0,0,0,0,14732,6.6,16332,186,47,-2749,-3335,18.6,1473.2,15,3,1,7,4,6,1,1,0,0,17481,7.6,19667,222,76,2749,3335,22.2,1748.1
4510877210,0,13,4,0,5,6,6,0,0,0,0,15771,6.8,16977,237,38,-1091,-1990,23.7,1577.1,17,5,1,6,5,5,0,0,0,0,16862,7.2,18967,226,46,1091,1990,22.6,1686.2
4475685776,1,15,2,1,6,1,9,0,0,0,0,17357,7.4,20069,236,56,2030,1411,23.6,1735.7,18,1,0,1,6,2,0,0,0,0,15327,7.0,18658,252,69,-2030,-1411,25.2,1532.7
4489438593,1,15,2,0,8,6,6,0,0,0,0,16947,7.0,18862,184,64,-538,1677,18.4,1694.7,17,2,1,6,8,8,2,1,1,1,17485,6.8,17185,198,47,538,-1677,19.8,1748.5
4517978315,1,17,2,0,4,9,4,0,0,0,0,14820,6.6,15946,184,44,-4156,-2933,18.4,1482.0,15,5,1,9,4,15,1,0,1,0,18976,7.0,18879,240,48,4156,2933,24.0,1897.6
4520706902,1,9,2,1,6,7,12,0,0,0,0,17490,6.8,17883,226,56,480,-685,22.6,1749.0,15,0,0,7,6,12,0,0,0,0,17010,7.0,18568,220,67,-480,685,22.0,1701.0
4518322850,0,17,2,1,6,7,5,0,0,0,0,16797,7.0,18636,213,65,823,2681,21.3,1679.7,14,2,0,7,6,11,1,0,1,0,15974,6.4,15955,158,44,-823,-2681,15.8,1597.4
4496840019,1,14,3,1,8,4,9,1,1,0,0,17163,7.2,19382,224,52,1422,775,22.4,1716.3,15,4,0,4,8,2,0,0,0,0,15741,7.2,18607,218,59,-1422,-775,21.8,1574.1
4515369512,0,10,2,0,6,4,8,0,0,0,0,17099,7.0,18702,208,74,1579,1223,20.8,1709.9,12,1,1,4,6,3,1,1,0,0,15520,6.8,17479,228,43,-1579,-1223,22.8,1552.0
4527031551,1,20,2,1,7,6,6,1,0,1,0,17131,6.6,17701,229,36,1254,-81,22.9,1713.1,13,2,0,6,7,3,1,1,0,0,15877,6.8,17782,199,62,-1254,81,19.9,1587.7
4456066920,1,15,4,0,1,5,0,0,0,0,0,14250,6.8,17406,238,49,-1461,241,23.8,1425.0,20,5,1,5,1,5,2,1,1,0,15711,6.6,17165,228,34,1461,-241,22.8,1571.1
4527063486,1,28,2,1,7,5,12,0,0,0,0,16674,6.8,17188,204,47,111,-199,20.4,1667.4,23,1,0,5,7,5,2,1,1,0,16563,7.0,17387,221,48,-111,199,22.1,1656.3
4509908881,1,14,2,1,14,3,19,1,1,0,1,22472,7.6,20870,251,54,8284,4654,25.1,2247.2,15,2,0,3,14,5,0,0,0,0,14188,6.6,16216,202,34,-8284,-4654,20.2,1418.8
4525911356,0,18,2,0,5,3,9,1,1,0,0,16380,6.8,18331,229,46,-115,480,22.9,1638.0,13,1,1,3,5,3,1,0,1,1,16495,7.0,17851,225,54,115,-480,22.5,1649.5
4520699104,0,11,3,1,8,8,7,1,0,1,0,17065,7.6,19772,214,51,519,1006,21.4,1706.5,14,1,0,8,8,6,1,1,0,0,16546,7.0,18766,204,51,-519,-1006,20.4,1654.6
4515922365,0,11,1,1,8,9,6,0,0,0,0,17424,7.2,18146,224,37,-618,-669,22.4,1742.4,17,2,0,9,8,8,0,0,0,0,18042,7.0,18815,223,57,618,669,22.3,1804.2
4524932837,1,17,3,1,9,1,9,1,1,0,0,17079,7.0,17962,229,44,3916,2599,22.9,1707.9,16,0,0,1,9,0,0,0,0,0,13163,6.6,15363,191,44,-3916,-2599,19.1,1316.3
4484049712,0,108,0,1,7,8,7,0,0,0,0,15857,6.6,16404,177,52,-2314,-1903,17.7,1585.7,16,3,0,8,7,8,2,1,1,0,18171,6.8,18307,203,48,2314,1903,20.3,1817.1
4527528290,0,10,0,0,2,7,3,0,0,0,0,13016,5.6,13166,167,44,-6869,-6365,16.7,1301.6,13,1,1,7,2,6,2,1,1,2,19885,7.2,19531,243,48,6869,6365,24.3,1988.5
4455468976,1,17,3,1,4,7,3,1,1,0,0,15859,7.0,18955,250,62,-898,-655,25.0,1585.9,17,5,0,7,4,9,0,0,0,0,16757,7.0,19610,193,59,898,655,19.3,1675.7
4462009562,0,38,4,1,1,5,0,1,1,0,0,13696,6.8,16789,200,56,-2462,-3352,20.0,1369.6,18,4,0,5,1,6,1,0,1,0,16158,7.6,20141,202,72,2462,3352,20.2,1615.8
4521845032,0,16,5,1,4,8,7,0,0,0,0,15667,7.0,17592,225,60,-2450,-2260,22.5,1566.7,14,3,0,8,4,14,1,1,0,0,18117,7.6,19852,252,60,2450,2260,25.2,1811.7
4527007820,1,17,2,0,9,10,9,0,0,0,0,17678,6.8,17263,190,40,-1213,848,19.0,1767.8,15,3,1,10,9,19,1,1,0,1,18891,6.6,16415,182,37,1213,-848,18.2,1889.1
4515874786,0,41,4,0,7,11,8,1,1,0,0,16728,7.0,17887,191,64,-2358,-1400,19.1,1672.8,34,6,1,11,7,11,1,0,1,0,19086,7.2,19287,211,64,2358,1400,21.1,1908.6
4523881390,1,18,2,1,6,2,8,1,0,1,0,17779,7.6,20127,268,48,3206,2261,26.8,1777.9,15,4,0,2,6,2,0,0,0,0,14573,7.0,17866,225,52,-3206,-2261,22.5,1457.3
4525953760,0,30,5,0,5,11,2,1,0,1,0,16627,7.0,18559,229,64,-844,737,22.9,1662.7,61,6,1,11,5,14,0,0,0,0,17471,7.0,17822,206,40,844,-737,20.6,1747.1
4524157575,1,15,1,1,6,2,6,2,1,1,0,16998,7.2,18708,236,56,2619,1209,23.6,1699.8,14,0,0,2,6,2,0,0,0,0,14379,7.0,17499,217,52,-2619,-1209,21.7,1437.9
4472053682,0,12,4,0,3,8,2,0,0,0,0,15027,6.6,17054,211,56,-2037,110,21.1,1502.7,20,1,1,8,3,11,1,1,0,0,17064,6.6,16944,197,44,2037,-110,19.7,1706.4
4525862363,1,14,3,0,8,7,6,1,1,0,0,17685,7.2,19338,231,44,1218,1150,23.1,1768.5,17,0,1,7,8,4,0,0,0,0,16467,7.0,18188,226,48,-1218,-1150,22.6,1646.7
4453066386,0,16,2,0,2,8,2,1,0,1,0,14786,6.6,16676,233,50,-1340,-529,23.3,1478.6,16,4,1,8,2,6,1,1,0,0,16126,6.8,17205,205,37,1340,529,20.5,1612.6
4460077928,1,17,4,1,9,8,12,0,0,0,0,18385,7.4,19948,248,65,607,1293,24.8,1838.5,17,5,0,8,9,8,2,1,1,0,17778,7.0,18655,240,56,-607,-1293,24.0,1777.8
4515500466,0,13,2,0,2,9,2,1,0,1,0,13932,6.0,14927,197,40,-3919,-3135,19.7,1393.2,49,2,1,9,2,16,0,0,0,0,17851,7.0,18062,205,55,3919,3135,20.5,1785.1
4526234314,0,18,3,0,7,7,9,1,1,0,0,16136,6.4,16071,212,47,436,-475,21.2,1613.6,18,5,1,7,7,6,0,0,0,0,15700,6.8,16546,190,42,-436,475,19.0,1570.0
4456330802,1,21,2,0,7,6,3,1,0,1,0,16653,7.4,19603,229,72,140,1737,22.9,1665.3,130,1,1,6,7,5,0,0,0,0,16513,7.0,17866,229,31,-140,-1737,22.9,1651.3
4463528314,1,17,1,0,9,6,12,0,0,0,0,17752,7.0,18405,212,47,1512,447,21.2,1775.2,12,6,1,6,9,6,1,1,0,0,16240,7.0,17958,219,52,-1512,-447,21.9,1624.0
4520889753,0,16,5,1,6,7,9,1,1,0,0,15303,6.6,16803,209,28,-1154,-1629,20.9,1530.3,21,1,0,7,6,8,0,0,0,0,16457,7.0,18432,207,44,1154,1629,20.7,1645.7
4492674623,1,14,1,1,10,3,8,1,0,1,1,20173,7.4,20931,248,56,6281,4551,24.8,2017.3,16,0,0,3,10,0,1,1,0,0,13892,6.6,16380,204,40,-6281,-4551,20.4,1389.2
4488366121,1,16,5,0,13,5,13,0,0,0,0,20067,7.4,20095,229,36,4409,4503,22.9,2006.7,16,2,1,5,13,5,1,1,0,0,15658,6.2,15592,182,48,-4409,-4503,18.2,1565.8
4470811112,0,16,0,1,4,6,2,0,0,0,0,15661,6.8,17735,235,38,-1055,-1236,23.5,1566.1,12,5,0,6,4,8,0,0,0,0,16716,7.2,18971,222,52,1055,1236,22.2,1671.6
4484058077,1,35,3,1,6,6,8,1,1,0,0,16073,7.0,18021,196,52,-570,467,19.6,1607.3,146,3,0,6,6,10,0,0,0,0,16643,6.8,17554,215,46,570,-467,21.5,1664.3
4502153690,0,15,2,0,3,5,2,0,0,0,0,15423,7.0,18346,244,56,-89,-41,24.4,1542.3,13,1,1,5,3,3,1,1,0,0,15512,7.0,18387,228,51,89,41,22.8,1551.2
4525208730,1,15,3,1,6,4,4,1,1,0,0,16645,7.2,19110,242,52,1151,470,24.2,1664.5,15,2,0,4,6,3,1,0,1,0,15494,7.0,18640,205,50,-1151,-470,20.5,1549.4
4424119688,1,14,1,1,5,8,3,0,0,0,0,15747,7.0,17856,214,52,-1358,-1063,21.4,1574.7,15,2,0,8,5,8,0,0,0,0,17105,7.0,18919,219,52,1358,1063,21.9,1710.5
4524047710,1,16,3,1,8,1,11,1,0,1,1,18976,7.2,19176,259,49,4910,2573,25.9,1897.6,20,2,0,1,8,0,1,1,0,0,14066,6.6,16603,224,43,-4910,-2573,22.4,1406.6
4468373148,0,10,2,1,12,12,6,2,1,1,1,19975,7.4,20209,213,56,1843,518,21.3,1997.5,13,2,0,12,12,9,0,0,0,0,18132,7.2,19691,183,43,-1843,-518,18.3,1813.2
4440425565,1,16,2,0,13,6,13,2,1,1,2,22162,7.8,21254,249,72,6578,5388,24.9,2216.2,10,2,1,6,13,7,0,0,0,0,15584,6.2,15866,156,68,-6578,-5388,15.6,1558.4
4482423857,1,14,0,1,13,10,15,0,0,0,0,19366,7.0,18628,229,56,1973,1461,22.9,1936.6,11,2,0,10,13,13,1,1,0,0,17393,6.8,17167,164,43,-1973,-1461,16.4,1739.3
4524733068,1,14,4,0,7,10,8,0,0,0,0,15724,6.4,15533,163,40,-3798,-2337,16.3,1572.4,17,4,1,10,7,10,1,0,1,2,19522,7.0,17870,222,44,3798,2337,22.2,1952.2
4449091810,0,53,1,0,3,6,4,0,0,0,0,14749,6.8,17146,200,49,-2513,-3419,20.0,1474.9,15,0,1,6,3,5,0,0,0,0,17262,7.4,20565,246,70,2513,3419,24.6,1726.2
4453444549,0,18,2,1,4,5,6,1,1,0,0,15466,6.8,17220,228,48,488,473,22.8,1546.6,17,3,0,5,4,8,0,0,0,0,14978,6.8,16747,182,48,-488,-473,18.2,1497.8
4505931030,1,17,2,1,7,4,6,1,1,0,0,17590,7.2,19299,231,56,2708,1906,23.1,1759.0,107,2,0,4,7,3,1,0,1,0,14882,6.6,17393,223,37,-2708,-1906,22.3,1488.2
4485904786,0,15,5,1,3,9,2,1,1,0,0,15000,6.6,16731,221,51,-3761,-2552,22.1,1500.0,31,2,0,9,3,7,0,0,0,0,18761,7.2,19283,225,48,3761,2552,22.5,1876.1
4520860576,0,17,3,0,4,7,8,0,0,0,0,15842,6.8,17016,211,48,-1214,-840,21.1,1584.2,40,1,1,7,4,11,2,1,1,0,17056,6.8,17856,198,56,1214,840,19.8,1705.6
4480098596,0,15,2,1,8,6,8,1,0,1,0,17381,7.0,18978,218,60,-119,-766,21.8,1738.1,52,3,0,6,8,6,1,1,0,0,17500,7.2,19744,235,75,119,766,23.5,1750.0
4524598212,1,16,2,1,11,6,8,1,0,1,0,18045,7.4,20275,227,55,2647,3204,22.7,1804.5,15,6,0,6,11,10,0,0,0,0,15398,6.6,17071,203,35,-2647,-3204,20.3,1539.8
4446797537,1,14,2,0,5,6,6,1,1,0,0,17251,7.4,19984,233,76,334,955,23.3,1725.1,16,2,1,6,5,5,0,0,0,0,16917,7.0,19029,230,60,-334,-955,23.0,1691.7
4457440450,1,22,6,1,5,3,7,1,1,0,0,15849,6.8,17178,220,43,1236,478,22.0,1584.9,15,3,0,3,5,6,0,0,0,0,14613,6.6,16700,202,55,-1236,-478,20.2,1461.3
4452452649,0,13,5,0,6,7,2,0,0,0,0,15244,6.6,16787,199,52,-1101,-718,19.9,1524.4,17,4,1,7,6,5,2,1,1,0,16345,7.0,17505,212,40,1101,718,21.2,1634.5
4475645681,0,16,4,1,6,7,10,1,1,0,0,16447,7.0,18423,201,60,-168,376,20.1,1644.7,17,3,0,7,6,10,0,0,0,0,16615,7.0,18047,224,42,168,-376,22.4,1661.5
4479934659,0,18,2,1,11,9,13,0,0,0,0,17794,7.2,18646,211,39,337,-260,21.1,1779.4,13,4,0,9,11,7,1,1,0,0,17457,7.0,18906,218,56,-337,260,21.8,1745.7
4514830749,0,18,3,0,7,10,7,1,1,0,0,15842,6.6,17223,216,35,-3572,-1330,21.6,1584.2,21,5,1,10,7,10,0,0,0,1,19414,7.0,18553,225,36,3572,1330,22.5,1941.4
4521571856,0,17,4,1,5,3,6,1,1,0,0,16695,7.2,19112,257,56,1551,1481,25.7,1669.5,14,2,0,3,5,3,0,0,0,0,15144,6.8,17631,224,52,-1551,-1481,22.4,1514.4
4525008225,1,16,14,0,6,4,7,1,0,1,0,17658,7.2,19584,241,58,1947,2521,24.1,1765.8,35,3,1,4,6,6,0,0,0,0,15711,6.8,17063,247,42,-1947,-2521,24.7,1571.1
4462344917,1,36,7,0,9,2,9,1,1,0,0,17964,7.4,19813,213,69,3311,3991,21.3,1796.4,15,1,1,2,9,2,0,0,0,0,14653,6.4,15822,198,51,-3311,-3991,19.8,1465.3
4522089265,1,14,1,1,9,8,7,1,1,0,0,18044,7.2,18900,207,69,738,1289,20.7,1804.4,11,1,0,8,9,11,0,0,0,0,17306,6.8,17611,188,41,-738,-1289,18.8,1730.6
4518324429,1,21,5,1,5,1,5,2,1,1,0,16833,7.0,18765,244,65,3246,1680,24.4,1683.3,24,2,0,1,5,0,0,0,0,0,13587,6.6,17085,219,54,-3246,-1680,21.9,1358.7
4520895239,1,16,3,0,6,2,9,0,0,0,0,16627,7.0,18254,247,47,1899,308,24.7,1662.7,52,4,1,2,6,0,1,1,0,0,14728,6.8,17946,231,60,-1899,-308,23.1,1472.8
4491959967,0,14,0,1,9,9,6,0,0,0,0,17384,6.8,18722,227,48,-898,-939,22.7,1738.4,12,0,0,9,9,9,2,1,1,0,18282,7.2,19661,225,56,898,939,22.5,1828.2
4519887278,0,76,1,0,4,11,5,1,0,1,0,15373,6.6,16348,217,47,-4432,-3639,21.7,1537.3,14,2,1,11,4,16,1,1,0,0,19805,7.4,19987,226,80,4432,3639,22.6,1980.5
4526787106,0,37,2,1,4,5,4,1,1,0,0,16042,7.0,17865,240,68,-236,711,24.0,1604.2,16,2,0,5,4,8,0,0,0,0,16278,6.8,17154,241,44,236,-711,24.1,1627.8
4522881704,1,21,1,0,15,13,15,1,1,0,0,19683,7.2,19202,195,52,879,1795,19.5,1968.3,46,6,1,13,15,18,0,0,0,0,18804,6.6,17407,179,53,-879,-1795,17.9,1880.4
4494869975,1,14,0,0,3,6,3,0,0,0,0,15859,7.0,19145,241,72,-1296,227,24.1,1585.9,13,5,1,6,3,7,1,1,0,0,17155,7.2,18918,257,40,1296,-227,25.7,1715.5
4384241438,1,16,1,0,7,3,7,1,1,0,0,16355,7.0,18991,238,43,1143,1251,23.8,1635.5,11,0,1,3,7,2,0,0,0,0,15212,7.0,17740,216,59,-1143,-1251,21.6,1521.2
4517748095,0,14,1,0,5,14,6,2,1,1,0,15015,6.6,16032,167,54,-5065,-3552,16.7,1501.5,16,1,1,14,5,9,0,0,0,0,20080,7.4,19584,224,52,5065,3552,22.4,2008.0
4523728834,1,17,2,0,6,10,5,0,0,0,0,16747,6.8,18099,214,52,-1391,-16,21.4,1674.7,11,1,1,10,6,12,1,1,0,0,18138,6.8,18115,189,72,1391,16,18.9,1813.8
4523507584,1,15,0,1,8,12,5,1,1,0,0,16855,6.4,16841,216,44,-2672,-2811,21.6,1685.5,13,3,0,12,8,19,0,0,0,0,19527,7.4,19652,204,65,2672,2811,20.4,1952.7
4515649293,1,13,1,1,4,8,8,0,0,0,0,15352,6.4,15672,193,46,-1702,-1490,19.3,1535.2,15,1,0,8,4,13,1,1,0,0,17054,6.6,17162,191,44,1702,1490,19.1,1705.4
4472954314,0,17,2,0,5,7,6,1,0,1,0,15595,6.8,17384,206,45,-1840,-2402,20.6,1559.5,42,6,1,7,5,11,1,1,0,0,17435,7.4,19786,242,50,1840,2402,24.2,1743.5
4482198928,0,50,1,0,9,11,8,1,1,0,0,17248,6.6,16433,185,40,-109,158,18.5,1724.8,13,3,1,11,9,6,0,0,0,0,17357,6.4,16275,195,33,109,-158,19.5,1735.7
4491633476,1,17,4,1,11,7,10,0,0,0,0,19008,7.6,19915,235,42,2763,2019,23.5,1900.8,13,3,0,7,11,6,1,1,0,0,16245,7.0,17896,216,43,-2763,-2019,21.6,1624.5
4447974687,0,21,0,1,7,9,6,2,1,1,0,17359,7.2,18754,221,69,1,-116,22.1,1735.9,17,5,0,9,7,6,0,0,0,0,17358,7.0,18870,221,42,-1,116,22.1,1735.8
4526126419,1,17,4,0,8,8,9,2,1,1,0,17882,6.8,17930,205,64,1667,1183,20.5,1788.2,17,2,1,8,8,9,0,0,0,0,16215,6.8,16747,194,36,-1667,-1183,19.4,1621.5
4441626945,1,47,1,0,7,5,11,0,0,0,0,16544,6.8,17758,196,32,732,280,19.6,1654.4,18,1,1,5,7,5,1,1,0,0,15812,6.8,17478,199,58,-732,-280,19.9,1581.2
4486431159,1,16,3,1,11,2,14,1,1,0,0,18722,7.2,19399,216,52,4371,3099,21.6,1872.2,17,1,0,2,11,5,0,0,0,0,14351,6.6,16300,228,49,-4371,-3099,22.8,1435.1
4520562055,1,17,2,0,3,6,4,1,0,1,0,14920,6.8,17487,217,50,-1959,-630,21.7,1492.0,20,4,1,6,3,6,1,1,0,0,16879,7.0,18117,242,43,1959,630,24.2,1687.9
4511383179,1,14,4,1,5,2,5,2,1,1,0,16627,6.8,18676,223,50,2359,1681,22.3,1662.7,14,3,0,2,5,3,0,0,0,0,14268,6.6,16995,221,45,-2359,-1681,22.1,1426.8
4520001049,1,42,2,1,9,6,10,1,1,0,0,18395,7.4,19262,242,45,2862,1862,24.2,1839.5,17,3,0,6,9,4,0,0,0,0,15533,6.8,17400,200,40,-2862,-1862,20.0,1553.3
4509298842,0,18,2,0,8,8,12,0,0,0,0,17318,6.6,16336,175,56,-266,-1524,17.5,1731.8,46,1,1,8,8,9,1,1,0,0,17584,6.8,17860,217,51,266,1524,21.7,1758.4
4526275078,1,15,4,0,7,3,6,1,1,0,0,18038,7.2,19458,240,64,3973,3481,24.0,1803.8,14,1,1,3,7,1,0,0,0,0,14065,6.6,15977,195,48,-3973,-3481,19.5,1406.5
4487076086,0,97,3,0,11,7,20,1,1,0,0,17068,6.2,15357,153,32,786,-562,15.3,1706.8,16,2,1,7,11,8,0,0,0,0,16282,6.6,15919,199,40,-786,562,19.9,1628.2
4515418591,1,15,4,1,7,2,6,1,0,1,1,17819,7.2,19319,236,44,2979,1183,23.6,1781.9,18,1,0,2,7,1,1,1,0,0,14840,7.0,18136,223,72,-2979,-1183,22.3,1484.0
4407776093,1,117,8,1,6,1,7,1,1,0,0,16036,6.8,17948,200,56,2083,1282,20.0,1603.6,20,6,0,1,6,2,0,0,0,0,13953,6.8,16666,221,46,-2083,-1282,22.1,1395.3
4523083494,1,16,2,1,9,7,13,1,1,0,0,18073,7.4,19907,221,57,1766,1606,22.1,1807.3,40,1,0,7,9,11,1,0,1,0,16307,6.8,18301,198,48,-1766,-1606,19.8,1630.7
4521355308,1,17,4,0,3,4,1,1,1,0,0,14507,6.6,17455,207,69,-885,180,20.7,1450.7,17,4,1,4,3,4,0,0,0,0,15392,6.8,17275,206,51,885,-180,20.6,1539.2
4523556963,1,19,5,1,7,5,10,1,1,0,0,16460,7.0,17623,220,52,1068,-736,22.0,1646.0,15,3,0,5,7,5,0,0,0,0,15392,6.8,18359,209,57,-1068,736,20.9,1539.2
4513214644,0,15,2,0,1,8,1,0,0,0,0,13129,6.6,16126,184,43,-4800,-1308,18.4,1312.9,18,3,1,8,1,10,0,0,0,0,17929,7.0,17434,218,48,4800,1308,21.8,1792.9
4511505654,0,105,3,0,5,11,4,0,0,0,0,15617,6.6,17334,202,63,-3516,-2677,20.2,1561.7,11,3,1,11,5,6,1,0,1,0,19133,7.4,20011,237,52,3516,2677,23.7,1913.3
4520682633,0,17,3,0,2,3,6,1,1,0,0,13918,6.8,17189,209,48,-1382,-271,20.9,1391.8,16,0,1,3,2,1,0,0,0,0,15300,6.8,17460,260,40,1382,271,26.0,1530.0
4525792479,1,40,3,1,6,6,8,1,1,0,0,16961,6.8,17778,238,48,-33,-998,23.8,1696.1,15,13,0,6,6,4,1,0,1,0,16994,7.0,18776,213,58,33,998,21.3,1699.4
4516530158,0,35,1,0,7,10,7,1,0,1,0,16511,7.2,18667,209,43,-2922,-1424,20.9,1651.1,12,0,1,10,7,13,0,0,0,0,19433,7.4,20091,212,72,2922,1424,21.2,1943.3
4449928172,0,21,3,0,5,7,5,1,0,1,0,15288,6.6,17567,192,56,-1308,-564,19.2,1528.8,29,4,1,7,5,6,1,1,0,0,16596,7.0,18131,223,49,1308,564,22.3,1659.6
4520617887,0,19,3,1,6,6,6,0,0,0,0,15866,6.6,17209,207,45,-859,-1186,20.7,1586.6,17,4,0,6,6,10,0,0,0,0,16725,7.2,18395,245,66,859,1186,24.5,1672.5
4524983213,1,18,4,1,9,7,10,1,1,0,0,16922,6.8,17350,207,36,-251,-1675,20.7,1692.2,15,3,0,7,9,3,0,0,0,0,17173,7.2,19025,221,48,251,1675,22.1,1717.3
4475217801,1,21,3,1,5,2,4,0,0,0,0,16350,7.0,18701,245,53,1290,1337,24.5,1635.0,37,6,0,2,5,2,0,0,0,0,15060,6.8,17364,236,54,-1290,-1337,23.6,1506.0
4513258080,1,14,5,1,5,9,5,1,0,1,0,15592,7.0,17700,218,39,-2078,-1506,21.8,1559.2,20,5,0,9,5,6,0,0,0,0,17670,7.6,19206,205,51,2078,1506,20.5,1767.0
4524973886,0,55,5,1,2,5,4,1,1,0,0,14692,6.8,16959,226,55,-1488,-572,22.6,1469.2,18,4,0,5,2,6,0,0,0,0,16180,6.8,17531,234,55,1488,572,23.4,1618.0
4470414312,1,18,4,1,1,1,1,1,1,0,0,14529,7.0,17655,241,58,924,1282,24.1,1452.9,18,3,0,1,1,0,1,0,1,0,13605,6.4,16373,215,42,-924,-1282,21.5,1360.5
4493201984,0,17,5,1,3,1,4,1,0,1,0,16247,7.0,19000,257,56,1351,940,25.7,1624.7,25,3,0,1,3,0,1,1,0,0,14896,7.0,18060,269,60,-1351,-940,26.9,1489.6
4462918469,0,22,6,0,1,5,1,0,0,0,0,15065,6.8,17423,252,68,-950,-1785,25.2,1506.5,29,3,1,5,1,6,0,0,0,0,16015,7.2,19208,238,55,950,1785,23.8,1601.5
4476983984,0,16,2,1,4,8,4,1,1,0,0,15247,6.6,17064,209,56,-2720,-2473,20.9,1524.7,12,3,0,8,4,9,0,0,0,0,17967,7.2,19537,207,64,2720,2473,20.7,1796.7
4508384732,0,17,0,1,10,5,8,0,0,0,0,17403,7.0,18532,181,40,1515,1112,18.1,1740.3,16,5,0,5,10,7,1,1,0,0,15888,7.0,17420,231,44,-1515,-1112,23.1,1588.8
4430925118,1,89,3,0,7,4,7,2,1,1,0,16985,7.0,19175,241,52,986,1194,24.1,1698.5,17,1,1,4,7,5,0,0,0,0,15999,7.0,17981,267,48,-986,-1194,26.7,1599.9
4513807065,0,19,4,1,6,10,9,0,0,0,0,16758,7.0,17743,243,43,-1356,-1064,24.3,1675.8,17,4,0,10,6,15,0,0,0,0,18114,7.2,18807,207,52,1356,1064,20.7,1811.4
4464521946,0,17,4,1,4,8,3,1,1,0,0,15769,6.8,17360,222,59,-2999,-1476,22.2,1576.9,18,3,0,8,4,11,0,0,0,1,18768,7.0,18836,232,60,2999,1476,23.2,1876.8
4477952218,0,18,5,1,2,3,1,0,0,0,0,15219,6.8,17357,241,48,-563,-1422,24.1,1521.9,19,5,0,3,2,3,1,1,0,0,15782,7.0,18779,225,68,563,1422,22.5,1578.2
4515440018,0,136,7,1,6,5,3,1,0,1,1,17174,7.0,18458,231,49,507,510,23.1,1717.4,38,2,0,5,6,5,1,1,0,0,16667,7.0,17948,233,57,-507,-510,23.3,1666.7
4458533375,1,14,3,1,7,1,6,1,1,0,0,17141,7.0,18486,230,36,3332,1330,23.0,1714.1,36,4,0,1,7,0,1,0,1,0,13809,6.8,17156,218,48,-3332,-1330,21.8,1380.9
4455484063,1,15,2,0,4,9,5,0,0,0,0,16044,7.0,18226,224,56,-1427,-1008,22.4,1604.4,18,2,1,9,4,6,0,0,0,0,17471,7.2,19234,243,28,1427,1008,24.3,1747.1
4447279447,0,18,5,1,5,10,4,1,1,0,0,17315,7.4,19378,253,66,-733,-1569,25.3,1731.5,21,6,0,10,5,7,0,0,0,0,18048,7.6,20947,216,54,733,1569,21.6,1804.8
4504190601,0,20,3,0,2,9,2,0,0,0,0,14944,6.6,17675,239,47,-2695,-1275,23.9,1494.4,14,3,1,9,2,9,1,1,0,0,17639,7.0,18950,252,46,2695,1275,25.2,1763.9
4423927997,0,41,3,1,4,9,1,1,0,1,0,15709,7.0,17814,207,52,-1696,-1748,20.7,1570.9,22,4,0,9,4,6,1,1,0,0,17405,7.2,19562,239,55,1696,1748,23.9,1740.5
4512811324,1,23,3,0,10,5,16,0,0,0,0,17272,6.4,15840,192,40,2171,-261,19.2,1727.2,37,2,1,5,10,6,2,1,1,0,15101,6.6,16101,199,40,-2171,261,19.9,1510.1
4520755410,1,18,1,0,9,6,10,1,0,1,0,17512,7.0,18140,186,51,2549,1269,18.6,1751.2,17,0,1,6,9,6,1,1,0,0,14963,6.6,16871,174,41,-2549,-1269,17.4,1496.3
4518536187,0,14,0,1,6,4,5,1,1,0,0,16073,6.8,17592,211,44,32,822,21.1,1607.3,19,3,0,4,6,8,1,0,1,0,16041,6.2,16770,207,44,-32,-822,20.7,1604.1
4518564856,0,15,1,0,6,9,5,0,0,0,0,15773,7.0,18578,228,44,-2069,-22,22.8,1577.3,13,1,1,9,6,11,1,1,0,0,17842,7.0,18600,222,56,2069,22,22.2,1784.2
4473156943,1,14,0,0,6,9,7,0,0,0,0,15809,7.0,18227,202,62,-2167,-1158,20.2,1580.9,32,2,1,9,6,6,0,0,0,0,17976,7.2,19385,243,53,2167,1158,24.3,1797.6
4521233015,1,16,2,1,14,6,11,1,1,0,0,18537,7.2,19024,200,48,1809,1633,20.0,1853.7,15,1,0,6,14,5,0,0,0,0,16728,6.8,17391,193,64,-1809,-1633,19.3,1672.8
4516557839,1,19,2,0,7,8,8,0,0,0,0,16992,7.0,18385,219,44,-371,-172,21.9,1699.2,30,3,1,8,7,7,1,1,0,0,17363,7.2,18557,225,65,371,172,22.5,1736.3
4519850833,0,10,1,1,5,7,8,0,0,0,0,15548,6.4,16604,191,52,-459,-307,19.1,1554.8,16,2,0,7,5,9,1,1,0,0,16007,6.8,16911,196,40,459,307,19.6,1600.7
4527078007,1,58,1,1,12,9,13,1,0,1,0,19104,7.0,17733,204,48,2241,1077,20.4,1910.4,17,2,0,9,12,11,1,1,0,0,16863,6.8,16656,200,48,-2241,-1077,20.0,1686.3
4527387973,1,18,1,0,7,5,11,1,0,1,0,17881,7.2,19560,257,56,3135,2366,25.7,1788.1,12,1,1,5,7,7,0,0,0,0,14746,6.6,17194,201,36,-3135,-2366,20.1,1474.6
4522392922,1,15,2,1,10,2,11,0,0,0,0,18104,7.4,19373,201,60,4142,2934,20.1,1810.4,22,2,0,2,10,1,0,0,0,0,13962,6.6,16439,176,49,-4142,-2934,17.6,1396.2
4521577993,0,16,2,0,7,9,6,0,0,0,0,16035,7.0,18455,180,55,-2691,-2196,18.0,1603.5,16,2,1,9,7,9,1,1,0,0,18726,7.6,20651,243,63,2691,2196,24.3,1872.6
4460998770,0,18,3,0,7,7,7,0,0,0,0,17122,7.0,19090,236,44,360,1102,23.6,1712.2,36,4,1,7,7,7,1,1,0,0,16762,7.0,17988,187,55,-360,-1102,18.7,1676.2
4521104135,0,14,2,0,4,8,4,1,1,0,0,14439,6.6,16198,196,41,-2975,-2024,19.6,1443.9,39,1,1,8,4,10,0,0,0,0,17414,7.0,18222,235,40,2975,2024,23.5,1741.4
4466248745,0,130,5,0,3,7,3,0,0,0,0,14649,6.8,17099,186,52,-2588,-884,18.6,1464.9,21,2,1,7,3,9,1,1,0,0,17237,7.0,17983,246,36,2588,884,24.6,1723.7
4511302072,1,15,1,1,9,4,9,0,0,0,0,17514,7.0,17672,236,28,3170,1984,23.6,1751.4,39,1,0,4,9,6,0,0,0,0,14344,6.6,15688,175,43,-3170,-1984,17.5,1434.4
4522623141,0,39,3,1,7,8,11,1,1,0,0,16562,7.0,17625,180,51,438,196,18.0,1656.2,16,2,0,8,7,5,0,0,0,0,16124,7.0,17429,201,48,-438,-196,20.1,1612.4
4515929996,0,22,1,1,10,4,17,1,1,0,0,17161,7.0,17817,157,48,1487,577,15.7,1716.1,17,2,0,4,10,3,1,0,1,0,15674,6.6,17240,203,68,-1487,-577,20.3,1567.4
4491022192,1,13,1,1,8,1,8,1,0,1,0,18066,7.0,18920,242,56,4597,3583,24.2,1806.6,15,1,0,1,8,1,1,1,0,0,13469,6.4,15337,189,52,-4597,-3583,18.9,1346.9
4511029912,0,82,4,1,6,13,2,0,0,0,0,15539,6.8,17438,202,48,-4311,-2532,20.2,1553.9,19,4,0,13,6,14,1,1,0,0,19850,7.4,19970,234,55,4311,2532,23.4,1985.0
4505373402,1,17,3,0,6,3,6,0,0,0,0,17671,7.0,18649,250,56,2135,1254,25.0,1767.1,59,4,1,3,6,4,1,1,0,0,15536,7.0,17395,231,52,-2135,-1254,23.1,1553.6
4524537061,0,38,1,0,7,7,4,0,0,0,0,15793,6.8,17795,191,41,-571,-932,19.1,1579.3,39,0,1,7,7,3,1,0,1,0,16364,7.2,18727,227,53,571,932,22.7,1636.4
4508930231,0,16,3,0,5,6,6,0,0,0,0,15268,6.6,17072,211,49,-2308,-1946,21.1,1526.8,12,2,1,6,5,8,1,1,0,0,17576,7.2,19018,263,56,2308,1946,26.3,1757.6
4520794662,1,12,1,0,12,7,14,0,0,0,0,19970,7.2,19994,221,56,3605,3504,22.1,1997.0,21,2,1,7,12,8,0,0,0,0,16365,6.4,16490,186,53,-3605,-3504,18.6,1636.5
4486816853,0,16,5,1,9,3,10,1,1,0,0,17679,7.4,19757,237,54,2488,2453,23.7,1767.9,16,4,0,3,9,5,0,0,0,0,15191,7.0,17304,222,49,-2488,-2453,22.2,1519.1
4486082210,0,14,2,1,5,9,6,2,1,1,0,16142,6.8,16958,230,51,-1231,-888,23.0,1614.2,25,2,0,9,5,11,0,0,0,0,17373,6.8,17846,221,53,1231,888,22.1,1737.3
4524796827,1,16,1,1,9,4,10,2,1,1,0,17097,7.2,18583,220,47,1186,907,22.0,1709.7,13,2,0,4,9,3,0,0,0,0,15911,7.0,17676,213,68,-1186,-907,21.3,1591.1
4499810008,0,12,4,0,6,6,10,0,0,0,0,15241,6.6,16491,190,36,-1137,-1402,19.0,1524.1,17,1,1,6,6,6,2,1,1,0,16378,6.8,17893,224,45,1137,1402,22.4,1637.8
4450865114,0,14,5,1,7,8,10,1,0,1,0,16740,6.8,18257,234,40,-1784,-889,23.4,1674.0,17,2,0,8,7,8,1,1,0,0,18524,7.0,19146,251,64,1784,889,25.1,1852.4
4472056933,1,15,1,1,12,6,16,0,0,0,0,18850,6.8,17995,216,55,3293,987,21.6,1885.0,13,3,0,6,12,7,0,0,0,0,15557,6.8,17008,210,37,-3293,-987,21.0,1555.7
4489152949,1,20,3,1,6,7,11,0,0,0,0,16535,6.8,17913,199,45,-847,11,19.9,1653.5,14,4,0,7,6,10,1,1,0,0,17382,6.8,17902,227,46,847,-11,22.7,1738.2
4523591630,0,15,4,0,4,3,5,0,0,0,0,15132,6.8,17330,197,53,-1487,-473,19.7,1513.2,17,3,1,3,4,4,0,0,0,0,16619,7.0,17803,235,64,1487,473,23.5,1661.9
4487198223,0,21,2,0,5,14,6,0,0,0,0,16251,6.8,16548,213,46,-4859,-2956,21.3,1625.1,18,3,1,14,5,14,1,0,1,2,21110,7.2,19504,226,44,4859,2956,22.6,2111.0
4521709624,1,41,3,1,7,7,5,1,1,0,0,16875,6.8,18112,219,48,-795,236,21.9,1687.5,19,3,0,7,7,9,0,0,0,0,17670,6.8,17876,221,44,795,-236,22.1,1767.0
4501386832,0,19,1,1,8,2,11,0,0,0,0,17526,6.8,17824,222,63,2761,680,22.2,1752.6,13,3,0,2,8,2,1,1,0,0,14765,6.8,17144,216,64,-2761,-680,21.6,1476.5
4524546018,1,43,3,0,5,8,3,0,0,0,0,16344,7.4,19207,230,64,-860,949,23.0,1634.4,13,8,1,8,5,6,1,1,0,0,17204,7.2,18258,202,52,860,-949,20.2,1720.4
4513101725,1,15,3,0,3,4,1,0,0,0,0,15236,7.2,18474,236,41,-297,548,23.6,1523.6,15,2,1,4,3,4,1,1,0,0,15533,7.0,17926,205,54,297,-548,20.5,1553.3
4518738712,1,40,1,0,7,14,6,1,1,0,0,15974,6.2,16174,183,37,-3421,-2624,18.3,1597.4,13,4,1,14,7,12,0,0,0,0,19395,7.2,18798,219,49,3421,2624,21.9,1939.5
4524351356,0,18,3,0,4,10,4,0,0,0,0,15409,6.8,17089,218,40,-2161,-297,21.8,1540.9,14,1,1,10,4,18,0,0,0,0,17570,6.6,17386,187,48,2161,297,18.7,1757.0
4512836783,1,18,7,0,1,2,1,1,0,1,0,14583,6.6,17525,244,54,262,1643,24.4,1458.3,19,1,1,2,1,3,1,1,0,0,14321,6.4,15882,224,32,-262,-1643,22.4,1432.1
4511547876,0,13,9,0,3,4,4,1,1,0,0,14017,6.2,15335,185,48,-2309,-2673,18.5,1401.7,35,1,1,4,3,5,0,0,0,0,16326,7.2,18008,214,63,2309,2673,21.4,1632.6
4453648603,1,12,2,0,5,9,4,1,1,0,0,14996,6.4,15901,188,44,-3331,-3464,18.8,1499.6,15,3,1,9,5,11,1,0,1,0,18327,7.2,19365,218,63,3331,3464,21.8,1832.7
4524968728,0,17,2,0,5,11,7,0,0,0,0,15881,6.8,17927,214,39,-1943,-1582,21.4,1588.1,60,3,1,11,5,7,1,1,0,0,17824,7.2,19509,216,45,1943,1582,21.6,1782.4
4519524460,0,17,2,0,2,4,1,0,0,0,0,14144,6.8,17041,208,42,-1122,-643,20.8,1414.4,16,4,1,4,2,1,1,1,0,0,15266,6.8,17684,230,46,1122,643,23.0,1526.6
4518687922,1,20,4,1,9,3,9,1,1,0,0,17731,7.0,18766,252,55,2748,842,25.2,1773.1,19,2,0,3,9,3,0,0,0,0,14983,7.0,17924,214,52,-2748,-842,21.4,1498.3
4459294938,1,14,4,0,7,2,6,0,0,0,0,16977,7.2,19637,209,64,1926,3774,20.9,1697.7,14,1,1,2,7,3,1,1,0,0,15051,6.4,15863,235,56,-1926,-3774,23.5,1505.1
4509930075,1,14,2,1,6,3,10,0,0,0,0,16911,6.8,17876,224,44,1913,842,22.4,1691.1,14,3,0,3,6,3,1,1,0,0,14998,6.8,17034,222,55,-1913,-842,22.2,1499.8
4506803451,1,16,4,1,11,2,8,1,1,0,0,19038,7.4,20256,252,46,4090,2523,25.2,1903.8,14,3,0,2,11,3,0,0,0,0,14948,7.0,17733,214,68,-4090,-2523,21.4,1494.8
4464253176,0,13,3,1,5,8,1,1,1,0,0,14528,6.4,16282,175,49,-3991,-3529,17.5,1452.8,34,1,0,8,5,3,0,0,0,0,18519,7.4,19811,239,71,3991,3529,23.9,1851.9
4527385549,0,15,5,1,4,2,6,0,0,0,0,15744,7.0,18381,219,60,1185,1042,21.9,1574.4,15,3,0,2,4,3,0,0,0,0,14559,6.8,17339,231,60,-1185,-1042,23.1,1455.9
4525547505,1,15,0,0,9,6,6,0,0,0,0,16950,7.0,18151,218,32,1081,1757,21.8,1695.0,16,3,1,6,9,8,1,1,0,0,15869,6.4,16394,183,59,-1081,-1757,18.3,1586.9
4520540286,1,19,6,0,4,5,5,1,1,0,0,16331,7.2,18927,246,60,-462,542,24.6,1633.1,18,5,1,5,4,8,0,0,0,0,16793,6.8,18385,273,49,462,-542,27.3,1679.3
4449504375,1,15,9,0,13,5,10,2,1,1,0,20038,7.8,21588,222,71,4079,5568,22.2,2003.8,39,1,1,5,13,6,0,0,0,0,15959,6.6,16020,208,40,-4079,-5568,20.8,1595.9
4510135143,0,48,2,1,7,5,10,0,0,0,0,17037,7.0,17825,237,40,987,-377,23.7,1703.7,15,5,0,5,7,5,2,1,1,0,16050,7.0,18202,219,60,-987,377,21.9,1605.0
4494914553,1,14,2,1,6,4,7,1,1,0,0,16439,7.2,18635,220,56,1603,1799,22.0,1643.9,113,0,0,4,6,1,1,0,1,0,14836,6.6,16836,213,51,-1603,-1799,21.3,1483.6
4479596391,1,90,1,1,8,5,10,1,1,0,0,16400,6.8,18604,181,48,-125,537,18.1,1640.0,10,3,0,5,8,2,0,0,0,0,16525,7.0,18067,247,53,125,-537,24.7,1652.5
4476661936,0,18,2,0,9,14,9,1,0,1,0,16897,6.4,15328,159,26,-2191,-1391,15.9,1689.7,17,3,1,14,9,19,1,1,0,0,19088,6.8,16719,185,39,2191,1391,18.5,1908.8
4462971109,0,15,0,0,4,7,4,0,0,0,0,15317,7.0,18310,225,56,-1742,-357,22.5,1531.7,26,4,1,7,4,7,1,1,0,0,17059,6.8,18667,221,67,1742,357,22.1,1705.9
4522797583,0,17,2,1,3,4,6,1,1,0,0,14609,6.8,16875,218,37,-2141,-2439,21.8,1460.9,40,4,0,4,3,4,1,0,1,0,16750,7.2,19314,253,51,2141,2439,25.3,1675.0
4482288525,1,15,4,0,4,6,4,0,0,0,0,14562,6.6,15925,164,44,-1295,-1230,16.4,1456.2,19,1,1,6,4,5,1,1,0,0,15857,6.6,17155,213,56,1295,1230,21.3,1585.7
4519562141,0,17,4,0,6,9,6,0,0,0,0,16377,6.6,16818,209,49,-780,-73,20.9,1637.7,24,2,1,9,6,14,0,0,0,0,17157,6.6,16891,200,32,780,73,20.0,1715.7
4474824980,1,15,1,1,5,3,6,1,1,0,0,15667,7.0,17128,202,51,481,-259,20.2,1566.7,17,1,0,3,5,1,0,0,0,0,15186,6.8,17387,219,57,-481,259,21.9,1518.6
4519651388,0,13,2,1,10,16,7,0,0,0,0,16759,6.4,15499,163,37,-4236,-4211,16.3,1675.9,15,2,0,16,10,15,1,1,0,0,20995,7.4,19710,187,46,4236,4211,18.7,2099.5
4523940286,0,18,2,0,5,6,8,2,1,1,0,16315,6.8,17744,236,56,199,403,23.6,1631.5,17,2,1,6,5,9,0,0,0,0,16116,6.6,17341,227,34,-199,-403,22.7,1611.6
4471416203,0,32,4,1,7,8,8,1,1,0,0,16179,6.8,16814,212,46,105,-1547,21.2,1617.9,24,5,0,8,7,5,1,0,1,0,16074,7.0,18361,200,42,-105,1547,20.0,1607.4
4523127328,0,13,4,0,4,7,3,0,0,0,0,13824,6.2,14814,167,40,-5059,-5247,16.7,1382.4,14,4,1,7,4,9,2,1,1,1,18883,7.6,20061,235,79,5059,5247,23.5,1888.3
4445596529,0,36,2,0,4,6,3,0,0,0,0,15306,6.8,17560,220,52,-1171,-11,22.0,1530.6,19,1,1,6,4,5,0,0,0,0,16477,6.8,17571,211,43,1171,11,21.1,1647.7
4523593129,0,15,4,0,1,5,0,0,0,0,0,13943,6.8,17294,230,55,-4036,-1844,23.0,1394.3,15,3,1,5,1,5,1,1,0,1,17979,7.2,19138,231,65,4036,1844,23.1,1797.9
4444878201,1,23,3,1,14,9,18,1,1,0,0,20909,7.4,19188,210,52,3193,1212,21.0,2090.9,14,3,0,9,14,9,0,0,0,0,17716,7.0,17976,183,53,-3193,-1212,18.3,1771.6
4468287973,0,11,2,0,2,3,5,1,0,1,0,14237,6.6,17344,178,73,-2114,-1121,17.8,1423.7,15,3,1,3,2,5,1,1,0,0,16351,7.0,18465,248,64,2114,1121,24.8,1635.1
4523041971,0,32,2,1,1,5,2,1,0,1,0,14197,6.8,17212,225,48,-2144,-2451,22.5,1419.7,14,19,0,5,1,3,1,1,0,0,16341,7.2,19663,246,52,2144,2451,24.6,1634.1
4471792481,0,11,0,0,6,15,8,0,0,0,0,15653,6.4,16813,158,43,-6105,-4065,15.8,1565.3,11,0,1,15,6,13,0,0,0,1,21758,7.8,20878,223,64,6105,4065,22.3,2175.8
4520635728,1,14,3,1,6,8,5,1,0,1,0,16353,7.0,18367,214,56,-560,-46,21.4,1635.3,16,2,0,8,6,10,1,1,0,0,16913,7.4,18413,221,44,560,46,22.1,1691.3
4509204216,0,13,0,0,3,8,2,0,0,0,0,14500,6.6,16097,209,50,-3614,-3434,20.9,1450.0,16,1,1,8,3,10,1,0,1,0,18114,7.2,19531,222,60,3614,3434,22.2,1811.4
4497870757,0,17,2,1,3,11,4,1,1,0,0,14625,6.6,16487,200,48,-2978,-2960,20.0,1462.5,19,3,0,11,3,12,0,0,0,0,17603,7.4,19447,190,44,2978,2960,19.0,1760.3
4483760431,1,11,1,0,8,5,10,2,1,1,0,17823,7.4,19752,215,64,1014,950,21.5,1782.3,9,1,1,5,8,5,0,0,0,0,16809,7.0,18802,219,75,-1014,-950,21.9,1680.9
4521060051,0,38,1,0,7,8,9,1,0,1,0,16623,6.8,17503,206,59,-389,329,20.6,1662.3,16,1,1,8,7,10,1,1,0,0,17012,6.8,17174,225,43,389,-329,22.5,1701.2
4526519393,0,20,2,1,3,4,4,1,1,0,0,15613,7.0,17932,214,66,-468,-1321,21.4,1561.3,14,2,0,4,3,3,0,0,0,0,16081,7.2,19253,230,52,468,1321,23.0,1608.1
4495019552,0,17,4,0,3,4,5,1,1,0,0,16001,7.2,18372,265,56,-54,616,26.5,1600.1,20,3,1,4,3,6,0,0,0,0,16055,6.6,17756,223,54,54,-616,22.3,1605.5
4513869667,1,17,2,1,3,1,4,1,1,0,0,15634,6.6,17475,213,53,487,-618,21.3,1563.4,37,2,0,1,3,0,1,0,1,0,15147,7.0,18093,242,70,-487,618,24.2,1514.7
4521314954,0,43,3,0,2,3,2,1,1,0,0,14462,7.0,17760,213,56,-892,-818,21.3,1446.2,14,2,1,3,2,3,0,0,0,0,15354,7.0,18578,240,58,892,818,24.0,1535.4
4522109455,1,19,1,1,8,5,7,0,0,0,0,17033,7.0,17938,232,44,832,903,23.2,1703.3,13,6,0,5,8,8,2,1,1,0,16201,6.8,17035,228,58,-832,-903,22.8,1620.1
4495398614,1,15,0,1,9,12,11,0,0,0,0,17332,6.8,16861,170,47,-874,-1370,17.0,1733.2,16,2,0,12,9,11,0,0,0,0,18206,7.2,18231,218,48,874,1370,21.8,1820.6
4497865298,0,15,1,1,3,4,2,0,0,0,0,15409,6.8,17883,240,44,-729,-900,24.0,1540.9,35,0,0,4,3,4,0,0,0,0,16138,7.0,18783,250,44,729,900,25.0,1613.8
4508240261,0,125,0,1,4,5,2,1,1,0,0,14842,6.8,17067,184,46,-1992,-1722,18.4,1484.2,12,1,0,5,4,5,1,0,1,1,16834,7.2,18789,209,55,1992,1722,20.9,1683.4
4503781874,1,11,2,1,4,4,8,1,1,0,0,16341,7.4,19567,236,72,1567,1637,23.6,1634.1,14,0,0,4,4,3,1,0,1,0,14774,6.8,17930,203,55,-1567,-1637,20.3,1477.4
4443104744,1,31,2,1,12,11,16,0,0,0,0,19861,7.2,18934,220,43,2352,133,22.0,1986.1,14,3,0,11,12,12,2,1,1,0,17509,7.2,18801,183,48,-2352,-133,18.3,1750.9
4499814815,0,11,2,0,7,9,5,0,0,0,0,15939,6.6,16482,205,31,-1323,-1025,20.5,1593.9,15,0,1,9,7,6,0,0,0,0,17262,6.8,17507,167,34,1323,1025,16.7,1726.2
4525178929,0,18,3,1,3,4,4,0,0,0,0,15419,6.8,18138,251,52,-726,-1168,25.1,1541.9,19,7,0,4,3,4,2,1,1,0,16145,7.4,19306,236,64,726,1168,23.6,1614.5
4513689722,1,12,4,0,5,1,5,0,0,0,0,17512,7.4,20540,283,67,3122,3276,28.3,1751.2,13,0,1,1,5,1,1,1,0,0,14390,6.6,17264,244,40,-3122,-3276,24.4,1439.0
4508510865,1,17,4,0,5,5,2,0,0,0,0,15775,6.6,16946,249,45,-848,-4,24.9,1577.5,19,3,1,5,5,7,1,1,0,0,16623,6.6,16950,225,53,848,4,22.5,1662.3
4522819345,1,15,5,1,5,2,5,0,0,0,0,16977,7.0,18682,231,60,1807,1076,23.1,1697.7,43,2,0,2,5,1,1,0,1,0,15170,7.0,17606,237,51,-1807,-1076,23.7,1517.0
4515442306,1,19,5,0,2,6,2,0,0,0,0,14569,6.6,16380,234,52,-575,-1495,23.4,1456.9,43,6,1,6,2,3,1,1,0,0,15144,7.0,17875,200,52,575,1495,20.0,1514.4
4506796397,1,14,1,0,4,2,4,1,1,0,0,15346,7.0,18388,232,52,1342,1886,23.2,1534.6,14,0,1,2,4,2,0,0,0,0,14004,6.6,16502,206,40,-1342,-1886,20.6,1400.4
4507608618,0,34,0,0,6,10,9,0,0,0,0,15569,6.8,17357,167,48,-4346,-2178,16.7,1556.9,12,0,1,10,6,11,1,1,0,0,19915,7.4,19535,239,72,4346,2178,23.9,1991.5
4467235457,0,13,2,1,3,9,3,0,0,0,0,14797,6.6,17124,212,48,-3268,-3888,21.2,1479.7,13,2,0,9,3,6,1,1,0,0,18065,7.6,21012,218,80,3268,3888,21.8,1806.5
4522605613,0,36,3,1,6,5,4,0,0,0,0,15956,7.0,17947,229,43,56,-587,22.9,1595.6,18,1,0,5,6,2,1,1,0,0,15900,7.0,18534,231,44,-56,587,23.1,1590.0
4521203741,1,14,16,1,5,3,7,1,1,0,0,16305,7.0,18828,191,80,713,851,19.1,1630.5,33,1,0,3,5,2,0,0,0,0,15592,6.8,17977,229,47,-713,-851,22.9,1559.2
4511159553,1,18,2,1,9,5,9,1,0,1,0,18408,7.2,19614,225,56,2969,2575,22.5,1840.8,14,4,0,5,9,3,0,0,0,0,15439,6.6,17039,210,60,-2969,-2575,21.0,1543.9
4524144661,0,21,0,1,4,3,7,1,1,0,0,15796,6.8,16848,221,54,724,-1747,22.1,1579.6,10,2,0,3,4,3,0,0,0,0,15072,7.2,18595,209,56,-724,1747,20.9,1507.2
4500094420,1,16,6,0,10,9,7,1,0,1,0,17346,7.0,18518,214,51,149,1781,21.4,1734.6,45,2,1,9,10,10,0,0,0,0,17197,6.8,16737,205,44,-149,-1781,20.5,1719.7
4512479841,1,19,6,0,11,5,15,0,0,0,0,18945,7.0,18908,241,35,3107,2132,24.1,1894.5,66,3,1,5,11,9,0,0,0,0,15838,6.8,16776,199,52,-3107,-2132,19.9,1583.8
4460648700,1,17,1,0,3,3,3,1,1,0,0,14820,6.8,16751,215,36,-292,-127,21.5,1482.0,15,4,1,3,3,3,1,0,1,0,15112,6.6,16878,222,38,292,127,22.2,1511.2
4521252780,1,11,2,0,5,5,1,0,0,0,0,16065,7.4,20238,247,74,544,2063,24.7,1606.5,50,0,1,5,5,3,0,0,0,0,15521,6.8,18175,222,48,-544,-2063,22.2,1552.1
4523452477,0,24,1,1,5,3,6,1,0,1,0,15759,6.8,17563,219,46,338,-1062,21.9,1575.9,39,1,0,3,5,4,0,0,0,0,15421,7.0,18625,220,56,-338,1062,22.0,1542.1
4460445038,0,34,0,0,5,7,3,1,0,1,0,16616,7.0,18633,211,67,-47,318,21.1,1661.6,11,4,1,7,5,10,1,1,0,0,16663,7.0,18315,219,56,47,-318,21.9,1666.3
4516204235,1,18,2,0,5,4,7,1,0,1,0,16104,7.0,17890,231,48,1039,589,23.1,1610.4,16,5,1,4,5,3,1,1,0,0,15065,6.8,17301,205,47,-1039,-589,20.5,1506.5
4517748188,0,78,1,1,4,6,5,0,0,0,0,15593,6.6,17750,225,46,-416,-1639,22.5,1559.3,54,3,0,6,4,6,1,1,0,0,16009,7.2,19389,221,51,416,1639,22.1,1600.9
4516493520,0,12,3,0,2,5,3,0,0,0,0,14777,6.8,17450,215,51,-1276,-1016,21.5,1477.7,14,1,1,5,2,1,2,1,1,0,16053,7.2,18466,241,55,1276,1016,24.1,1605.3
4517685313,0,19,2,0,2,7,2,0,0,0,1,16418,7.0,17847,243,47,-258,-419,24.3,1641.8,37,1,1,7,2,9,1,1,0,0,16676,7.0,18266,211,40,258,419,21.1,1667.6
4520879335,0,13,4,0,5,10,5,0,0,0,0,16925,6.6,18087,233,64,-962,107,23.3,1692.5,17,3,1,10,5,16,1,1,0,0,17887,7.0,17980,213,44,962,-107,21.3,1788.7
4495628923,1,17,5,0,5,9,7,0,0,0,0,16103,6.6,17019,193,48,-2419,-1437,19.3,1610.3,50,5,1,9,5,14,1,0,1,0,18522,7.0,18456,246,40,2419,1437,24.6,1852.2
4519523296,0,68,3,0,3,6,3,1,1,0,0,15094,6.6,16864,237,48,-911,-870,23.7,1509.4,17,18,1,6,3,7,0,0,0,0,16005,6.8,17734,204,34,911,870,20.4,1600.5
4477243448,0,40,3,0,6,7,6,0,0,0,0,16302,6.8,17297,212,52,-211,-1305,21.2,1630.2,17,4,1,7,6,7,1,0,1,0,16513,7.2,18602,211,46,211,1305,21.1,1651.3
4473758044,0,24,2,0,2,8,2,1,0,1,0,13853,6.2,14781,205,42,-3650,-3119,20.5,1385.3,17,4,1,8,2,7,0,0,0,0,17503,7.2,17900,221,46,3650,3119,22.1,1750.3
4513809360,1,25,2,0,8,4,12,2,1,1,0,18167,7.0,18502,222,68,2691,2585,22.2,1816.7,16,2,1,4,8,4,0,0,0,0,15476,6.2,15917,234,41,-2691,-2585,23.4,1547.6
4520336674,1,19,7,0,10,4,13,1,1,0,0,18401,7.6,20273,236,60,3668,4509,23.6,1840.1,118,2,1,4,10,3,1,0,1,0,14733,6.6,15764,195,46,-3668,-4509,19.5,1473.3
4507618231,0,15,4,1,13,7,19,0,0,0,0,18781,6.8,17690,204,43,2348,1462,20.4,1878.1,15,4,0,7,13,12,0,0,0,0,16433,6.6,16228,191,44,-2348,-1462,19.1,1643.3
4526588067,1,122,4,0,5,5,7,1,0,1,1,17716,7.0,17963,216,44,8,-625,21.6,1771.6,15,3,1,5,5,4,1,1,0,0,17708,7.2,18588,249,68,-8,625,24.9,1770.8
4468252863,1,19,2,1,6,5,2,0,0,0,0,15740,7.0,18504,201,46,1078,2430,20.1,1574.0,11,4,0,5,6,5,1,1,0,0,14662,6.6,16074,158,53,-1078,-2430,15.8,1466.2
4519466762,0,16,6,0,1,2,1,1,1,0,0,13486,6.6,16382,200,47,-1433,-394,20.0,1348.6,16,2,1,2,1,2,0,0,0,0,14919,6.6,16776,241,40,1433,394,24.1,1491.9
4524654219,1,19,2,0,10,5,12,1,1,0,0,17834,7.2,19107,208,38,1260,1141,20.8,1783.4,15,1,1,5,10,4,0,0,0,0,16574,7.0,17966,226,50,-1260,-1141,22.6,1657.4
4524917610,1,17,2,1,7,2,9,1,1,0,0,15993,6.4,16122,188,51,2090,468,18.8,1599.3,18,4,0,2,7,2,0,0,0,0,13903,6.4,15654,209,36,-2090,-468,20.9,1390.3
4507827537,0,16,2,0,5,4,4,0,0,0,0,16429,7.0,18899,242,54,-172,1254,24.2,1642.9,18,1,1,4,5,5,0,0,0,0,16601,6.8,17645,219,47,172,-1254,21.9,1660.1
4515934716,1,19,5,0,11,10,21,0,0,0,0,20330,7.0,18408,234,44,2460,498,23.4,2033.0,22,3,1,10,11,24,1,1,0,0,17870,6.8,17910,205,60,-2460,-498,20.5,1787.0
4519917547,0,36,2,0,4,14,2,0,0,0,0,15719,6.8,17678,211,62,-3558,-2346,21.1,1571.9,12,0,1,14,4,9,2,1,1,0,19277,7.4,20024,212,60,3558,2346,21.2,1927.7
4522444254,0,13,1,1,3,8,2,0,0,0,0,15404,6.8,17439,240,56,-3096,-3752,24.0,1540.4,38,5,0,8,3,11,1,1,0,0,18500,7.6,21191,256,76,3096,3752,25.6,1850.0
4521020562,0,47,4,0,3,10,6,0,0,0,0,15018,6.4,15571,192,36,-3643,-3628,19.2,1501.8,41,3,1,10,3,18,1,1,0,0,18661,7.0,19199,220,55,3643,3628,22.0,1866.1
4490887510,0,14,3,0,6,7,6,0,0,0,0,16404,6.8,18840,245,48,-919,47,24.5,1640.4,112,3,1,7,6,10,0,0,0,0,17323,7.2,18793,219,50,919,-47,21.9,1732.3
4521429241,1,30,2,1,5,8,6,1,1,0,0,16131,7.0,17821,206,55,-1142,229,20.6,1613.1,17,1,0,8,5,6,1,0,1,0,17273,6.8,17592,221,52,1142,-229,22.1,1727.3
4450369263,1,18,2,1,2,4,2,1,1,0,0,14922,7.2,18119,227,65,-1316,-1111,22.7,1492.2,22,2,0,4,2,1,0,0,0,0,16238,6.8,19230,247,65,1316,1111,24.7,1623.8
4472597794,0,16,1,0,7,7,4,1,1,0,0,16518,7.0,18036,229,43,176,943,22.9,1651.8,10,1,1,7,7,9,0,0,0,0,16342,6.6,17093,200,38,-176,-943,20.0,1634.2
4518092454,0,15,3,0,5,9,5,0,0,0,0,15529,6.8,17544,200,52,-2347,-1346,20.0,1552.9,14,2,1,9,5,9,1,0,1,0,17876,7.2,18890,229,55,2347,1346,22.9,1787.6
4508196415,0,17,4,0,7,9,7,0,0,0,0,17177,6.8,18796,228,68,-1885,-210,22.8,1717.7,20,3,1,9,7,10,1,1,0,0,19062,7.2,19006,236,56,1885,210,23.6,1906.2
4523681256,1,14,2,1,11,7,11,0,0,0,0,18625,7.2,18941,234,38,1059,683,23.4,1862.5,9,2,0,7,11,4,0,0,0,0,17566,6.8,18258,191,63,-1059,-683,19.1,1756.6
4495693355,0,18,1,0,3,4,1,1,1,0,0,15701,7.0,17966,245,44,826,-382,24.5,1570.1,13,1,1,4,3,6,0,0,0,0,14875,7.0,18348,193,62,-826,382,19.3,1487.5
4435440889,1,19,6,1,2,4,4,0,0,0,0,15215,6.8,18360,231,52,-714,233,23.1,1521.5,25,3,0,4,2,6,1,1,0,0,15929,7.0,18127,208,60,714,-233,20.8,1592.9
4467269037,1,21,4,1,5,1,6,1,1,0,0,16956,7.2,18750,259,56,1723,740,25.9,1695.6,14,2,0,1,5,1,1,0,1,0,15233,6.8,18010,262,64,-1723,-740,26.2,1523.3
4520538056,0,40,3,1,7,10,7,0,0,0,0,15989,6.4,16090,179,32,-2662,-2170,17.9,1598.9,16,3,0,10,7,16,1,1,0,0,18651,7.0,18260,204,43,2662,2170,20.4,1865.1
4468130569,0,13,4,0,3,13,4,1,1,0,0,14676,6.2,14842,191,42,-4489,-4047,19.1,1467.6,59,3,1,13,3,13,0,0,0,0,19165,7.0,18889,224,49,4489,4047,22.4,1916.5
4519994537,0,18,1,0,3,7,2,0,0,0,0,14011,6.4,15027,197,33,-4043,-4142,19.7,1401.1,15,1,1,7,3,6,1,1,0,1,18054,7.2,19169,207,51,4043,4142,20.7,1805.4
4527257633,1,64,3,0,4,3,3,1,0,1,0,15844,6.8,17574,225,52,1147,254,22.5,1584.4,17,3,1,3,4,3,1,1,0,0,14697,6.8,17320,186,68,-1147,-254,18.6,1469.7
4519922949,1,16,1,0,5,7,3,1,1,0,0,16590,7.0,18656,251,48,-283,84,25.1,1659.0,142,1,1,7,5,8,0,0,0,0,16873,7.2,18572,208,52,283,-84,20.8,1687.3
4527216964,1,37,4,0,3,7,4,0,0,0,0,15270,7.0,18043,235,55,-1429,1040,23.5,1527.0,85,5,1,7,3,8,0,0,0,0,16699,6.4,17003,204,39,1429,-1040,20.4,1669.9
4511778720,1,16,1,1,8,2,10,1,0,1,0,17300,7.0,19249,223,44,2298,1572,22.3,1730.0,13,1,0,2,8,0,1,1,0,0,15002,7.0,17677,248,64,-2298,-1572,24.8,1500.2
4526865025,1,16,5,0,8,5,7,1,1,0,0,16770,7.4,19515,212,52,402,1641,21.2,1677.0,18,5,1,5,8,6,0,0,0,0,16368,6.8,17874,222,52,-402,-1641,22.2,1636.8
4464614548,0,12,1,0,2,7,1,1,0,1,0,15051,6.8,17519,220,57,-2815,-1204,22.0,1505.1,16,1,1,7,2,8,0,0,0,0,17866,7.2,18723,236,52,2815,1204,23.6,1786.6
4524532805,0,10,1,0,6,6,5,1,1,0,0,16490,7.0,19578,214,68,-392,462,21.4,1649.0,16,1,1,6,6,8,0,0,0,0,16882,7.2,19116,232,56,392,-462,23.2,1688.2
4522471195,0,18,8,1,4,4,4,0,0,0,0,15597,6.8,17541,232,36,717,215,23.2,1559.7,15,2,0,4,4,3,1,1,0,0,14880,6.8,17326,197,52,-717,-215,19.7,1488.0
4505097297,0,17,4,0,7,7,5,0,0,0,0,16374,6.6,17432,194,54,-255,1128,19.4,1637.4,23,1,1,7,7,7,1,1,0,0,16629,6.8,16304,194,50,255,-1128,19.4,1662.9
4520523189,1,26,5,1,5,3,5,1,1,0,0,15582,7.0,18842,234,55,-18,788,23.4,1558.2,37,2,0,3,5,7,0,0,0,0,15600,7.0,18054,202,67,18,-788,20.2,1560.0
4445137863,0,18,2,0,3,7,3,0,0,0,0,14698,6.6,16625,224,53,-1723,-2525,22.4,1469.8,16,4,1,7,3,4,1,1,0,0,16421,7.0,19150,216,64,1723,2525,21.6,1642.1
4500869291,0,20,3,0,11,8,9,2,1,1,0,17598,7.2,18935,225,52,1380,1402,22.5,1759.8,15,1,1,8,11,8,0,0,0,0,16218,6.8,17533,192,44,-1380,-1402,19.2,1621.8
4513352439,1,20,5,1,4,5,3,0,0,0,0,16083,6.8,18268,264,53,80,-609,26.4,1608.3,67,2,0,5,4,8,1,1,0,0,16003,7.2,18877,225,53,-80,609,22.5,1600.3
4381068813,0,42,1,1,7,3,8,1,1,0,0,16146,6.6,16204,196,43,2037,-281,19.6,1614.6,19,5,0,3,7,3,0,0,0,0,14109,6.4,16485,172,57,-2037,281,17.2,1410.9
4514274413,1,16,2,1,7,10,8,0,0,0,0,16855,6.8,17721,218,62,-1678,-959,21.8,1685.5,14,1,0,10,7,14,1,1,0,0,18533,7.0,18680,232,48,1678,959,23.2,1853.3
4510184598,0,26,2,0,2,5,5,0,0,0,0,12886,6.0,14091,165,32,-3117,-3799,16.5,1288.6,13,4,1,5,2,4,1,1,0,0,16003,6.8,17890,206,60,3117,3799,20.6,1600.3
4513993269,1,19,5,1,8,3,11,1,1,0,1,18524,7.0,18193,241,44,2702,1047,24.1,1852.4,18,3,0,3,8,5,0,0,0,0,15822,6.8,17146,228,54,-2702,-1047,22.8,1582.2
4515708213,1,14,3,1,5,2,3,0,0,0,0,15757,6.8,17869,229,52,603,-461,22.9,1575.7,85,1,0,2,5,0,1,1,0,0,15154,7.0,18330,246,67,-603,461,24.6,1515.4
4523408050,0,17,4,1,7,12,6,0,0,0,0,16668,6.8,17267,193,51,-2781,-1104,19.3,1666.8,45,3,0,12,7,15,1,0,1,1,19449,7.2,18371,205,36,2781,1104,20.5,1944.9
4527433973,0,15,3,0,2,7,3,0,0,0,0,15268,6.8,17717,214,72,-880,179,21.4,1526.8,18,0,1,7,2,8,0,0,0,0,16148,6.6,17538,198,42,880,-179,19.8,1614.8
4471300165,1,17,4,0,7,5,7,1,1,0,0,17097,7.0,17368,199,62,1800,546,19.9,1709.7,17,3,1,5,7,9,0,0,0,0,15297,6.6,16822,182,41,-1800,-546,18.2,1529.7
4479605659,0,12,2,1,3,2,4,0,0,0,0,16307,7.2,19846,255,64,1180,1124,25.5,1630.7,17,1,0,2,3,2,1,1,0,0,15127,7.2,18722,240,52,-1180,-1124,24.0,1512.7
4519851176,0,15,2,0,3,5,2,1,1,0,0,14444,6.4,16768,231,27,-1501,-878,23.1,1444.4,17,4,1,5,3,4,0,0,0,0,15945,7.0,17646,215,47,1501,878,21.5,1594.5
4509823937,0,18,3,0,4,10,2,0,0,0,0,16183,7.0,17767,251,44,-2155,-2249,25.1,1618.3,14,2,1,10,4,10,1,1,0,0,18338,7.2,20016,219,60,2155,2249,21.9,1833.8
4527059473,0,18,4,0,12,5,14,1,1,0,0,18508,7.4,18693,205,60,1442,322,20.5,1850.8,15,4,1,5,12,4,0,0,0,0,17066,7.0,18371,225,52,-1442,-322,22.5,1706.6
4524823620,0,51,5,1,8,5,13,0,0,0,0,17663,6.8,18440,202,60,1942,890,20.2,1766.3,39,2,0,5,8,3,1,0,1,0,15721,6.8,17550,205,58,-1942,-890,20.5,1572.1
4457630115,0,33,2,1,6,5,7,0,0,0,0,16879,7.4,19265,203,68,-29,1014,20.3,1687.9,39,2,0,5,6,7,2,1,1,0,16908,7.0,18251,249,43,29,-1014,24.9,1690.8
4522444322,1,12,2,1,6,2,8,1,0,1,0,16897,7.0,18652,234,56,1923,1300,23.4,1689.7,15,2,0,2,6,2,1,1,0,0,14974,6.8,17352,240,48,-1923,-1300,24.0,1497.4
4434622213,1,14,0,1,14,8,15,1,0,1,0,19372,7.0,18802,180,62,1342,13,18.0,1937.2,11,2,0,8,14,9,0,0,0,0,18030,7.4,18789,229,51,-1342,-13,22.9,1803.0
4489981636,1,18,3,0,5,7,6,0,0,0,0,16150,6.8,16981,207,55,-1166,-988,20.7,1615.0,17,5,1,7,5,12,1,1,0,0,17316,7.0,17969,218,60,1166,988,21.8,1731.6
4410578219,1,42,5,1,10,5,15,0,0,0,0,18062,6.8,17582,220,33,2301,667,22.0,1806.2,25,5,0,5,10,9,1,1,0,0,15761,6.6,16915,204,52,-2301,-667,20.4,1576.1
4496154110,0,19,1,1,3,5,6,0,0,0,0,15929,7.2,18460,229,64,-709,-147,22.9,1592.9,18,1,0,5,3,10,1,1,0,0,16638,7.0,18607,232,68,709,147,23.2,1663.8
4520570110,0,15,2,0,9,8,3,0,0,0,0,16882,7.4,18988,191,57,-1261,1286,19.1,1688.2,16,3,1,8,9,9,0,0,0,0,18143,6.8,17702,238,40,1261,-1286,23.8,1814.3
4475690414,0,13,4,0,7,9,4,1,0,1,0,16360,6.6,16891,187,52,-833,-773,18.7,1636.0,19,2,1,9,7,13,1,1,0,0,17193,6.8,17664,197,56,833,773,19.7,1719.3
4526544646,1,14,1,0,6,7,8,1,1,0,0,16871,6.8,17798,263,40,-89,-144,26.3,1687.1,40,3,1,7,6,13,0,0,0,0,16960,7.2,17942,232,36,89,144,23.2,1696.0
4469964060,0,16,4,0,7,12,2,0,0,0,0,15869,6.8,16808,162,48,-4369,-3324,16.2,1586.9,20,2,1,12,7,23,1,1,0,0,20238,7.6,20132,242,45,4369,3324,24.2,2023.8
4445714594,0,15,7,1,6,6,5,1,0,1,0,15965,6.8,17701,213,40,-865,-20,21.3,1596.5,62,1,0,6,6,7,1,1,0,0,16830,7.0,17721,204,59,865,20,20.4,1683.0
4468105635,1,15,2,1,11,6,9,1,1,0,0,19045,7.4,20131,227,70,3387,2782,22.7,1904.5,37,4,0,6,11,8,0,0,0,0,15658,6.8,17349,187,45,-3387,-2782,18.7,1565.8
4516904725,1,14,6,1,10,6,15,0,0,0,0,17687,7.0,18169,203,52,1484,-24,20.3,1768.7,33,3,0,6,10,8,0,0,0,0,16203,7.2,18193,216,56,-1484,24,21.6,1620.3
4518069516,1,16,2,1,7,3,4,1,1,0,0,17879,7.4,19767,241,63,4864,5310,24.1,1787.9,47,1,0,3,7,1,0,0,0,0,13015,6.0,14457,185,28,-4864,-5310,18.5,1301.5
4508590240,0,15,2,0,2,9,3,1,1,0,0,13986,6.4,16124,189,44,-3246,-1980,18.9,1398.6,43,3,1,9,2,10,0,0,0,0,17232,7.0,18104,209,52,3246,1980,20.9,1723.2
4510871194,0,38,3,0,4,9,4,0,0,0,0,15585,7.2,18357,216,55,-2017,-659,21.6,1558.5,12,3,1,9,4,12,0,0,0,0,17602,7.2,19016,220,49,2017,659,22.0,1760.2
4511716965,1,15,3,0,9,4,12,1,0,1,0,18710,7.6,20305,210,80,3467,3958,21.0,1871.0,18,1,1,4,9,3,0,0,0,0,15243,6.4,16347,193,52,-3467,-3958,19.3,1524.3
4515443406,0,18,3,0,10,7,12,0,0,0,0,18996,7.2,18231,231,47,3227,1158,23.1,1899.6,19,5,1,7,10,5,1,1,0,0,15769,6.6,17073,175,52,-3227,-1158,17.5,1576.9
4500110259,1,18,3,1,6,2,4,0,0,0,0,16849,7.4,19849,241,67,2094,2789,24.1,1684.9,14,4,0,2,6,3,0,0,0,0,14755,6.8,17060,208,56,-2094,-2789,20.8,1475.5
4513965875,0,16,11,0,3,13,6,0,0,0,0,14991,6.6,17279,207,53,-6050,-4081,20.7,1499.1,38,0,1,13,3,16,0,0,0,0,21041,7.6,21360,273,60,6050,4081,27.3,2104.1
4518806486,0,11,4,1,3,8,1,1,0,1,0,15126,7.2,18480,214,72,-3439,-1460,21.4,1512.6,14,0,0,8,3,6,1,1,0,0,18565,7.2,19940,251,56,3439,1460,25.1,1856.5
4479788915,1,16,2,1,8,4,8,2,1,1,1,19528,7.4,19755,257,56,3974,2785,25.7,1952.8,15,2,0,4,8,5,0,0,0,0,15554,6.8,16970,220,44,-3974,-2785,22.0,1555.4
4523418547,0,12,1,0,3,8,2,0,0,0,0,14585,6.6,16310,225,38,-1321,-274,22.5,1458.5,11,0,1,8,3,4,2,1,1,0,15906,6.8,16584,185,64,1321,274,18.5,1590.6
4518364742,1,17,3,1,6,0,3,1,1,0,0,17816,7.2,20228,244,61,4677,4588,24.4,1781.6,13,1,0,0,6,0,0,0,0,0,13139,6.6,15640,216,39,-4677,-4588,21.6,1313.9
4516945455,1,13,1,0,8,8,8,1,1,0,0,18011,7.0,18540,243,57,1522,277,24.3,1801.1,16,1,1,8,8,7,0,0,0,0,16489,7.2,18263,210,38,-1522,-277,21.0,1648.9
4434549109,0,41,2,1,3,3,6,1,1,0,0,14623,6.6,15613,173,47,-417,-1234,17.3,1462.3,55,5,0,3,3,4,0,0,0,0,15040,6.8,16847,207,46,417,1234,20.7,1504.0
4513724737,0,13,6,1,2,5,2,1,1,0,0,14514,7.0,17851,211,63,-1386,-450,21.1,1451.4,39,2,0,5,2,1,0,0,0,0,15900,6.8,18301,242,55,1386,450,24.2,1590.0
4518394707,0,38,1,0,6,8,7,1,1,0,0,16877,7.4,19179,225,52,-772,-545,22.5,1687.7,14,0,1,8,6,11,0,0,0,0,17649,7.4,19724,226,59,772,545,22.6,1764.9
4523482490,0,14,2,0,15,12,14,1,1,0,0,19632,7.6,20057,228,43,84,992,22.8,1963.2,15,6,1,12,15,9,0,0,0,0,19548,7.2,19065,237,40,-84,-992,23.7,1954.8
4511243744,0,18,4,0,2,11,2,0,0,0,0,13960,6.4,15286,191,48,-5431,-4681,19.1,1396.0,35,4,1,11,2,10,0,0,0,1,19391,7.4,19967,200,57,5431,4681,20.0,1939.1
4509664534,0,15,2,1,4,5,1,0,0,0,0,14473,6.8,17358,185,53,-2485,-1570,18.5,1447.3,31,2,0,5,4,2,1,1,0,0,16958,7.2,18928,263,54,2485,1570,26.3,1695.8
4511783197,0,31,5,0,5,4,5,0,0,0,0,15427,6.8,17722,215,50,-174,-503,21.5,1542.7,17,5,1,4,5,4,1,1,0,0,15601,7.0,18225,229,48,174,503,22.9,1560.1
4439137888,0,16,4,1,8,10,11,1,0,1,0,17064,6.6,16813,185,41,-574,-1413,18.5,1706.4,24,4,0,10,8,14,1,1,0,0,17638,6.8,18226,217,55,574,1413,21.7,1763.8
4459961160,0,22,5,0,6,11,8,0,0,0,0,17171,6.8,18333,254,32,-1882,-1917,25.4,1717.1,25,9,1,11,6,6,2,1,1,0,19053,7.6,20250,218,60,1882,1917,21.8,1905.3
4496739291,1,16,3,1,10,5,7,1,1,0,0,18240,7.0,19116,259,31,2953,1980,25.9,1824.0,17,2,0,5,10,4,0,0,0,0,15287,6.8,17136,197,64,-2953,-1980,19.7,1528.7
4492722693,1,13,1,1,8,5,8,0,0,0,0,17953,6.8,18196,218,59,3363,2997,21.8,1795.3,13,2,0,5,8,9,1,1,0,0,14590,6.4,15199,176,43,-3363,-2997,17.6,1459.0
4419637679,0,16,1,1,7,5,7,1,1,0,1,17787,7.2,18660,232,46,2360,1439,23.2,1778.7,15,2,0,5,7,6,0,0,0,0,15427,6.6,17221,161,60,-2360,-1439,16.1,1542.7
4479329999,1,16,4,1,5,6,3,0,0,0,0,17083,7.2,18817,248,60,1031,98,24.8,1708.3,17,3,0,6,5,6,2,1,1,0,16052,7.2,18719,220,60,-1031,-98,22.0,1605.2
4481573191,0,16,3,1,12,11,12,0,0,0,0,19460,7.4,19643,223,43,778,1443,22.3,1946.0,11,3,0,11,12,14,0,0,0,0,18682,7.0,18200,234,32,-778,-1443,23.4,1868.2
4450445125,0,13,3,0,0,5,0,1,0,1,0,14103,6.6,17162,230,66,-1977,-700,23.0,1410.3,13,3,1,5,0,4,0,0,0,0,16080,7.0,17862,224,54,1977,700,22.4,1608.0
4468650585,0,209,1,1,5,9,4,1,1,0,0,15703,7.0,17235,210,44,-1678,-2431,21.0,1570.3,14,1,0,9,5,5,0,0,0,0,17381,7.4,19666,202,52,1678,2431,20.2,1738.1
4510212768,1,16,1,1,10,6,11,0,0,0,0,18081,7.0,18813,207,63,2273,1714,20.7,1808.1,14,0,0,6,10,10,0,0,0,0,15808,6.8,17099,220,41,-2273,-1714,22.0,1580.8
4515418492,0,18,1,1,3,7,3,0,0,0,0,14951,6.8,17632,206,48,-2002,-565,20.6,1495.1,15,2,0,7,3,6,1,1,0,0,16953,7.0,18197,214,59,2002,565,21.4,1695.3
4524217548,0,17,1,0,5,10,6,0,0,0,0,16249,7.0,18383,213,59,-1796,-749,21.3,1624.9,16,2,1,10,5,15,1,1,0,0,18045,7.0,19132,214,44,1796,749,21.4,1804.5
4527782537,0,51,3,1,3,6,7,1,1,0,0,14857,6.8,16510,226,43,-959,-1248,22.6,1485.7,29,3,0,6,3,3,1,0,1,0,15816,6.8,17758,195,58,959,1248,19.5,1581.6
4523809434,0,76,6,0,5,5,4,1,1,0,0,16203,7.0,18321,228,51,2,-365,22.8,1620.3,19,5,1,5,5,6,0,0,0,0,16201,7.0,18686,228,53,-2,365,22.8,1620.1
4510843873,1,16,1,0,5,9,5,2,1,1,1,18041,7.0,18637,221,60,786,1049,22.1,1804.1,15,3,1,9,5,14,0,0,0,0,17255,6.8,17588,213,33,-786,-1049,21.3,1725.5
4522794397,0,10,1,0,5,12,6,0,0,0,0,15299,7.0,17019,169,58,-3111,-2286,16.9,1529.9,15,2,1,12,5,10,0,0,0,0,18410,7.0,19305,178,56,3111,2286,17.8,1841.0
4521266172,0,15,2,1,5,2,8,1,1,0,0,16348,7.0,18350,243,47,1476,1149,24.3,1634.8,19,2,0,2,5,4,0,0,0,0,14872,6.8,17201,233,51,-1476,-1149,23.3,1487.2
4522846190,0,16,4,0,3,5,3,0,0,0,0,15404,7.0,17893,244,52,-1793,-1226,24.4,1540.4,17,2,1,5,3,7,1,1,0,0,17197,7.0,19119,254,68,1793,1226,25.4,1719.7
4525625460,0,145,2,0,3,7,4,1,1,0,0,15418,7.0,17598,232,56,-1540,-313,23.2,1541.8,17,3,1,7,3,10,0,0,0,0,16958,6.8,17911,214,48,1540,313,21.4,1695.8
4458431377,1,15,2,1,11,3,4,0,0,0,0,18192,7.2,19823,221,50,2639,1711,22.1,1819.2,13,1,0,3,11,2,0,0,0,0,15553,7.0,18112,230,49,-2639,-1711,23.0,1555.3
4524447556,0,14,5,0,4,5,4,1,1,0,0,15129,7.0,17887,197,61,-1330,-639,19.7,1512.9,14,4,1,5,4,4,0,0,0,0,16459,7.0,18526,241,56,1330,639,24.1,1645.9
4520401990,0,16,2,1,9,9,9,0,0,0,0,17197,7.2,18127,205,40,-1383,-970,20.5,1719.7,14,2,0,9,9,12,0,0,0,0,18580,7.0,19097,232,51,1383,970,23.2,1858.0
4523561313,0,16,4,1,8,2,7,1,0,1,0,17281,7.4,20413,219,63,2485,2934,21.9,1728.1,18,0,0,2,8,4,1,1,0,0,14796,6.8,17479,207,60,-2485,-2934,20.7,1479.6
4517065551,0,18,2,1,8,4,18,0,0,0,0,17691,7.0,18548,222,60,3544,2399,22.2,1769.1,14,3,0,4,8,4,0,0,0,0,14147,6.4,16149,184,44,-3544,-2399,18.4,1414.7
4470179488,1,16,4,0,4,6,5,0,0,0,0,15403,6.8,17661,216,43,-1636,-2200,21.6,1540.3,15,3,1,6,4,5,1,1,0,0,17039,7.2,19861,245,60,1636,2200,24.5,1703.9
4505154902,1,44,1,1,10,2,13,1,1,0,0,17519,6.8,17753,209,37,4216,2141,20.9,1751.9,11,2,0,2,10,1,0,0,0,0,13303,6.4,15612,197,38,-4216,-2141,19.7,1330.3
4475519320,0,18,8,1,1,6,0,0,0,0,0,13446,6.4,15362,204,45,-4840,-4530,20.4,1344.6,16,8,0,6,1,6,2,1,1,1,18286,7.2,19892,258,66,4840,4530,25.8,1828.6
4517895727,0,15,0,1,2,12,2,0,0,0,0,13751,6.2,15189,183,40,-5551,-2712,18.3,1375.1,15,2,0,12,2,15,1,1,0,1,19302,6.8,17901,201,40,5551,2712,20.1,1930.2
4523485594,1,26,2,1,10,5,6,0,0,0,0,17915,7.4,19494,222,62,2833,3175,22.2,1791.5,14,4,0,5,10,6,0,0,0,0,15082,6.6,16319,206,25,-2833,-3175,20.6,1508.2
4523858150,0,28,3,0,4,11,3,0,0,0,0,15483,6.8,17362,222,48,-3025,-1833,22.2,1548.3,41,0,1,11,4,16,1,1,0,0,18508,7.2,19195,213,39,3025,1833,21.3,1850.8
4524555645,1,14,1,0,10,8,10,1,0,1,0,17793,7.0,18327,193,55,496,187,19.3,1779.3,14,0,1,8,10,7,1,1,0,0,17297,6.8,18140,220,44,-496,-187,22.0,1729.7
4498445484,0,17,3,0,6,7,2,1,1,0,1,17046,7.2,18406,197,76,-190,-576,19.7,1704.6,15,5,1,7,6,5,1,0,1,0,17236,7.2,18982,229,53,190,576,22.9,1723.6
4521175049,0,15,3,0,3,5,3,1,1,0,0,15809,6.8,17675,214,63,-1462,-1833,21.4,1580.9,17,2,1,5,3,8,1,0,1,0,17271,7.4,19508,232,56,1462,1833,23.2,1727.1
4527437019,1,36,2,0,5,7,5,0,0,0,0,15689,6.6,16026,187,48,-1544,-792,18.7,1568.9,38,4,1,7,5,6,1,1,0,1,17233,6.6,16818,180,53,1544,792,18.0,1723.3
4489200768,0,20,4,1,7,5,7,0,0,0,0,17622,7.2,18672,247,50,2077,986,24.7,1762.2,16,5,0,5,7,5,1,1,0,0,15545,6.8,17686,226,47,-2077,-986,22.6,1554.5
4508898898,0,14,2,0,6,11,5,0,0,0,0,16167,7.0,18659,202,60,-2055,-214,20.2,1616.7,18,5,1,11,6,11,2,1,1,0,18222,7.2,18873,204,56,2055,214,20.4,1822.2
4489481429,1,15,1,1,8,9,9,0,0,0,0,17119,7.0,18174,209,36,-1362,-863,20.9,1711.9,13,3,0,9,8,9,0,0,0,0,18481,7.4,19037,235,55,1362,863,23.5,1848.1
4524537915,0,15,2,0,10,5,8,1,1,0,0,18497,7.2,19069,223,54,3609,3620,22.3,1849.7,13,2,1,5,10,5,0,0,0,0,14888,6.4,15449,174,52,-3609,-3620,17.4,1488.8
4518531939,0,16,5,1,2,6,3,0,0,0,0,14874,6.8,16729,232,60,-3131,-1768,23.2,1487.4,17,4,0,6,2,5,2,1,1,1,18005,7.2,18497,221,47,3131,1768,22.1,1800.5
4444833318,1,16,4,0,8,4,10,0,0,0,0,18363,7.6,20591,250,56,2012,2314,25.0,1836.3,16,0,1,4,8,4,2,1,1,0,16351,7.0,18277,221,60,-2012,-2314,22.1,1635.1
4468528737,1,20,7,1,7,5,9,1,1,0,0,16100,6.6,16520,189,48,-488,-1312,18.9,1610.0,19,4,0,5,7,7,0,0,0,0,16588,7.0,17832,240,40,488,1312,24.0,1658.8
4471276142,1,11,3,1,9,7,14,1,1,0,0,17631,7.0,17645,199,38,1328,1043,19.9,1763.1,16,0,0,7,9,7,0,0,0,0,16303,6.6,16602,188,56,-1328,-1043,18.8,1630.3
4448427323,0,14,1,1,15,3,5,0,0,0,0,19038,7.2,19801,261,32,4941,4702,26.1,1903.8,17,2,0,3,15,5,0,0,0,0,14097,6.2,15099,190,48,-4941,-4702,19.0,1409.7
4516664706,0,18,2,0,4,7,2,1,1,0,0,15190,7.0,18507,215,61,-2134,-339,21.5,1519.0,14,4,1,7,4,8,1,0,1,0,17324,7.0,18846,227,48,2134,339,22.7,1732.4
4517966226,1,20,5,1,5,5,6,2,1,1,0,16746,7.2,18699,247,56,1066,-560,24.7,1674.6,42,3,0,5,5,4,0,0,0,0,15680,7.4,19259,239,47,-1066,560,23.9,1568.0
4527545392,1,23,7,0,6,8,7,0,0,0,0,16449,6.6,16962,232,48,-167,-395,23.2,1644.9,21,5,1,8,6,9,0,0,0,0,16616,7.0,17357,196,46,167,395,19.6,1661.6
4518654959,1,15,2,0,4,4,4,1,0,1,0,16631,7.2,19310,252,57,1507,1667,25.2,1663.1,29,2,1,4,4,1,0,0,0,0,15124,7.0,17643,214,56,-1507,-1667,21.4,1512.4
4523968738,1,15,5,1,9,9,7,0,0,0,0,17225,7.0,17613,217,38,69,-232,21.7,1722.5,13,4,0,9,9,12,0,0,0,0,17156,7.0,17845,210,32,-69,232,21.0,1715.6
4526103377,1,86,2,0,5,6,7,0,0,0,0,16123,6.8,17612,203,60,569,304,20.3,1612.3,15,2,1,6,5,4,1,1,0,0,15554,6.8,17308,181,60,-569,-304,18.1,1555.4
4523349823,1,9,5,0,6,6,6,1,0,1,0,16421,7.4,19037,224,50,961,849,22.4,1642.1,18,0,1,6,6,4,0,0,0,0,15460,7.0,18188,194,48,-961,-849,19.4,1546.0
4511287504,0,17,3,0,4,4,5,0,0,0,0,15374,7.0,17614,221,48,405,11,22.1,1537.4,14,2,1,4,4,3,0,0,0,0,14969,6.8,17603,205,56,-405,-11,20.5,1496.9
4523081068,1,16,4,0,7,8,5,0,0,0,0,15646,7.0,17325,192,35,-1528,-1421,19.2,1564.6,26,4,1,8,7,8,1,1,0,0,17174,7.2,18746,225,42,1528,1421,22.5,1717.4
4511553683,0,15,3,0,7,5,7,1,1,0,0,16424,7.0,17990,205,60,427,479,20.5,1642.4,17,5,1,5,7,4,0,0,0,0,15997,7.0,17511,237,44,-427,-479,23.7,1599.7
4523081762,0,17,3,0,6,8,4,0,0,0,0,16142,7.0,18299,191,66,-1769,-1209,19.1,1614.2,15,2,1,8,6,6,1,1,0,0,17911,7.4,19508,264,56,1769,1209,26.4,1791.1
4454098285,0,14,0,0,2,4,5,0,0,0,0,14680,7.0,17305,222,52,-1413,-729,22.2,1468.0,10,0,1,4,2,7,1,0,1,0,16093,7.2,18034,234,60,1413,729,23.4,1609.3
4519807655,1,16,2,1,3,2,3,1,1,0,0,15574,6.8,17686,217,68,-100,219,21.7,1557.4,17,3,0,2,3,2,0,0,0,0,15674,6.6,17467,240,48,100,-219,24.0,1567.4
4499336831,1,14,0,1,10,9,8,0,0,0,0,17817,6.8,17747,188,40,780,74,18.8,1781.7,12,3,0,9,10,7,0,0,0,0,17037,7.0,17673,212,44,-780,-74,21.2,1703.7
4521600378,1,33,3,1,3,0,5,0,0,0,0,16419,7.0,19867,276,61,1783,1420,27.6,1641.9,15,2,0,0,3,0,1,1,0,0,14636,6.8,18447,257,68,-1783,-1420,25.7,1463.6
4520552077,1,17,2,0,6,6,9,0,0,0,0,17528,6.8,18106,216,55,1376,1018,21.6,1752.8,16,3,1,6,6,5,1,1,0,0,16152,6.8,17088,217,38,-1376,-1018,21.7,1615.2
4478440823,1,21,2,1,8,4,12,0,0,0,0,17307,7.0,18013,249,34,2516,1053,24.9,1730.7,47,4,0,4,8,3,1,1,0,0,14791,6.6,16960,203,54,-2516,-1053,20.3,1479.1
4451884884,0,16,5,1,9,10,12,0,0,0,0,16990,6.8,17317,198,29,-1534,-1073,19.8,1699.0,15,5,0,10,9,11,0,0,0,0,18524,6.8,18390,218,44,1534,1073,21.8,1852.4
4517519722,1,59,2,0,6,5,6,0,0,0,0,16896,7.2,18779,258,46,459,1326,25.8,1689.6,18,4,1,5,6,5,1,1,0,0,16437,7.0,17453,244,44,-459,-1326,24.4,1643.7
4514536242,0,46,2,0,4,5,5,0,0,0,0,14511,6.2,17013,193,52,-2246,-961,19.3,1451.1,20,4,1,5,4,7,1,1,0,0,16757,7.0,17974,233,44,2246,961,23.3,1675.7
4509982374,0,19,4,0,6,5,7,0,0,0,0,16543,7.0,18558,245,48,192,-656,24.5,1654.3,18,4,1,5,6,7,1,1,0,0,16351,7.2,19214,245,56,-192,656,24.5,1635.1
4525153486,0,14,1,0,8,10,13,1,1,0,0,17174,6.8,17921,244,56,-516,-4,24.4,1717.4,12,2,1,10,8,13,0,0,0,0,17690,6.8,17925,183,40,516,4,18.3,1769.0
4473216293,0,102,0,0,2,10,1,0,0,0,0,13456,6.6,16144,164,50,-5199,-3608,16.4,1345.6,16,2,1,10,2,8,1,1,0,0,18655,7.4,19752,245,47,5199,3608,24.5,1865.5
4519515708,1,19,1,1,11,1,18,1,1,0,0,18190,7.6,20017,225,65,4069,3954,22.5,1819.0,16,5,0,1,11,1,0,0,0,0,14121,6.6,16063,224,51,-4069,-3954,22.4,1412.1
4522387396,1,16,3,1,11,11,7,1,0,1,0,18164,7.0,18492,198,52,-640,403,19.8,1816.4,12,1,0,11,11,14,1,1,0,0,18804,7.0,18089,204,50,640,-403,20.4,1880.4
4508388395,1,16,2,1,15,2,17,1,1,0,1,21883,7.8,20941,252,55,7980,4916,25.2,2188.3,12,1,0,2,15,0,0,0,0,0,13903,6.4,16025,193,44,-7980,-4916,19.3,1390.3
4518971206,0,20,3,0,7,4,8,0,0,0,0,16472,7.2,18966,219,53,1367,2396,21.9,1647.2,15,4,1,4,7,4,1,0,1,0,15105,6.6,16570,180,45,-1367,-2396,18.0,1510.5
4509868261,1,12,3,0,9,3,10,0,0,0,0,17460,7.0,17575,217,40,2338,1009,21.7,1746.0,14,1,1,3,9,3,1,0,1,0,15122,6.6,16566,192,52,-2338,-1009,19.2,1512.2
4520868488,1,15,3,1,9,3,11,0,0,0,0,17592,7.0,18664,220,41,1411,766,22.0,1759.2,11,1,0,3,9,4,1,1,0,0,16181,7.0,17898,215,62,-1411,-766,21.5,1618.1
4515302737,0,16,2,0,4,13,4,0,0,0,0,14958,6.8,16993,207,47,-4629,-3393,20.7,1495.8,55,4,1,13,4,16,1,1,0,0,19587,7.4,20386,239,46,4629,3393,23.9,1958.7
4516132532,1,14,1,1,5,2,3,0,0,0,0,16568,7.0,18389,222,52,2150,475,22.2,1656.8,11,2,0,2,5,4,1,1,0,0,14418,7.0,17914,228,48,-2150,-475,22.8,1441.8
4527157118,1,14,2,0,12,5,10,1,1,0,0,19296,7.4,18995,222,56,3611,2136,22.2,1929.6,15,1,1,5,12,7,0,0,0,0,15685,6.8,16859,180,46,-3611,-2136,18.0,1568.5
4488307772,1,15,1,0,1,4,1,2,1,1,0,14140,6.6,17249,241,48,-1481,-1506,24.1,1414.0,57,1,1,4,1,5,0,0,0,0,15621,7.0,18755,228,52,1481,1506,22.8,1562.1
4465078328,0,27,2,0,5,4,6,0,0,0,0,15732,6.6,16582,218,44,17,-1014,21.8,1573.2,15,3,1,4,5,4,0,0,0,0,15715,7.0,17596,248,44,-17,1014,24.8,1571.5
4526146492,0,17,1,1,7,11,7,0,0,0,0,17375,6.8,18610,222,48,-2049,-1230,22.2,1737.5,16,1,0,11,7,10,2,1,1,0,19424,7.4,19840,236,58,2049,1230,23.6,1942.4
4526920856,0,25,1,0,4,5,3,1,1,0,0,15791,7.0,18218,220,56,-478,346,22.0,1579.1,17,2,1,5,4,4,0,0,0,0,16269,7.0,17872,247,42,478,-346,24.7,1626.9
4527328545,1,14,4,1,10,3,9,0,0,0,0,18389,7.0,18618,227,64,5191,4111,22.7,1838.9,14,2,0,3,10,3,0,0,0,0,13198,6.2,14507,162,40,-5191,-4111,16.2,1319.8
4488970376,1,14,5,0,6,6,7,0,0,0,0,17159,7.2,19172,223,56,-71,994,22.3,1715.9,33,1,1,6,6,8,1,1,0,0,17230,6.8,18178,229,43,71,-994,22.9,1723.0
4498664895,0,11,1,0,5,9,5,1,1,0,0,16408,6.8,17435,199,69,-2517,-1199,19.9,1640.8,35,0,1,9,5,12,0,0,0,0,18925,7.2,18634,248,44,2517,1199,24.8,1892.5
4458063255,1,66,4,1,5,6,10,1,1,0,0,15649,6.6,17165,240,40,-1209,-1184,24.0,1564.9,19,5,0,6,5,9,0,0,0,0,16858,7.0,18349,238,52,1209,1184,23.8,1685.8
4521217676,1,16,3,0,13,9,12,0,0,0,0,18734,7.2,19093,187,55,2355,884,18.7,1873.4,14,1,1,9,13,8,1,1,0,0,16379,6.8,18209,200,56,-2355,-884,20.0,1637.9
4495400346,0,34,2,1,9,11,10,0,0,0,0,17645,7.0,18506,201,44,-177,-308,20.1,1764.5,16,0,0,11,9,11,1,1,0,0,17822,7.4,18814,206,51,177,308,20.6,1782.2
4452913051,1,19,1,1,6,3,6,2,1,1,0,17201,6.8,17943,186,67,2184,419,18.6,1720.1,48,3,0,3,6,4,0,0,0,0,15017,6.8,17524,211,52,-2184,-419,21.1,1501.7
4522838213,1,13,2,1,7,0,5,2,1,1,0,17520,7.2,19639,245,63,4228,2880,24.5,1752.0,15,1,0,0,7,0,0,0,0,0,13292,6.6,16759,194,60,-4228,-2880,19.4,1329.2
4446773786,0,16,3,0,3,16,5,0,0,0,0,14081,6.4,15129,207,30,-6402,-4189,20.7,1408.1,17,8,1,16,3,22,1,1,0,0,20483,7.2,19318,233,47,6402,4189,23.3,2048.3
4483500225,0,15,4,0,4,4,2,0,0,0,0,15023,6.8,17293,226,44,-814,-374,22.6,1502.3,17,2,1,4,4,4,1,0,1,0,15837,6.8,17667,232,47,814,374,23.2,1583.7
4498439649,0,17,6,1,6,6,6,2,1,1,0,16254,7.0,17969,203,48,-740,-665,20.3,1625.4,16,4,0,6,6,9,0,0,0,0,16994,7.0,18634,238,60,740,665,23.8,1699.4
4502442635,0,16,3,1,6,5,8,0,0,0,0,15890,6.4,15995,178,36,237,-1307,17.8,1589.0,38,3,0,5,6,5,1,1,0,0,15653,7.0,17302,202,44,-237,1307,20.2,1565.3
4522338747,1,29,1,1,11,5,12,1,1,0,0,18093,6.8,17986,211,48,2025,-460,21.1,1809.3,12,3,0,5,11,3,0,0,0,0,16068,6.8,18446,199,52,-2025,460,19.9,1606.8
4523365971,1,10,1,1,16,5,7,1,0,1,0,20310,7.4,20225,230,60,5565,5067,23.0,2031.0,81,1,0,5,16,3,1,1,0,0,14745,6.2,15158,169,46,-5565,-5067,16.9,1474.5
4503476670,1,19,3,1,4,4,3,0,0,0,0,16621,6.8,18305,255,50,875,-391,25.5,1662.1,15,4,0,4,4,7,0,0,0,0,15746,7.0,18696,238,65,-875,391,23.8,1574.6
4522260081,0,14,1,0,9,8,7,1,1,0,0,17183,7.0,18225,196,60,-1295,-305,19.6,1718.3,18,1,1,8,9,10,0,0,0,0,18478,7.0,18530,247,56,1295,305,24.7,1847.8
4449694269,0,20,7,0,7,8,6,1,1,0,0,16685,6.8,17591,193,40,-335,-681,19.3,1668.5,29,4,1,8,7,7,1,0,1,0,17020,6.8,18272,228,47,335,681,22.8,1702.0
4460468802,1,21,2,0,3,3,3,1,1,0,0,15398,6.8,17885,227,64,324,231,22.7,1539.8,13,3,1,3,3,1,1,0,1,0,15074,6.8,17654,239,47,-324,-231,23.9,1507.4
4521100238,0,54,2,1,7,3,7,0,0,0,0,17576,7.2,18867,227,44,2237,1848,22.7,1757.6,14,1,0,3,7,4,0,0,0,0,15339,6.8,17019,209,60,-2237,-1848,20.9,1533.9
4500634961,1,35,3,1,14,3,20,1,1,0,0,20028,7.4,20153,229,51,5885,4694,22.9,2002.8,22,1,0,3,14,3,0,0,0,0,14143,6.2,15459,160,60,-5885,-4694,16.0,1414.3
4519816980,1,21,3,0,4,2,4,0,0,0,0,16523,7.2,18881,222,60,2592,1348,22.2,1652.3,16,5,1,2,4,2,1,1,0,0,13931,6.6,17533,202,52,-2592,-1348,20.2,1393.1
4516930956,0,12,2,0,6,15,6,0,0,0,0,15392,6.4,16156,175,45,-4885,-3111,17.5,1539.2,16,3,1,15,6,17,1,0,1,0,20277,7.4,19267,233,46,4885,3111,23.3,2027.7
4523504461,1,14,2,1,13,7,12,1,1,0,0,19360,7.2,19057,238,52,3034,1636,23.8,1936.0,12,4,0,7,13,7,0,0,0,0,16326,6.6,17421,183,56,-3034,-1636,18.3,1632.6
4469530341,0,13,3,0,6,6,3,0,0,0,0,15933,7.2,18813,221,52,-866,259,22.1,1593.3,18,2,1,6,6,3,1,1,0,0,16799,7.2,18554,249,52,866,-259,24.9,1679.9
4426908175,0,13,1,0,6,2,4,0,0,0,0,15828,6.8,17834,218,48,1176,763,21.8,1582.8,16,1,1,2,6,2,1,1,0,0,14652,6.8,17071,218,49,-1176,-763,21.8,1465.2
4497981317,0,15,0,1,8,9,5,0,0,0,0,16319,6.8,17715,217,32,-1228,11,21.7,1631.9,11,1,0,9,8,9,0,0,0,0,17547,6.8,17704,191,47,1228,-11,19.1,1754.7
4475122609,0,14,4,1,5,7,3,0,0,0,0,16946,7.2,18333,230,56,368,-774,23.0,1694.6,27,4,0,7,5,6,2,1,1,0,16578,7.2,19107,220,64,-368,774,22.0,1657.8
4519670667,1,58,1,1,6,3,6,1,1,0,0,17604,7.4,20758,248,67,2547,2796,24.8,1760.4,36,0,0,3,6,2,0,0,0,0,15057,6.6,17962,195,60,-2547,-2796,19.5,1505.7
4524750008,0,15,4,1,6,5,7,1,1,0,0,15138,6.6,16193,191,43,-452,-1060,19.1,1513.8,16,5,0,5,6,5,0,0,0,0,15590,7.0,17253,206,56,452,1060,20.6,1559.0
4518184888,1,77,2,0,4,6,6,2,1,1,0,15564,7.0,18158,214,46,-1075,378,21.4,1556.4,17,1,1,6,4,11,0,0,0,0,16639,7.0,17780,240,44,1075,-378,24.0,1663.9
4523456164,1,39,2,1,9,6,16,0,0,0,0,17335,6.8,17918,193,50,2094,2937,19.3,1733.5,15,1,0,6,9,14,0,0,0,0,15241,6.2,14981,170,33,-2094,-2937,17.0,1524.1
4456973095,0,16,0,0,0,4,0,1,0,1,0,14175,6.6,17400,234,60,-1769,-2076,23.4,1417.5,15,4,1,4,0,6,1,1,0,0,15944,7.4,19476,249,56,1769,2076,24.9,1594.4
4423079773,1,16,4,1,6,4,8,2,1,1,0,16832,7.2,18675,221,65,1624,1008,22.1,1683.2,17,1,0,4,6,5,0,0,0,0,15208,7.0,17667,238,33,-1624,-1008,23.8,1520.8
4526022064,0,17,3,0,6,2,10,1,1,0,0,17066,7.0,18756,230,61,1998,1200,23.0,1706.6,13,3,1,2,6,2,0,0,0,0,15068,6.8,17556,253,48,-1998,-1200,25.3,1506.8
4462493939,0,16,2,0,8,9,8,0,0,0,0,16984,7.0,18400,206,44,-1720,-1376,20.6,1698.4,216,3,1,9,8,6,1,1,0,0,18704,7.2,19776,226,52,1720,1376,22.6,1870.4
4500958321,1,16,4,1,5,5,10,0,0,0,0,16932,6.8,17955,239,56,1059,919,23.9,1693.2,20,1,0,5,5,4,1,0,1,0,15873,6.8,17036,192,56,-1059,-919,19.2,1587.3
4516450809,0,12,2,1,10,8,18,0,0,0,0,18121,7.4,19091,230,49,833,-523,23.0,1812.1,26,0,0,8,10,7,2,1,1,0,17288,7.2,19614,217,56,-833,523,21.7,1728.8
4511067003,1,12,4,0,4,10,2,0,0,0,0,16956,7.2,19562,252,81,-387,1466,25.2,1695.6,16,2,1,10,4,11,1,1,0,0,17343,7.0,18096,236,44,387,-1466,23.6,1734.3
4474730654,1,18,2,1,11,9,9,1,1,0,0,18313,7.0,17999,214,40,1099,-673,21.4,1831.3,14,3,0,9,11,6,0,0,0,0,17214,6.8,18672,178,60,-1099,673,17.8,1721.4
4523657411,1,18,1,0,6,4,4,0,0,0,0,16948,7.0,18271,252,60,2346,1424,25.2,1694.8,14,4,1,4,6,1,1,1,0,0,14602,6.4,16847,211,51,-2346,-1424,21.1,1460.2
4520973698,1,15,2,0,12,7,17,0,0,0,0,18074,6.8,16950,211,35,2170,1207,21.1,1807.4,50,0,1,7,12,11,1,1,0,0,15904,6.4,15743,188,34,-2170,-1207,18.8,1590.4
4475203157,0,15,6,1,6,2,11,0,0,0,0,17955,7.2,18774,270,43,3187,880,27.0,1795.5,17,1,0,2,6,1,1,1,0,0,14768,6.8,17894,230,64,-3187,-880,23.0,1476.8
4521157030,1,18,1,0,6,7,4,0,0,0,0,15369,6.8,17402,200,40,-1833,-917,20.0,1536.9,14,1,1,7,6,4,1,1,0,0,17202,7.0,18319,245,49,1833,917,24.5,1720.2
4510816810,1,16,4,1,10,2,7,1,1,0,0,18725,7.2,19463,248,69,4073,1397,24.8,1872.5,18,3,0,2,10,1,0,0,0,0,14652,6.8,18066,225,63,-4073,-1397,22.5,1465.2
4526758448,0,124,0,0,1,3,1,1,1,0,0,14997,7.2,17630,229,62,-465,-801,22.9,1499.7,14,2,1,3,1,3,0,0,0,0,15462,7.0,18431,219,58,465,801,21.9,1546.2
4522021441,0,12,2,0,1,10,0,0,0,0,0,13410,6.4,16059,210,52,-5025,-2610,21.0,1341.0,19,4,1,10,1,16,1,1,0,0,18435,7.2,18669,228,58,5025,2610,22.8,1843.5
4508360116,1,37,3,1,6,5,7,1,1,0,0,16149,7.0,18253,217,44,-549,-323,21.7,1614.9,15,3,0,5,6,5,0,0,0,0,16698,6.8,18576,233,59,549,323,23.3,1669.8
4513579989,0,30,4,1,7,10,3,0,0,0,0,16399,7.0,18258,214,44,-1977,-944,21.4,1639.9,13,4,0,10,7,9,0,0,0,0,18376,7.2,19202,231,55,1977,944,23.1,1837.6
4521152732,0,14,0,0,5,9,3,0,0,0,0,14964,6.6,17465,196,48,-3225,-1705,19.6,1496.4,15,0,1,9,5,6,2,1,1,0,18189,7.4,19170,249,67,3225,1705,24.9,1818.9
4522849346,0,86,3,1,6,3,6,1,0,1,0,17395,7.2,18998,252,56,2234,1606,25.2,1739.5,22,2,0,3,6,5,1,1,0,0,15161,7.0,17392,226,56,-2234,-1606,22.6,1516.1
4518442366,1,13,5,0,6,4,3,1,1,0,0,16409,6.8,18420,232,43,596,486,23.2,1640.9,13,1,1,4,6,4,0,0,0,0,15813,7.0,17934,202,68,-596,-486,20.2,1581.3
4495592386,0,14,1,0,3,7,1,1,1,0,0,14604,6.6,17494,198,58,-3333,-379,19.8,1460.4,15,3,1,7,3,10,1,0,1,0,17937,6.8,17873,245,40,3333,379,24.5,1793.7
4517740459,1,14,2,1,12,5,13,1,0,1,0,19266,7.4,19920,236,44,3362,2634,23.6,1926.6,17,3,0,5,12,6,0,0,0,0,15904,6.8,17286,204,44,-3362,-2634,20.4,1590.4
4520900550,1,43,1,0,8,4,3,0,0,0,0,17743,7.6,20843,247,56,2507,3436,24.7,1774.3,11,3,1,4,8,5,0,0,0,0,15236,6.8,17407,186,67,-2507,-3436,18.6,1523.6
4475523215,0,13,0,0,6,12,6,0,0,0,0,15951,6.6,16512,223,40,-1734,-3696,22.3,1595.1,16,3,1,12,6,5,2,1,1,0,17685,7.6,20208,221,44,1734,3696,22.1,1768.5
4467871886,1,86,4,0,4,5,3,1,1,0,0,14803,6.8,17318,213,49,-1380,326,21.3,1480.3,19,3,1,5,4,10,0,0,0,0,16183,7.0,16992,238,33,1380,-326,23.8,1618.3
4486524151,0,21,1,1,5,7,4,0,0,0,0,16218,6.8,16863,204,52,-193,-634,20.4,1621.8,18,2,0,7,5,10,2,1,1,0,16411,6.8,17497,202,48,193,634,20.2,1641.1
4449195620,0,15,1,1,4,8,0,0,0,0,0,15704,6.6,16968,210,52,-322,-716,21.0,1570.4,13,1,0,8,4,14,0,0,0,0,16026,7.0,17684,179,32,322,716,17.9,1602.6
4477340237,1,19,4,1,8,6,8,1,1,0,0,16984,6.8,17114,205,48,469,-755,20.5,1698.4,41,4,0,6,8,5,1,0,1,0,16515,7.0,17869,233,47,-469,755,23.3,1651.5
4487026164,1,12,4,0,3,5,2,0,0,0,0,14584,6.8,17432,201,45,-813,840,20.1,1458.4,22,1,1,5,3,5,1,1,0,0,15397,6.6,16592,195,52,813,-840,19.5,1539.7
4453150703,1,16,2,1,3,6,3,0,0,0,0,14538,6.2,15395,177,50,-1266,-1255,17.7,1453.8,13,2,0,6,3,6,1,1,0,0,15804,6.4,16650,200,52,1266,1255,20.0,1580.4
4492190443,1,16,2,1,6,4,11,0,0,0,0,16731,7.0,17558,239,49,2073,2090,23.9,1673.1,15,4,0,4,6,4,0,0,0,0,14658,6.4,15468,203,38,-2073,-2090,20.3,1465.8
4454611264,1,14,0,1,7,10,8,1,1,0,0,18089,7.4,18770,225,77,1158,191,22.5,1808.9,14,1,0,10,7,8,1,0,1,0,16931,7.2,18579,202,38,-1158,-191,20.2,1693.1
4296354535,0,16,5,1,12,3,14,1,1,0,0,19031,7.4,18999,234,40,4188,2399,23.4,1903.1,19,1,0,3,12,2,1,0,1,0,14843,6.6,16600,207,52,-4188,-2399,20.7,1484.3
4491334204,1,19,7,1,13,5,14,0,0,0,0,19610,7.6,20901,220,51,4491,5575,22.0,1961.0,17,1,0,5,13,4,1,1,0,0,15119,6.2,15326,186,51,-4491,-5575,18.6,1511.9
4489878526,1,14,2,1,6,4,6,0,0,0,0,16493,7.2,18450,231,46,628,-243,23.1,1649.3,17,3,0,4,6,6,1,1,0,0,15865,7.0,18693,212,67,-628,243,21.2,1586.5
4523814750,1,17,4,1,7,3,4,1,0,1,0,17666,7.0,18167,240,41,3198,1428,24.0,1766.6,17,3,0,3,7,7,1,1,0,0,14468,6.6,16739,201,40,-3198,-1428,20.1,1446.8
4521968003,0,14,1,1,5,4,5,0,0,0,0,16062,6.8,17907,195,61,39,-1075,19.5,1606.2,48,3,0,4,5,3,1,1,0,0,16023,7.2,18982,237,61,-39,1075,23.7,1602.3
4511513768,1,11,0,1,14,5,9,1,1,0,0,19433,7.0,18610,213,46,4483,3132,21.3,1943.3,13,1,0,5,14,5,0,0,0,0,14950,6.4,15478,176,49,-4483,-3132,17.6,1495.0
4472113530,1,13,0,1,8,5,5,0,0,0,0,16979,7.2,18700,213,48,1486,991,21.3,1697.9,14,0,0,5,8,3,0,0,0,0,15493,7.0,17709,200,46,-1486,-991,20.0,1549.3
4521835060,1,42,3,0,8,13,8,0,0,0,0,17639,6.6,16561,194,48,-887,-501,19.4,1763.9,51,5,1,13,8,20,1,1,0,0,18526,6.8,17062,198,36,887,501,19.8,1852.6
4489643108,0,17,2,1,9,8,10,1,0,1,0,18529,7.2,18459,227,57,1550,910,22.7,1852.9,19,2,0,8,9,11,1,1,0,0,16979,6.6,17549,206,51,-1550,-910,20.6,1697.9
4426206807,0,14,3,0,10,7,13,0,0,0,0,17625,7.4,19146,205,39,514,2073,20.5,1762.5,14,5,1,7,10,10,0,0,0,0,17111,6.6,17073,223,36,-514,-2073,22.3,1711.1
4481856648,0,23,8,1,5,6,6,0,0,0,0,16182,7.0,17509,245,51,-667,-1046,24.5,1618.2,20,6,0,6,5,9,2,1,1,0,16849,7.0,18555,234,56,667,1046,23.4,1684.9
4499542309,1,11,2,0,4,7,3,0,0,0,0,15562,6.8,17869,225,48,-435,-427,22.5,1556.2,15,2,1,7,4,8,1,1,0,0,15997,7.0,18296,196,65,435,427,19.6,1599.7
4516581221,1,58,2,1,5,7,10,1,1,0,0,14492,6.4,16087,176,48,-2828,-1814,17.6,1449.2,16,3,0,7,5,4,1,0,1,0,17320,6.6,17901,217,54,2828,1814,21.7,1732.0
4500080276,1,19,1,1,7,0,8,0,0,0,0,16688,7.2,19162,233,60,3060,2469,23.3,1668.8,32,0,0,0,7,0,1,1,0,0,13628,6.8,16693,222,57,-3060,-2469,22.2,1362.8
4447281221,0,27,1,0,4,6,1,1,1,0,0,14358,6.8,18106,190,70,-2128,264,19.0,1435.8,18,2,1,6,4,5,0,0,0,0,16486,7.0,17842,227,50,2128,-264,22.7,1648.6
4522487757,0,19,4,0,2,7,1,0,0,0,0,13685,6.6,16729,182,52,-4011,-2271,18.2,1368.5,17,4,1,7,2,6,2,1,1,0,17696,7.2,19000,243,62,4011,2271,24.3,1769.6
4523432309,0,38,2,1,10,11,10,0,0,0,0,17151,6.8,17562,149,48,-1593,-1157,14.9,1715.1,16,3,0,11,10,9,0,0,0,0,18744,7.2,18719,212,37,1593,1157,21.2,1874.4
4519443312,0,16,3,0,6,11,8,1,1,0,0,15930,6.8,17257,200,43,-3549,-2407,20.0,1593.0,14,4,1,11,6,12,0,0,0,0,19479,7.4,19664,214,60,3549,2407,21.4,1947.9
4526812997,0,58,2,0,6,12,12,1,1,0,0,15417,6.4,15374,154,51,-4032,-2866,15.4,1541.7,35,4,1,12,6,11,0,0,0,0,19449,7.0,18240,232,52,4032,2866,23.2,1944.9
4517196528,1,13,0,0,6,4,4,0,0,0,0,17649,7.4,19655,276,50,2194,2684,27.6,1764.9,14,0,1,4,6,3,1,1,0,0,15455,6.8,16971,221,58,-2194,-2684,22.1,1545.5
4526697632,0,16,6,0,7,9,4,0,0,0,0,16649,7.2,18909,230,48,-360,658,23.0,1664.9,34,2,1,9,7,13,0,0,0,0,17009,6.8,18251,203,37,360,-658,20.3,1700.9
4462061093,1,36,6,1,13,3,11,1,1,0,0,21386,7.4,20807,264,60,7420,5869,26.4,2138.6,15,3,0,3,13,3,0,0,0,0,13966,6.0,14938,190,43,-7420,-5869,19.0,1396.6
4522286152,1,16,5,1,5,3,5,2,1,1,0,15263,7.0,17693,216,36,579,-37,21.6,1526.3,17,3,0,3,5,1,0,0,0,0,14684,7.0,17730,245,45,-579,37,24.5,1468.4
4485978471,1,20,3,1,16,5,21,1,1,0,0,20032,7.4,20277,166,48,3931,4106,16.6,2003.2,14,1,0,5,16,4,0,0,0,0,16101,6.6,16171,198,44,-3931,-4106,19.8,1610.1
4515671582,1,30,3,0,8,6,11,0,0,0,0,17588,7.2,18523,238,47,1800,713,23.8,1758.8,12,2,1,6,8,9,1,1,0,0,15788,6.8,17810,192,48,-1800,-713,19.2,1578.8
4485509508,0,11,1,0,5,15,4,0,0,0,0,15727,6.8,17147,198,46,-4245,-3455,19.8,1572.7,15,0,1,15,5,20,0,0,0,0,19972,7.4,20602,227,47,4245,3455,22.7,1997.2
4527159489,0,15,1,0,3,4,3,0,0,0,0,15604,7.0,18013,227,65,-557,625,22.7,1560.4,16,1,1,4,3,6,2,1,1,0,16161,6.8,17388,216,57,557,-625,21.6,1616.1
4526452438,0,18,1,1,4,7,2,0,0,0,0,16061,7.0,17642,230,52,-717,-997,23.0,1606.1,15,6,0,7,4,8,1,1,0,0,16778,7.0,18639,236,56,717,997,23.6,1677.8
4511092295,0,17,4,0,4,5,4,0,0,0,0,15663,7.0,18122,237,44,936,1377,23.7,1566.3,21,2,1,5,4,2,1,1,0,0,14727,6.6,16745,191,52,-936,-1377,19.1,1472.7
4522134991,1,18,2,0,6,9,5,1,1,0,0,16042,6.8,17983,218,56,-1416,-362,21.8,1604.2,19,4,1,9,6,6,0,0,0,0,17458,7.2,18345,243,47,1416,362,24.3,1745.8
4496878235,0,13,1,0,1,4,0,0,0,0,0,13649,6.0,14620,189,41,-2564,-2920,18.9,1364.9,68,2,1,4,1,6,0,0,0,0,16213,6.8,17540,213,72,2564,2920,21.3,1621.3
4510885108,1,19,4,1,8,4,9,0,0,0,0,17950,7.4,18805,226,44,2802,281,22.6,1795.0,44,1,0,4,8,3,1,1,0,0,15148,7.0,18524,213,56,-2802,-281,21.3,1514.8
4525356677,1,52,4,1,5,2,9,1,0,1,0,15574,6.8,16955,206,44,506,-142,20.6,1557.4,17,6,0,2,5,2,1,1,0,0,15068,6.6,17097,229,52,-506,142,22.9,1506.8
4500687748,0,16,6,0,3,4,2,1,0,1,0,15527,6.8,18231,223,48,-564,-298,22.3,1552.7,19,4,1,4,3,7,1,1,0,0,16091,7.0,18529,246,67,564,298,24.6,1609.1
4519588489,1,21,4,1,6,4,9,2,1,1,1,17802,7.0,18461,239,40,2768,1411,23.9,1780.2,16,3,0,4,6,3,0,0,0,0,15034,6.8,17050,211,60,-2768,-1411,21.1,1503.4
4477180489,0,14,5,0,3,14,7,0,0,0,0,14231,6.2,15543,208,44,-5316,-3648,20.8,1423.1,19,3,1,14,3,21,0,0,0,0,19547,7.4,19191,214,48,5316,3648,21.4,1954.7
4526402561,1,39,5,0,1,4,2,0,0,0,0,14783,7.0,18120,248,54,-2003,-1370,24.8,1478.3,17,20,1,4,1,6,0,0,0,0,16786,7.0,19490,264,64,2003,1370,26.4,1678.6
4502439636,0,13,4,0,6,6,5,1,1,0,0,16512,6.8,17751,225,56,46,-1299,22.5,1651.2,17,3,1,6,6,8,0,0,0,0,16466,7.2,19050,232,44,-46,1299,23.2,1646.6
4512245409,1,14,1,0,9,6,9,0,0,0,0,17633,7.2,18808,206,54,1703,1809,20.6,1763.3,16,1,1,6,9,7,0,0,0,0,15930,6.8,16999,210,40,-1703,-1809,21.0,1593.0
4463495962,0,16,2,0,2,6,3,0,0,0,0,15144,7.2,17995,236,52,-1281,-602,23.6,1514.4,15,2,1,6,2,10,0,0,0,0,16425,7.2,18597,219,44,1281,602,21.9,1642.5
4516853831,1,47,4,1,9,9,18,0,0,0,0,17284,6.2,15506,182,42,550,-371,18.2,1728.4,17,2,0,9,9,15,0,0,0,0,16734,6.6,15877,192,44,-550,371,19.2,1673.4
4473257949,1,18,2,1,5,3,7,2,1,1,0,15427,6.8,17667,217,47,134,-144,21.7,1542.7,19,4,0,3,5,2,0,0,0,0,15293,7.0,17811,235,51,-134,144,23.5,1529.3
4500486602,0,28,2,0,3,3,2,0,0,0,0,15134,7.0,18028,214,54,-168,267,21.4,1513.4,17,2,1,3,3,4,1,1,0,0,15302,7.0,17761,214,61,168,-267,21.4,1530.2
4519674041,1,16,3,0,7,12,5,0,0,0,0,16948,7.0,17861,207,48,-2581,-1304,20.7,1694.8,94,3,1,12,7,12,1,1,0,0,19529,7.2,19165,252,48,2581,1304,25.2,1952.9
4478907514,1,19,4,1,7,10,8,1,1,0,0,16632,6.8,17520,191,53,-1069,-587,19.1,1663.2,17,2,0,10,7,11,0,0,0,0,17701,6.8,18107,202,45,1069,587,20.2,1770.1
4522240488,0,18,5,0,3,3,7,1,1,0,0,14742,6.6,16390,202,57,-1517,-1565,20.2,1474.2,16,4,1,3,3,5,0,0,0,0,16259,7.0,17955,255,49,1517,1565,25.5,1625.9
4515907973,0,14,4,1,6,9,6,0,0,0,0,15946,7.0,17404,222,32,-1565,-467,22.2,1594.6,17,0,0,9,6,15,0,0,0,0,17511,6.8,17871,187,40,1565,467,18.7,1751.1
4526437692,1,17,0,1,7,9,11,0,0,0,0,16752,7.0,18525,226,42,-753,-299,22.6,1675.2,14,1,0,9,7,6,0,0,0,0,17505,7.0,18824,225,51,753,299,22.5,1750.5
4519221427,1,16,4,1,7,4,14,1,0,1,0,16655,6.8,17121,214,36,1054,-67,21.4,1665.5,14,6,0,4,7,5,1,1,0,0,15601,6.8,17188,214,56,-1054,67,21.4,1560.1
4518046236,1,13,1,0,6,3,6,1,1,0,0,16665,7.0,18534,236,56,1630,1924,23.6,1666.5,14,1,1,3,6,3,0,0,0,0,15035,6.8,16610,235,36,-1630,-1924,23.5,1503.5
4509940974,0,19,5,1,6,10,7,0,0,0,0,15787,6.8,16711,205,37,-2457,-1625,20.5,1578.7,22,6,0,10,6,10,1,0,1,0,18244,7.0,18336,238,53,2457,1625,23.8,1824.4
4455390955,0,39,1,0,1,5,1,0,0,0,0,13361,6.8,16819,174,48,-3006,-1880,17.4,1336.1,15,0,1,5,1,4,2,1,1,0,16367,7.0,18699,219,48,3006,1880,21.9,1636.7
4514563182,0,18,1,0,9,5,5,1,0,1,0,16835,6.8,17752,200,48,606,533,20.0,1683.5,13,3,1,5,9,6,0,0,0,0,16229,6.8,17219,211,55,-606,-533,21.1,1622.9
4498314967,0,13,3,0,1,6,2,0,0,0,0,14808,7.2,18642,240,64,-2041,-1090,24.0,1480.8,14,2,1,6,1,6,1,1,0,0,16849,7.4,19732,227,64,2041,1090,22.7,1684.9
4461096215,0,16,2,1,5,6,5,0,0,0,1,17659,7.0,18422,225,44,2021,-274,22.5,1765.9,11,3,0,6,5,7,1,1,0,0,15638,7.0,18696,196,48,-2021,274,19.6,1563.8
4494516063,0,16,5,1,9,7,5,1,1,0,0,17907,7.2,19438,231,49,1550,2512,23.1,1790.7,46,4,0,7,9,10,0,0,0,0,16357,6.6,16926,192,40,-1550,-2512,19.2,1635.7
4464260583,0,142,1,0,4,5,4,0,0,0,0,14569,6.6,17180,194,49,-1195,-56,19.4,1456.9,13,3,1,5,4,6,1,1,0,0,15764,6.6,17236,194,54,1195,56,19.4,1576.4
4526202382,1,13,1,1,6,4,5,2,1,1,0,16491,7.6,19790,214,72,392,866,21.4,1649.1,24,1,0,4,6,3,0,0,0,0,16099,7.4,18924,241,69,-392,-866,24.1,1609.9
4527370035,0,13,1,0,3,7,2,1,0,1,0,15000,6.8,17095,212,48,-3290,-1243,21.2,1500.0,15,2,1,7,3,7,1,1,0,0,18290,7.2,18338,252,51,3290,1243,25.2,1829.0
4459817582,1,19,5,1,11,6,12,0,0,0,0,18354,6.8,17746,207,39,1775,-5,20.7,1835.4,37,5,0,6,11,3,0,0,0,0,16579,6.8,17751,208,54,-1775,5,20.8,1657.9
4445858545,1,23,3,1,4,7,6,1,1,0,0,15159,6.6,17115,217,43,-2496,-2174,21.7,1515.9,16,4,0,7,4,6,1,0,1,0,17655,7.2,19289,240,52,2496,2174,24.0,1765.5
4490077553,1,15,2,1,4,2,4,0,0,0,0,16181,7.0,18426,261,49,873,-52,26.1,1618.1,15,1,0,2,4,2,2,1,1,0,15308,7.2,18478,249,61,-873,52,24.9,1530.8
4527713716,0,23,1,0,6,7,5,0,0,0,0,15903,7.0,18032,210,45,-2416,-1877,21.0,1590.3,14,0,1,7,6,11,1,1,0,0,18319,7.4,19909,261,60,2416,1877,26.1,1831.9
4493209584,0,15,2,0,4,6,3,0,0,0,0,15532,6.8,18026,210,64,-781,-1296,21.0,1553.2,22,1,1,6,4,4,2,1,1,0,16313,7.2,19322,220,58,781,1296,22.0,1631.3
4497565171,1,10,4,1,13,5,18,1,1,0,1,20853,7.4,20447,251,49,5477,3692,25.1,2085.3,14,2,0,5,13,4,0,0,0,0,15376,6.6,16755,206,46,-5477,-3692,20.6,1537.6
4501312404,1,16,3,1,6,4,5,0,0,0,0,15659,6.8,17407,211,47,-127,-445,21.1,1565.9,16,4,0,4,6,6,2,1,1,0,15786,6.8,17852,209,64,127,445,20.9,1578.6
4506495968,0,8,2,0,7,11,6,1,0,1,0,16998,6.6,17282,207,55,-1343,-591,20.7,1699.8,18,3,1,11,7,15,1,1,0,0,18341,6.8,17873,191,40,1343,591,19.1,1834.1
4496084500,0,37,2,0,3,9,5,0,0,0,0,14735,6.4,16488,219,38,-2932,-2063,21.9,1473.5,13,2,1,9,3,5,0,0,0,0,17667,7.2,18551,223,44,2932,2063,22.3,1766.7
4505942636,1,15,8,0,9,4,9,0,0,0,0,18099,7.0,18989,238,56,2420,2272,23.8,1809.9,20,2,1,4,9,4,1,1,0,0,15679,6.6,16717,218,50,-2420,-2272,21.8,1567.9
4487261308,0,37,4,0,3,5,3,0,0,0,0,14822,7.0,18244,231,49,-2420,-753,23.1,1482.2,18,4,1,5,3,5,1,0,1,0,17242,7.0,18997,246,63,2420,753,24.6,1724.2
4470773744,0,12,2,1,5,12,5,2,1,1,0,16347,6.6,17442,212,51,-3529,-1509,21.2,1634.7,12,5,0,12,5,15,0,0,0,1,19876,7.4,18951,214,52,3529,1509,21.4,1987.6
4519919253,1,16,0,0,5,7,4,1,0,1,0,15994,6.8,17724,225,52,-144,1497,22.5,1599.4,14,5,1,7,5,12,0,0,0,0,16138,6.4,16227,183,44,144,-1497,18.3,1613.8
4487913203,0,17,2,1,11,2,9,0,0,0,0,18285,7.2,19465,221,37,4581,3919,22.1,1828.5,20,3,0,2,11,1,0,0,0,0,13704,6.6,15546,175,50,-4581,-3919,17.5,1370.4
4476146291,1,88,2,1,10,2,6,1,1,0,0,19077,7.6,20483,234,52,5271,3997,23.4,1907.7,15,1,0,2,10,2,0,0,0,0,13806,6.6,16486,191,48,-5271,-3997,19.1,1380.6
4507604548,1,21,2,1,5,6,2,2,1,1,1,16874,6.8,17230,226,41,1319,556,22.6,1687.4,21,4,0,6,5,4,0,0,0,0,15555,6.8,16674,212,42,-1319,-556,21.2,1555.5
4518392490,1,17,3,0,9,7,9,1,1,0,0,19034,7.4,19369,240,43,4051,3552,24.0,1903.4,15,1,1,7,9,6,0,0,0,0,14983,6.6,15817,178,28,-4051,-3552,17.8,1498.3
4522510134,0,80,4,0,7,5,10,0,0,0,0,17274,7.4,20199,246,56,424,1050,24.6,1727.4,16,2,1,5,7,4,1,1,0,0,16850,7.2,19149,245,72,-424,-1050,24.5,1685.0
4519722602,0,16,3,1,7,6,8,1,1,0,0,16646,6.6,16213,204,44,592,-875,20.4,1664.6,30,3,0,6,7,8,0,0,0,0,16054,6.6,17088,204,56,-592,875,20.4,1605.4
4478377067,0,18,3,0,6,8,4,1,0,1,0,16561,7.0,18103,239,54,-1637,-886,23.9,1656.1,39,6,1,8,6,7,1,1,0,0,18198,7.2,18989,240,57,1637,886,24.0,1819.8
4470712101,0,22,3,0,7,4,8,1,1,0,0,16413,6.8,16989,209,39,188,-1124,20.9,1641.3,83,6,1,4,7,6,0,0,0,0,16225,6.8,18113,248,47,-188,1124,24.8,1622.5
4472015135,1,17,2,1,7,6,8,0,0,0,0,15833,6.8,16967,208,36,-1800,-2200,20.8,1583.3,14,4,0,6,7,8,1,1,0,0,17633,7.0,19167,245,60,1800,2200,24.5,1763.3
4518143538,1,34,6,1,6,3,8,0,0,0,0,16240,6.6,16345,200,51,2171,960,20.0,1624.0,17,5,0,3,6,5,0,0,0,0,14069,6.2,15385,193,47,-2171,-960,19.3,1406.9
4476239097,1,9,5,1,11,7,8,0,0,0,0,18483,7.4,19419,199,47,2915,2523,19.9,1848.3,18,1,0,7,11,6,0,0,0,0,15568,6.6,16896,209,41,-2915,-2523,20.9,1556.8
4515729442,0,15,5,0,5,6,7,1,0,1,0,15913,6.8,17592,202,41,-844,-689,20.2,1591.3,16,3,1,6,5,3,1,1,0,0,16757,7.2,18281,247,56,844,689,24.7,1675.7
4521093374,0,43,1,1,6,8,10,0,0,0,0,15629,6.8,16806,176,52,-1537,-926,17.6,1562.9,15,4,0,8,6,9,0,0,0,0,17166,7.0,17732,186,36,1537,926,18.6,1716.6
4510352485,0,14,2,1,6,0,7,0,0,0,0,17476,7.2,19471,226,68,3460,2275,22.6,1747.6,17,2,0,0,6,0,1,1,0,0,14016,6.8,17196,242,64,-3460,-2275,24.2,1401.6
4451639888,0,19,3,1,5,5,6,1,1,0,0,16043,7.0,17912,227,43,-564,-422,22.7,1604.3,21,3,0,5,5,9,1,0,1,0,16607,7.0,18334,236,60,564,422,23.6,1660.7
4512098685,0,20,3,1,12,10,20,0,0,0,0,18269,6.4,16542,198,35,1032,-617,19.8,1826.9,17,3,0,10,12,9,0,0,0,0,17237,6.8,17159,202,36,-1032,617,20.2,1723.7
4513346421,1,16,4,0,5,9,4,0,0,0,0,15999,6.8,17524,203,62,-1189,-1741,20.3,1599.9,16,4,1,9,5,5,1,1,0,0,17188,7.2,19265,224,50,1189,1741,22.4,1718.8
4458734669,0,19,7,1,3,4,3,1,0,1,0,14839,6.8,17590,205,53,-986,-1894,20.5,1483.9,98,6,0,4,3,3,1,1,0,0,15825,7.4,19484,250,48,986,1894,25.0,1582.5
4517909755,0,13,0,1,2,4,2,0,0,0,0,14524,6.8,17686,214,50,-1333,-1832,21.4,1452.4,14,3,0,4,2,2,0,0,0,0,15857,7.0,19518,260,49,1333,1832,26.0,1585.7
4497717907,0,18,1,1,4,8,6,0,0,0,0,15694,6.6,16853,202,59,-3531,-2649,20.2,1569.4,7,3,0,8,4,8,1,1,0,1,19225,7.2,19502,265,40,3531,2649,26.5,1922.5
4507608751,0,19,2,1,8,7,12,2,1,1,0,16912,6.8,17022,213,57,106,-1098,21.3,1691.2,26,4,0,7,8,6,0,0,0,0,16806,7.0,18120,179,60,-106,1098,17.9,1680.6
4463284489,0,21,6,0,6,10,7,0,0,0,1,17225,6.6,16572,210,44,-833,-1786,21.0,1722.5,56,8,1,10,6,10,1,0,1,0,18058,7.0,18358,220,53,833,1786,22.0,1805.8
4521440025,0,17,4,1,4,4,4,0,0,0,0,14788,6.6,17212,212,46,-516,-113,21.2,1478.8,38,3,0,4,4,5,1,1,0,0,15304,6.6,17325,212,47,516,113,21.2,1530.4
4496641163,0,17,4,0,4,6,6,0,0,0,0,15920,6.6,17106,229,51,-905,-2229,22.9,1592.0,58,4,1,6,4,12,2,1,1,0,16825,7.0,19335,224,46,905,2229,22.4,1682.5
4516262815,0,28,4,1,4,7,6,0,0,0,0,14937,6.8,16417,211,57,-2601,-3694,21.1,1493.7,15,5,0,7,4,8,2,1,1,0,17538,7.4,20111,232,60,2601,3694,23.2,1753.8
4526832449,0,15,3,1,7,9,9,1,0,1,1,17655,6.4,16585,203,52,-134,-1518,20.3,1765.5,16,2,0,9,7,16,1,1,0,0,17789,7.0,18103,217,53,134,1518,21.7,1778.9
4511502291,1,13,4,0,7,8,6,1,0,1,0,16464,6.6,17075,209,52,166,395,20.9,1646.4,16,1,1,8,7,12,1,1,0,0,16298,6.6,16680,167,40,-166,-395,16.7,1629.8
4502587670,0,17,4,0,5,7,6,0,0,0,0,15639,6.6,16156,196,48,-1003,-1777,19.6,1563.9,17,3,1,7,5,7,1,1,0,0,16642,6.8,17933,204,48,1003,1777,20.4,1664.2
4520304212,0,15,4,0,7,13,9,0,0,0,0,15812,6.8,17646,186,47,-3590,-1683,18.6,1581.2,17,1,1,13,7,10,1,1,0,0,19402,7.2,19329,216,52,3590,1683,21.6,1940.2
4462648496,1,15,3,1,10,6,16,2,1,1,0,18718,7.4,18807,214,71,2404,927,21.4,1871.8,17,0,0,6,10,6,0,0,0,0,16314,7.0,17880,228,60,-2404,-927,22.8,1631.4
4507316147,0,17,4,1,2,5,3,0,0,0,0,14219,6.6,16055,213,40,-2405,-1720,21.3,1421.9,46,5,0,5,2,7,0,0,0,0,16624,6.8,17775,235,37,2405,1720,23.5,1662.4
4513491112,0,84,1,0,3,8,2,0,0,0,0,14975,7.0,17721,227,40,-3348,-1795,22.7,1497.5,37,4,1,8,3,10,1,0,1,0,18323,7.2,19516,224,58,3348,1795,22.4,1832.3
4513364103,1,15,0,1,10,8,11,1,0,1,0,17965,7.2,19735,219,60,-195,646,21.9,1796.5,14,1,0,8,10,3,1,1,0,0,18160,7.0,19089,244,50,195,-646,24.4,1816.0
4524763610,1,15,4,1,10,2,12,1,1,0,0,18444,7.0,18580,220,51,3711,2294,22.0,1844.4,16,3,0,2,10,2,0,0,0,0,14733,6.4,16286,234,47,-3711,-2294,23.4,1473.3
4491128143,0,13,1,0,4,8,4,0,0,0,0,15676,7.2,19519,223,63,-2476,-394,22.3,1567.6,19,3,1,8,4,7,2,1,1,0,18152,7.4,19913,260,64,2476,394,26.0,1815.2
4472684884,1,16,4,0,6,4,6,1,0,1,0,16434,7.0,18330,235,48,-435,574,23.5,1643.4,20,5,1,4,6,8,1,1,0,0,16869,6.8,17756,270,36,435,-574,27.0,1686.9
4516912566,1,21,0,1,7,0,9,2,1,1,1,19148,7.0,18457,232,50,7791,6458,23.2,1914.8,10,0,0,0,7,0,0,0,0,0,11357,5.6,11999,137,45,-7791,-6458,13.7,1135.7
4496611472,1,14,3,1,7,2,7,1,0,1,0,17206,7.4,20071,248,66,2893,3588,24.8,1720.6,12,1,0,2,7,4,1,1,0,0,14313,6.6,16483,218,56,-2893,-3588,21.8,1431.3
4523322738,1,17,3,1,8,8,8,1,0,1,0,17022,7.0,19318,237,50,-900,1475,23.7,1702.2,16,2,0,8,8,12,1,1,0,0,17922,7.0,17843,203,45,900,-1475,20.3,1792.2
4519582751,0,40,4,1,4,7,4,0,0,0,0,15280,6.6,16650,202,47,-770,-1875,20.2,1528.0,17,16,0,7,4,4,1,1,0,0,16050,7.2,18525,217,51,770,1875,21.7,1605.0
4523540564,0,11,1,0,4,6,2,1,0,1,0,14933,6.6,16336,190,56,-2781,-2752,19.0,1493.3,13,1,1,6,4,8,1,1,0,0,17714,7.2,19088,204,81,2781,2752,20.4,1771.4
4521833951,0,16,4,1,8,3,13,0,0,0,0,18093,7.2,18506,238,51,2774,1134,23.8,1809.3,40,6,0,3,8,3,1,1,0,0,15319,6.8,17372,230,47,-2774,-1134,23.0,1531.9
4521541761,1,17,3,1,2,0,2,1,1,0,0,15081,6.6,17517,240,59,865,-933,24.0,1508.1,39,5,0,0,2,0,0,0,0,0,14216,6.8,18450,252,51,-865,933,25.2,1421.6
4509711649,1,18,7,1,7,1,4,1,1,0,0,17200,7.2,19346,234,60,2977,3051,23.4,1720.0,16,3,0,1,7,1,0,0,0,0,14223,6.6,16295,211,72,-2977,-3051,21.1,1422.3
4522136543,1,11,3,0,6,8,6,2,1,1,0,16618,7.0,17861,206,69,-702,746,20.6,1661.8,16,1,1,8,6,11,0,0,0,0,17320,6.4,17115,206,38,702,-746,20.6,1732.0
4451981471,0,15,2,0,7,11,6,0,0,0,0,16364,6.4,16467,223,29,-1565,-1752,22.3,1636.4,19,3,1,11,7,14,2,1,1,0,17929,7.0,18219,170,70,1565,1752,17.0,1792.9
4448360530,0,13,1,1,7,5,5,2,1,1,0,17381,7.0,18495,220,52,1418,544,22.0,1738.1,15,0,0,5,7,5,0,0,0,0,15963,6.8,17951,225,56,-1418,-544,22.5,1596.3
4424223586,1,15,5,0,6,6,6,0,0,0,0,16763,6.8,17822,207,52,54,-119,20.7,1676.3,20,3,1,6,6,7,1,1,0,0,16709,6.8,17941,214,53,-54,119,21.4,1670.9
4494314514,0,44,5,1,8,2,7,2,1,1,0,17298,7.2,18556,225,48,2975,2627,22.5,1729.8,18,2,0,2,8,3,0,0,0,0,14323,6.4,15929,211,44,-2975,-2627,21.1,1432.3
4484391297,1,13,2,0,4,4,0,1,0,1,1,17079,7.4,19361,250,66,1680,2384,25.0,1707.9,50,2,1,4,4,3,0,0,0,0,15399,6.6,16977,200,62,-1680,-2384,20.0,1539.9
4442298197,0,18,2,1,9,6,13,1,1,0,0,17169,6.8,17934,216,33,-92,-1411,21.6,1716.9,14,0,0,6,9,6,1,0,1,0,17261,7.2,19345,221,63,92,1411,22.1,1726.1
4525161056,1,40,4,0,6,4,11,0,0,0,0,16814,7.0,18612,238,56,2247,1262,23.8,1681.4,14,2,1,4,6,0,1,1,0,0,14567,6.8,17350,220,55,-2247,-1262,22.0,1456.7
4509836530,1,38,1,1,6,8,10,0,0,0,0,15579,6.8,16638,198,38,-1314,-566,19.8,1557.9,17,2,0,8,6,8,1,1,0,0,16893,6.8,17204,215,48,1314,566,21.5,1689.3
4527592753,1,19,1,0,1,6,1,0,0,0,0,13719,6.4,15044,213,31,-3247,-3783,21.3,1371.9,14,2,1,6,1,5,2,1,1,0,16966,7.2,18827,237,58,3247,3783,23.7,1696.6
4515203264,1,15,2,0,6,5,11,1,1,0,0,16452,6.8,17946,208,60,906,1330,20.8,1645.2,16,1,1,5,6,7,0,0,0,0,15546,6.6,16616,185,43,-906,-1330,18.5,1554.6
4456745249,0,26,3,0,1,8,1,1,0,1,0,14044,6.8,16385,231,44,-4107,-3090,23.1,1404.4,20,6,1,8,1,12,1,1,0,0,18151,7.4,19475,234,60,4107,3090,23.4,1815.1
4489459707,1,17,2,0,7,7,8,0,0,0,0,16983,6.8,17858,227,51,-355,-560,22.7,1698.3,18,5,1,7,7,10,1,1,0,0,17338,7.0,18418,218,71,355,560,21.8,1733.8
4518202397,0,20,5,1,13,7,10,1,1,0,0,19402,7.0,18727,213,51,2399,1719,21.3,1940.2,18,2,0,7,13,8,0,0,0,0,17003,6.6,17008,212,32,-2399,-1719,21.2,1700.3
4427925743,0,15,4,1,3,6,2,0,0,0,0,13977,6.6,15961,185,48,-2707,-3132,18.5,1397.7,17,4,0,6,3,5,2,1,1,0,16684,7.4,19093,226,64,2707,3132,22.6,1668.4
4462139744,1,27,5,1,15,3,14,2,1,1,1,20567,7.4,19536,221,42,6487,4018,22.1,2056.7,19,6,0,3,15,1,0,0,0,0,14080,6.2,15518,197,46,-6487,-4018,19.7,1408.0
4517057084,0,14,0,0,7,9,8,0,0,0,0,16278,6.6,16530,181,36,-1829,-1668,18.1,1627.8,14,2,1,9,7,10,1,1,0,0,18107,7.0,18198,212,52,1829,1668,21.2,1810.7
4518419610,0,93,4,1,5,7,4,0,0,0,0,16082,6.6,17246,220,38,-974,-1306,22.0,1608.2,16,5,0,7,5,9,0,0,0,0,17056,6.8,18552,228,52,974,1306,22.8,1705.6
4505905510,1,13,2,1,5,5,5,0,0,0,0,16287,7.0,16978,235,38,1099,-622,23.5,1628.7,12,1,0,5,5,4,0,0,0,0,15188,6.8,17600,183,51,-1099,622,18.3,1518.8
4445687037,1,18,3,1,9,4,11,1,0,1,0,18036,7.0,18597,236,46,2806,1391,23.6,1803.6,47,3,0,4,9,7,1,1,0,0,15230,6.6,17206,232,49,-2806,-1391,23.2,1523.0
4523375871,0,20,2,0,5,8,3,0,0,0,0,15429,6.8,17256,198,55,-2375,-2008,19.8,1542.9,16,5,1,8,5,11,1,1,0,0,17804,7.2,19264,222,46,2375,2008,22.2,1780.4
4525545427,1,36,0,1,3,5,2,1,1,0,0,14711,7.0,18380,209,52,-1244,-548,20.9,1471.1,11,1,0,5,3,6,1,0,1,0,15955,7.2,18928,234,51,1244,548,23.4,1595.5
4524677634,1,19,1,1,7,4,11,0,0,0,0,16867,7.2,18904,219,57,920,1488,21.9,1686.7,18,2,0,4,7,6,1,1,0,0,15947,7.0,17416,210,54,-920,-1488,21.0,1594.7
4436714385,0,18,3,0,6,15,6,0,0,0,0,15205,6.4,15267,166,28,-4683,-3444,16.6,1520.5,33,3,1,15,6,15,1,1,0,0,19888,7.2,18711,220,62,4683,3444,22.0,1988.8
4451359541,1,14,0,1,8,4,10,1,1,0,0,16912,7.0,17678,222,38,1416,-211,22.2,1691.2,14,1,0,4,8,3,0,0,0,0,15496,6.8,17889,196,60,-1416,211,19.6,1549.6
4511923610,0,15,2,1,9,6,8,0,0,0,0,17848,7.4,19890,212,67,868,1728,21.2,1784.8,18,1,0,6,9,8,1,1,0,0,16980,7.2,18162,216,56,-868,-1728,21.6,1698.0
4458718389,1,18,2,1,16,10,12,1,1,0,0,20084,6.8,17621,175,46,2098,1150,17.5,2008.4,17,1,0,10,16,10,0,0,0,0,17986,6.8,16471,182,37,-2098,-1150,18.2,1798.6
4516362177,1,17,4,1,8,10,8,0,0,0,0,15984,6.6,16282,206,34,-2111,-1573,20.6,1598.4,16,2,0,10,8,14,1,0,1,0,18095,6.8,17855,208,45,2111,1573,20.8,1809.5
4506831821,0,15,2,1,2,12,3,0,0,0,0,14379,6.6,16423,203,49,-6676,-3924,20.3,1437.9,12,5,0,12,2,14,1,1,0,1,21055,7.2,20347,223,66,6676,3924,22.3,2105.5
4519196581,0,59,4,1,5,9,4,1,1,0,0,15534,6.6,16209,204,40,-2212,-1548,20.4,1553.4,17,4,0,9,5,8,0,0,0,0,17746,6.8,17757,215,60,2212,1548,21.5,1774.6
4527454154,0,19,5,1,13,12,19,0,0,0,0,19362,6.6,17316,195,28,965,1856,19.5,1936.2,16,2,0,12,13,20,1,0,1,0,18397,6.4,15460,180,40,-965,-1856,18.0,1839.7
4518381780,0,14,1,0,8,10,10,1,1,0,0,16991,7.0,17910,205,44,-1001,-825,20.5,1699.1,15,3,1,10,8,6,0,0,0,0,17992,7.2,18735,225,52,1001,825,22.5,1799.2
4512213079,0,100,1,0,8,7,4,0,0,0,0,16865,7.4,19606,212,56,147,1133,21.2,1686.5,30,0,1,7,8,3,1,1,0,0,16718,7.0,18473,209,52,-147,-1133,20.9,1671.8
4523108166,0,18,4,1,8,8,12,1,1,0,0,16171,6.6,16898,214,43,-1642,-2040,21.4,1617.1,16,4,0,8,8,9,1,0,1,0,17813,7.2,18938,235,60,1642,2040,23.5,1781.3
4500920231,1,17,5,0,6,5,9,1,0,1,0,17544,7.0,18604,230,73,1092,1401,23.0,1754.4,22,4,1,5,6,9,0,0,0,0,16452,6.8,17203,258,30,-1092,-1401,25.8,1645.2
4525622541,0,28,5,0,6,5,6,0,0,0,0,15801,7.0,17655,208,45,161,1546,20.8,1580.1,20,5,1,5,6,3,0,0,0,0,15640,6.6,16109,197,34,-161,-1546,19.7,1564.0
4482052361,0,19,6,0,2,8,4,0,0,0,0,13698,6.2,15671,222,33,-4907,-2556,22.2,1369.8,18,7,1,8,2,11,1,0,1,1,18605,7.0,18227,242,40,4907,2556,24.2,1860.5
4524792382,0,41,1,1,7,8,8,1,1,0,0,15956,6.6,17062,200,44,-916,-1466,20.0,1595.6,12,1,0,8,7,6,0,0,0,0,16872,7.2,18528,204,52,916,1466,20.4,1687.2
4521004120,1,17,2,1,5,7,1,0,0,0,0,15446,6.6,16681,183,62,-1257,-1406,18.3,1544.6,86,1,0,7,5,5,1,1,0,0,16703,6.8,18087,186,56,1257,1406,18.6,1670.3
4524775496,1,12,1,0,8,7,9,1,1,0,0,17738,7.2,18849,209,63,1868,1432,20.9,1773.8,17,2,1,7,8,3,0,0,0,0,15870,7.0,17417,207,49,-1868,-1432,20.7,1587.0
4524478226,1,15,2,0,12,10,20,0,0,0,0,17961,6.8,17984,172,32,478,-124,17.2,1796.1,61,1,1,10,12,17,1,1,0,0,17483,6.8,18108,159,75,-478,124,15.9,1748.3
4521034143,0,18,3,0,8,10,13,1,1,0,0,17048,6.8,17097,193,52,-1773,-1963,19.3,1704.8,14,4,1,10,8,13,0,0,0,0,18821,7.2,19060,215,51,1773,1963,21.5,1882.1
4516562361,0,15,3,0,8,7,8,0,0,0,0,17496,7.4,19884,232,35,4,1213,23.2,1749.6,15,2,1,7,8,8,0,0,0,0,17492,7.2,18671,259,56,-4,-1213,25.9,1749.2
4518345906,1,39,3,1,7,0,4,1,1,0,0,16897,7.6,20576,240,67,3084,3352,24.0,1689.7,13,3,0,0,7,0,0,0,0,0,13813,6.6,17224,219,60,-3084,-3352,21.9,1381.3
4526394559,0,15,3,1,6,6,9,1,1,0,0,15602,6.6,16235,195,48,-1081,-2155,19.5,1560.2,12,3,0,6,6,4,0,0,0,0,16683,7.0,18390,214,48,1081,2155,21.4,1668.3
4458486391,1,18,7,1,9,5,7,1,1,0,0,17803,7.4,20184,267,39,2193,2957,26.7,1780.3,17,4,0,5,9,4,0,0,0,0,15610,6.8,17227,207,44,-2193,-2957,20.7,1561.0
4520301016,0,13,11,0,5,9,6,0,0,0,0,14826,6.8,16490,176,40,-2907,-3389,17.6,1482.6,38,0,1,9,5,2,1,1,0,0,17733,7.4,19879,229,65,2907,3389,22.9,1773.3
4519798886,0,21,17,1,9,9,11,1,1,0,0,18036,6.8,17340,213,34,-1501,-3119,21.3,1803.6,37,4,0,9,9,10,1,0,1,0,19537,7.6,20459,221,74,1501,3119,22.1,1953.7
4526099071,1,16,3,0,7,5,8,0,0,0,0,16905,6.8,17224,214,40,831,8,21.4,1690.5,15,1,1,5,7,8,1,1,0,0,16074,6.8,17216,218,61,-831,-8,21.8,1607.4
4521735411,0,13,2,1,4,8,5,0,0,0,0,15913,6.4,16454,193,48,-960,-2502,19.3,1591.3,12,1,0,8,4,9,0,0,0,0,16873,7.4,18956,190,54,960,2502,19.0,1687.3
4513591449,0,19,2,0,4,5,2,0,0,0,0,15180,7.0,17773,210,52,-1705,-1839,21.0,1518.0,11,4,1,5,4,1,0,0,0,0,16885,7.2,19612,227,62,1705,1839,22.7,1688.5
4513418433,0,18,3,0,7,13,5,0,0,0,0,15744,6.8,16509,201,48,-3762,-1626,20.1,1574.4,17,2,1,13,7,16,2,1,1,0,19506,6.8,18135,213,52,3762,1626,21.3,1950.6
4455281479,1,45,3,1,10,3,5,1,0,1,0,18730,7.4,20389,232,58,5229,5136,23.2,1873.0,16,15,0,3,10,0,1,1,0,0,13501,6.4,15253,181,36,-5229,-5136,18.1,1350.1
4457745439,0,10,4,0,7,11,5,1,1,0,0,17892,7.2,18922,205,72,273,1428,20.5,1789.2,43,1,1,11,7,14,0,0,0,0,17619,6.8,17494,191,31,-273,-1428,19.1,1761.9
4510832463,0,17,2,0,5,7,3,0,0,0,0,15209,6.8,16799,208,56,-1517,-1331,20.8,1520.9,59,5,1,7,5,8,0,0,0,0,16726,7.0,18130,229,52,1517,1331,22.9,1672.6
4493037422,0,11,0,1,8,8,12,0,0,0,0,16033,6.8,17402,188,52,-3022,-613,18.8,1603.3,14,1,0,8,8,6,1,0,1,1,19055,7.2,18015,221,54,3022,613,22.1,1905.5
4475840580,1,16,2,0,5,2,3,0,0,0,0,16929,7.2,19477,232,76,1398,1802,23.2,1692.9,16,2,1,2,5,3,0,0,0,0,15531,7.0,17675,239,60,-1398,-1802,23.9,1553.1
4526521494,0,18,3,1,5,4,9,0,0,0,0,15885,6.8,17840,233,35,-350,626,23.3,1588.5,15,5,0,4,5,5,0,0,0,0,16235,7.0,17214,221,56,350,-626,22.1,1623.5
4492054165,0,58,2,1,4,8,1,0,0,0,0,14807,6.8,17294,201,56,-2462,-1894,20.1,1480.7,15,2,0,8,4,6,0,0,0,0,17269,7.4,19188,229,56,2462,1894,22.9,1726.9
4527471301,1,19,8,0,7,4,10,0,0,0,0,16507,6.4,16273,212,42,1114,-1294,21.2,1650.7,18,4,1,4,7,5,0,0,0,0,15393,6.8,17567,221,55,-1114,1294,22.1,1539.3
4460534353,1,16,0,0,11,6,11,2,1,1,0,19294,7.4,20668,242,52,2750,2647,24.2,1929.4,14,2,1,6,11,9,0,0,0,0,16544,7.0,18021,203,52,-2750,-2647,20.3,1654.4
4485702614,0,11,1,0,2,4,0,0,0,0,0,14395,6.6,17060,210,43,-1386,-335,21.0,1439.5,16,1,1,4,2,6,0,0,0,0,15781,6.8,17395,211,60,1386,335,21.1,1578.1
4502752465,0,17,4,0,4,4,7,0,0,0,0,15813,7.2,18788,248,46,-80,470,24.8,1581.3,15,4,1,4,4,2,1,1,0,0,15893,7.2,18318,219,72,80,-470,21.9,1589.3
4506094664,1,12,1,0,2,10,1,1,0,1,0,14749,6.6,16489,204,51,-3114,-2569,20.4,1474.9,19,0,1,10,2,5,0,0,0,0,17863,7.2,19058,224,47,3114,2569,22.4,1786.3
4521524486,1,16,3,1,5,5,7,0,0,0,0,16061,7.0,18238,210,60,530,1280,21.0,1606.1,14,2,0,5,5,5,0,0,0,0,15531,6.8,16958,204,44,-530,-1280,20.4,1553.1
4500122994,0,16,1,1,3,2,1,1,1,0,0,16238,7.0,18724,241,60,1443,-453,24.1,1623.8,20,2,0,2,3,2,0,0,0,0,14795,7.2,19177,215,68,-1443,453,21.5,1479.5
4460600037,0,16,5,1,3,3,5,1,0,1,0,15578,7.0,18183,243,56,-313,-701,24.3,1557.8,13,4,0,3,3,3,1,1,0,0,15891,7.2,18884,253,62,313,701,25.3,1589.1
4512974012,0,14,3,0,0,6,0,0,0,0,0,14197,6.8,17915,255,54,-2313,-1210,25.5,1419.7,60,3,1,6,0,6,0,0,0,0,16510,7.2,19125,231,64,2313,1210,23.1,1651.0
4522584665,1,40,3,1,5,3,3,0,0,0,0,17194,7.4,19447,263,61,2588,1628,26.3,1719.4,14,2,0,3,5,3,0,0,0,0,14606,7.0,17819,215,37,-2588,-1628,21.5,1460.6
4523615323,1,38,1,0,7,7,6,0,0,0,0,16639,6.8,18068,214,48,-293,-818,21.4,1663.9,15,4,1,7,7,5,1,1,0,0,16932,7.2,18886,232,52,293,818,23.2,1693.2
4518877029,0,16,3,1,5,4,3,1,1,0,0,16374,7.2,18711,227,55,412,93,22.7,1637.4,31,5,0,4,5,1,0,0,0,0,15962,7.2,18618,234,64,-412,-93,23.4,1596.2
4478629184,0,28,4,0,3,4,3,1,1,0,0,14383,6.4,15898,211,55,-890,-528,21.1,1438.3,16,2,1,4,3,5,1,0,1,0,15273,6.4,16426,208,44,890,528,20.8,1527.3
4521767558,0,149,2,0,7,9,7,0,0,0,0,17166,7.2,18945,224,52,-1561,925,22.4,1716.6,42,3,1,9,7,10,2,1,1,1,18727,7.0,18020,177,47,1561,-925,17.7,1872.7
4491649384,1,42,3,0,6,4,7,2,1,1,0,16199,7.0,18445,213,53,531,947,21.3,1619.9,14,0,1,4,6,4,0,0,0,0,15668,6.8,17498,234,40,-531,-947,23.4,1566.8
4513255821,0,16,6,0,1,4,1,0,0,0,0,15632,7.2,18155,268,60,-598,-1285,26.8,1563.2,17,3,1,4,1,6,2,1,1,0,16230,7.2,19440,238,78,598,1285,23.8,1623.0
4459961867,0,15,4,1,8,6,11,1,0,1,0,17662,7.2,19112,219,60,1016,310,21.9,1766.2,20,3,0,6,8,8,1,1,0,0,16646,7.2,18802,231,60,-1016,-310,23.1,1664.6
4467758598,0,17,2,0,5,5,4,1,1,0,0,15013,7.0,17384,198,48,-1008,-717,19.8,1501.3,16,3,1,5,5,6,0,0,0,0,16021,7.0,18101,225,56,1008,717,22.5,1602.1
4514421047,1,16,3,1,7,7,5,0,0,0,0,16448,7.2,19097,216,52,387,1781,21.6,1644.8,15,1,0,7,7,2,0,0,0,0,16061,6.8,17316,210,48,-387,-1781,21.0,1606.1
4516962004,0,14,3,0,5,8,8,1,1,0,0,17160,7.2,19481,245,64,-312,37,24.5,1716.0,15,1,1,8,5,12,0,0,0,0,17472,7.2,19444,231,60,312,-37,23.1,1747.2
4525626729,1,15,4,1,16,7,14,1,1,0,0,20236,6.8,18074,203,40,3424,1464,20.3,2023.6,15,1,0,7,16,6,0,0,0,0,16812,6.6,16610,169,48,-3424,-1464,16.9,1681.2
4500004334,0,18,1,0,4,6,3,1,1,0,0,15377,7.2,18315,215,51,-1262,614,21.5,1537.7,13,2,1,6,4,5,0,0,0,0,16639,7.0,17701,225,66,1262,-614,22.5,1663.9
4521867073,1,20,1,1,8,7,12,1,0,1,0,18339,7.4,19803,232,74,694,1305,23.2,1833.9,37,7,0,7,8,10,1,1,0,0,17645,7.4,18498,245,49,-694,-1305,24.5,1764.5
4526195256,1,16,5,1,5,4,5,1,0,1,0,15916,6.8,17531,237,51,73,-806,23.7,1591.6,21,6,0,4,5,4,1,1,0,0,15843,7.0,18337,238,61,-73,806,23.8,1584.3
4509979337,1,14,0,0,4,7,1,0,0,0,0,14924,6.8,17139,207,56,-2611,-1375,20.7,1492.4,54,0,1,7,4,5,1,1,0,1,17535,7.0,18514,218,65,2611,1375,21.8,1753.5
4521920198,0,16,2,0,1,7,1,0,0,0,0,14513,6.6,17238,218,48,-2382,-2219,21.8,1451.3,15,4,1,7,1,5,1,1,0,0,16895,7.2,19457,248,56,2382,2219,24.8,1689.5
4525354292,1,13,6,1,7,5,7,1,1,0,0,16736,7.0,18814,217,56,433,-323,21.7,1673.6,21,4,0,5,7,6,0,0,0,0,16303,7.2,19137,262,52,-433,323,26.2,1630.3
4481862687,1,18,5,1,10,2,12,2,1,1,0,18912,7.0,17839,257,44,4565,2079,25.7,1891.2,19,4,0,2,10,2,0,0,0,0,14347,6.2,15760,197,52,-4565,-2079,19.7,1434.7
4523487666,0,9,2,1,6,5,6,1,0,1,0,16782,7.0,19622,238,61,817,350,23.8,1678.2,17,1,0,5,6,5,1,1,0,0,15965,7.2,19272,235,51,-817,-350,23.5,1596.5
4492561443,1,15,3,1,5,1,4,0,0,0,0,16778,7.2,18893,247,48,2375,2688,24.7,1677.8,37,1,0,1,5,0,0,0,0,0,14403,6.6,16205,235,60,-2375,-2688,23.5,1440.3
4527372782,0,14,4,0,5,3,5,0,0,0,0,15897,7.0,18190,226,44,485,858,22.6,1589.7,15,3,1,3,5,3,0,0,0,0,15412,6.8,17332,238,31,-485,-858,23.8,1541.2
4524632974,0,14,2,0,2,5,1,1,0,1,0,14815,7.0,18080,233,54,-931,1384,23.3,1481.5,86,3,1,5,2,4,0,0,0,0,15746,6.6,16696,209,52,931,-1384,20.9,1574.6
4481425277,1,18,1,0,6,6,12,1,1,0,0,16951,7.0,18426,229,49,248,-219,22.9,1695.1,15,1,1,6,6,7,1,0,1,0,16703,6.8,18645,245,60,-248,219,24.5,1670.3
4513433271,1,81,2,0,4,7,4,1,1,0,0,15746,7.0,17836,195,62,-1556,286,19.5,1574.6,47,5,1,7,4,6,0,0,0,0,17302,6.8,17550,237,53,1556,-286,23.7,1730.2
4494450044,1,16,3,0,1,4,1,0,0,0,0,14899,7.0,18183,228,61,-420,138,22.8,1489.9,20,3,1,4,1,1,2,1,1,0,15319,6.8,18045,234,48,420,-138,23.4,1531.9
4471187696,0,16,3,0,2,6,1,0,0,0,0,13962,6.8,16214,215,28,-1635,-1467,21.5,1396.2,17,3,1,6,2,3,1,0,1,0,15597,7.0,17681,193,50,1635,1467,19.3,1559.7
4524992699,1,18,2,1,7,5,9,1,0,1,0,18010,7.2,19401,239,66,2585,2288,23.9,1801.0,16,5,0,5,7,5,1,1,0,0,15425,6.6,17113,226,45,-2585,-2288,22.6,1542.5
4514102884,0,15,4,0,2,5,2,0,0,0,0,14780,7.0,17765,249,51,-1828,-1146,24.9,1478.0,16,5,1,5,2,6,1,1,0,0,16608,7.2,18911,230,84,1828,1146,23.0,1660.8
4512340309,0,12,2,1,10,9,14,0,0,0,0,18178,7.0,17725,213,34,342,-646,21.3,1817.8,15,1,0,9,10,8,1,1,0,0,17836,7.0,18371,222,54,-342,646,22.2,1783.6
4522659821,0,15,3,0,1,3,2,0,0,0,0,14114,6.8,17618,229,55,-1313,-6,22.9,1411.4,18,2,1,3,1,5,2,1,1,0,15427,6.8,17624,250,48,1313,6,25.0,1542.7
4495172463,1,12,0,0,4,6,5,0,0,0,0,15154,6.6,17363,170,56,-2642,-1908,17.0,1515.4,16,2,1,6,4,7,1,1,0,0,17796,7.2,19271,258,64,2642,1908,25.8,1779.6
4527084361,1,15,4,1,9,6,16,2,1,1,0,17260,6.6,16577,187,49,1006,820,18.7,1726.0,20,2,0,6,9,10,0,0,0,0,16254,6.4,15757,204,44,-1006,-820,20.4,1625.4
4518337349,0,19,1,1,8,11,10,1,0,1,0,17282,7.0,17712,222,48,-1008,-810,22.2,1728.2,16,4,0,11,8,7,1,1,0,0,18290,7.0,18522,220,48,1008,810,22.0,1829.0
4496593867,1,19,0,0,8,5,10,0,0,0,0,16957,7.0,18220,204,55,1484,469,20.4,1695.7,14,4,1,5,8,3,0,0,0,0,15473,6.6,17751,226,35,-1484,-469,22.6,1547.3
4458337524,1,13,4,1,7,7,5,0,0,0,0,17623,7.2,19660,233,68,724,1268,23.3,1762.3,14,2,0,7,7,7,1,1,0,0,16899,7.2,18392,223,56,-724,-1268,22.3,1689.9
4525937822,1,12,7,0,6,7,8,1,1,0,0,17026,7.2,18215,229,48,326,85,22.9,1702.6,18,0,1,7,6,6,0,0,0,0,16700,6.8,18130,217,52,-326,-85,21.7,1670.0
4486718307,0,29,5,0,7,5,9,0,0,0,0,16793,6.8,17671,242,48,620,-226,24.2,1679.3,16,6,1,5,7,7,1,1,0,0,16173,7.0,17897,237,44,-620,226,23.7,1617.3
4521989550,0,13,2,0,4,10,2,0,0,0,0,14774,6.6,16999,214,40,-3032,-2816,21.4,1477.4,37,3,1,10,4,11,2,1,1,0,17806,7.2,19815,215,52,3032,2816,21.5,1780.6
4432115286,0,19,1,1,6,9,8,0,0,0,0,17088,7.2,18768,226,67,-884,963,22.6,1708.8,19,2,0,9,6,15,2,1,1,0,17972,6.8,17805,218,48,884,-963,21.8,1797.2
4517985377,1,15,1,1,8,9,7,0,0,0,0,17697,6.8,16356,208,41,118,-2044,20.8,1769.7,14,2,0,9,8,5,1,1,0,0,17579,7.2,18400,200,59,-118,2044,20.0,1757.9
4438257769,0,12,2,0,5,6,9,1,1,0,0,15011,6.4,15341,173,50,-1071,-1810,17.3,1501.1,19,1,1,6,5,3,0,0,0,0,16082,6.6,17151,226,44,1071,1810,22.6,1608.2
4486920046,0,13,2,0,4,9,3,0,0,0,0,15027,6.6,16491,216,44,-3148,-2107,21.6,1502.7,16,2,1,9,4,9,1,1,0,0,18175,7.0,18598,220,56,3148,2107,22.0,1817.5
4509662137,1,14,0,0,5,8,6,0,0,0,0,15589,7.0,17960,203,43,-2111,-1385,20.3,1558.9,17,1,1,8,5,5,1,1,0,0,17700,7.2,19345,262,68,2111,1385,26.2,1770.0
4525587763,1,13,1,1,9,4,8,0,0,0,0,17260,7.0,19375,197,60,1463,1277,19.7,1726.0,14,2,0,4,9,4,0,0,0,0,15797,7.0,18098,203,52,-1463,-1277,20.3,1579.7
4490273842,1,17,3,1,6,4,5,2,1,1,0,16727,7.2,18834,220,55,613,-602,22.0,1672.7,40,3,0,4,6,3,0,0,0,0,16114,7.4,19436,247,52,-613,602,24.7,1611.4
4468097327,1,20,1,1,11,2,9,1,1,0,0,19527,7.6,20653,237,52,5525,3467,23.7,1952.7,12,2,0,2,11,1,0,0,0,0,14002,6.8,17186,211,52,-5525,-3467,21.1,1400.2
4522131517,0,12,2,0,1,7,1,0,0,0,0,15414,6.8,17341,236,54,-553,-114,23.6,1541.4,17,0,1,7,1,8,0,0,0,0,15967,7.0,17455,194,48,553,114,19.4,1596.7
4518053347,0,20,1,1,12,9,16,1,1,0,0,18345,6.8,17559,222,32,941,-561,22.2,1834.5,15,3,0,9,12,8,1,0,1,0,17404,7.0,18120,207,48,-941,561,20.7,1740.4
4509162427,1,34,3,0,5,5,5,0,0,0,0,16384,7.4,19826,229,61,759,2511,22.9,1638.4,17,2,1,5,5,7,1,1,0,0,15625,6.6,17315,205,55,-759,-2511,20.5,1562.5
4525358270,0,15,2,0,10,15,11,0,0,0,0,17318,7.0,17449,212,52,-3075,-2008,21.2,1731.8,12,4,1,15,10,16,2,1,1,0,20393,7.4,19457,214,52,3075,2008,21.4,2039.3
4521573510,0,15,0,0,2,3,4,0,0,0,0,13761,6.6,16433,187,48,-1400,-2239,18.7,1376.1,13,1,1,3,2,1,1,1,0,0,15161,7.0,18672,247,52,1400,2239,24.7,1516.1
4523758462,1,14,1,1,10,2,8,0,0,0,0,19733,7.6,20862,263,56,5228,3378,26.3,1973.3,13,2,0,2,10,2,1,1,0,0,14505,6.8,17484,210,64,-5228,-3378,21.0,1450.5
4480485955,0,14,2,0,3,5,4,1,0,1,0,14814,6.8,16691,216,39,-3082,-1694,21.6,1481.4,16,1,1,5,3,4,1,1,0,1,17896,6.8,18385,242,57,3082,1694,24.2,1789.6
4526301397,0,10,1,0,3,11,4,0,0,0,0,15145,6.6,16768,200,32,-3472,-3059,20.0,1514.5,102,0,1,11,3,6,1,0,1,0,18617,7.4,19827,227,63,3472,3059,22.7,1861.7
4523954840,0,17,2,0,8,10,10,0,0,0,0,16382,7.2,18090,206,37,-4322,-1588,20.6,1638.2,16,1,1,10,8,8,1,0,1,1,20704,7.2,19678,244,60,4322,1588,24.4,2070.4
4494170863,1,17,1,0,3,5,1,1,1,0,0,14900,6.8,18274,211,68,-2631,-1358,21.1,1490.0,16,3,1,5,3,11,0,0,0,0,17531,7.4,19632,221,78,2631,1358,22.1,1753.1
4510806182,1,14,3,0,6,9,7,1,1,0,0,15843,7.0,16910,206,36,-2292,-810,20.6,1584.3,16,2,1,9,6,11,0,0,0,0,18135,6.8,17720,210,48,2292,810,21.0,1813.5
4507304964,0,16,2,1,5,9,3,1,1,0,0,16182,7.0,17560,204,46,-320,-120,20.4,1618.2,17,0,0,9,5,11,0,0,0,0,16502,7.0,17680,195,36,320,120,19.5,1650.2
4525063445,1,15,2,0,8,8,8,1,0,1,0,16836,6.8,17998,228,49,-52,-301,22.8,1683.6,15,2,1,8,8,12,0,0,0,0,16888,7.0,18299,186,52,52,301,18.6,1688.8
4490677497,0,13,4,0,7,13,3,1,1,0,0,17090,7.0,18662,222,72,-2001,-1137,22.2,1709.0,19,1,1,13,7,20,0,0,0,0,19091,7.6,19799,217,24,2001,1137,21.7,1909.1
4521826058,0,13,3,0,1,4,1,0,0,0,0,14754,6.6,16591,230,44,-1769,-845,23.0,1475.4,21,1,1,4,1,4,0,0,0,1,16523,7.0,17436,224,36,1769,845,22.4,1652.3
4527400475,1,14,2,1,6,5,5,1,1,0,0,17375,7.0,17881,225,55,1825,243,22.5,1737.5,50,4,0,5,6,8,0,0,0,0,15550,7.0,17638,199,44,-1825,-243,19.9,1555.0
4504012663,0,152,4,0,7,6,6,1,1,0,0,16608,7.2,18459,233,60,-26,989,23.3,1660.8,15,2,1,6,7,7,0,0,0,0,16634,6.8,17470,203,52,26,-989,20.3,1663.4
4505385341,1,15,3,1,4,5,3,0,0,0,0,15600,6.8,17354,229,57,-226,-157,22.9,1560.0,41,2,0,5,4,6,0,0,0,0,15826,6.6,17511,191,44,226,157,19.1,1582.6
4484788416,1,39,2,0,7,7,9,0,0,0,0,16391,7.0,17955,209,39,129,230,20.9,1639.1,35,2,1,7,7,5,1,1,0,0,16262,6.6,17725,199,63,-129,-230,19.9,1626.2
4522445853,1,16,4,0,4,6,3,0,0,0,0,15157,6.8,17482,241,24,-549,-805,24.1,1515.7,15,1,1,6,4,3,2,1,1,0,15706,7.0,18287,223,56,549,805,22.3,1570.6
4518053944,0,44,3,0,5,9,4,0,0,0,0,15950,7.0,18040,231,46,-2365,-2046,23.1,1595.0,15,4,1,9,5,6,1,1,0,0,18315,7.4,20086,233,56,2365,2046,23.3,1831.5
4525296321,0,15,0,1,2,4,2,0,0,0,0,15210,6.8,17457,222,45,262,-414,22.2,1521.0,15,1,0,4,2,5,2,1,1,0,14948,7.0,17871,216,46,-262,414,21.6,1494.8
4520653758,0,14,1,1,6,7,11,0,0,0,0,15844,6.8,16801,197,47,-151,-895,19.7,1584.4,17,0,0,7,6,5,2,1,1,0,15995,6.8,17696,205,60,151,895,20.5,1599.5
4460035354,0,16,3,1,4,9,4,0,0,0,0,15122,7.0,17694,195,48,-3223,-2518,19.5,1512.2,12,2,0,9,4,10,2,1,1,0,18345,7.4,20212,235,68,3223,2518,23.5,1834.5
4500506484,1,31,4,1,5,5,10,1,1,0,0,16737,6.8,17553,231,52,272,-467,23.1,1673.7,15,2,0,5,5,8,0,0,0,0,16465,7.0,18020,218,48,-272,467,21.8,1646.5
4449382907,0,13,1,1,4,4,0,0,0,0,0,14727,7.0,17726,197,52,-1012,-1528,19.7,1472.7,14,2,0,4,4,7,1,1,0,0,15739,7.2,19254,238,56,1012,1528,23.8,1573.9
4514234813,0,52,2,0,6,12,7,0,0,0,0,15456,6.6,16280,188,42,-4920,-3280,18.8,1545.6,15,1,1,12,6,11,1,0,1,1,20376,7.4,19560,240,62,4920,3280,24.0,2037.6
4488357361,1,16,5,0,4,8,4,1,0,1,0,15767,7.0,17903,233,52,-953,-677,23.3,1576.7,19,5,1,8,4,8,0,0,0,0,16720,7.0,18580,226,40,953,677,22.6,1672.0
4525215598,1,57,3,0,6,9,6,1,1,0,0,15824,6.6,16324,210,41,-2047,-2330,21.0,1582.4,19,3,1,9,6,8,1,0,1,0,17871,6.8,18654,205,64,2047,2330,20.5,1787.1
4510868167,0,142,4,0,1,8,0,1,1,0,0,13631,6.6,16334,220,48,-3839,-3318,22.0,1363.1,39,2,1,8,1,7,1,0,1,0,17470,7.4,19652,233,55,3839,3318,23.3,1747.0
4448404997,0,15,3,0,5,8,5,0,0,0,0,16550,6.8,17563,204,60,-748,-1865,20.4,1655.0,40,1,1,8,5,9,1,0,1,0,17298,7.2,19428,227,48,748,1865,22.7,1729.8
4457100198,0,38,1,1,5,3,5,0,0,0,0,15999,7.0,18110,211,45,497,-743,21.1,1599.9,14,1,0,3,5,3,0,0,0,0,15502,7.2,18853,229,60,-497,743,22.9,1550.2
4493326882,0,103,6,0,6,10,5,1,1,0,1,16878,7.0,17994,185,64,-2636,-1390,18.5,1687.8,15,6,1,10,6,9,1,0,1,1,19514,7.4,19384,227,55,2636,1390,22.7,1951.4
4524913184,1,17,2,1,6,6,10,0,0,0,0,15947,6.4,16477,221,44,-53,87,22.1,1594.7,14,4,0,6,6,9,1,1,0,0,16000,6.4,16390,203,52,53,-87,20.3,1600.0
4524378471,1,16,5,0,11,10,10,1,1,0,0,18720,7.2,18913,222,44,-438,-669,22.2,1872.0,37,1,1,10,11,12,0,0,0,0,19158,7.2,19582,186,64,438,669,18.6,1915.8
4509576274,0,14,1,1,10,5,9,1,1,0,0,18611,7.6,20169,225,68,2819,3222,22.5,1861.1,17,2,0,5,10,6,0,0,0,0,15792,6.8,16947,211,49,-2819,-3222,21.1,1579.2
4520842972,1,13,2,1,7,4,8,1,1,0,0,17568,7.2,19108,241,56,1975,802,24.1,1756.8,16,1,0,4,7,5,0,0,0,0,15593,7.0,18306,229,48,-1975,-802,22.9,1559.3
4524783374,1,33,2,0,14,10,9,0,0,0,0,18595,7.0,18307,199,48,1543,-21,19.9,1859.5,37,3,1,10,14,8,1,1,0,0,17052,7.0,18328,172,52,-1543,21,17.2,1705.2
4466254312,0,40,0,0,7,8,5,1,1,0,0,16460,7.0,18464,202,59,-1449,-777,20.2,1646.0,14,1,1,8,7,4,1,0,1,0,17909,7.4,19241,236,56,1449,777,23.6,1790.9
4526621303,0,19,1,0,5,5,4,1,0,1,0,15550,6.8,17793,218,43,-1324,-615,21.8,1555.0,16,4,1,5,5,7,1,1,0,0,16874,6.8,18408,257,64,1324,615,25.7,1687.4
4470135007,1,19,2,0,9,6,10,1,1,0,0,17590,7.2,18788,200,56,1783,2066,20.0,1759.0,44,4,1,6,9,6,0,0,0,0,15807,6.8,16722,183,52,-1783,-2066,18.3,1580.7
4454239214,0,16,4,0,3,10,2,0,0,0,0,14032,6.8,16550,193,40,-4782,-3408,19.3,1403.2,17,8,1,10,3,11,1,1,0,0,18814,7.4,19958,245,51,4782,3408,24.5,1881.4
4522178825,1,16,2,1,5,6,5,1,1,0,0,15901,6.8,16965,213,44,324,-409,21.3,1590.1,15,1,0,6,5,6,0,0,0,0,15577,6.6,17374,207,40,-324,409,20.7,1557.7
4450611631,0,18,1,1,9,5,6,1,1,0,0,17384,7.4,19286,235,56,2175,1409,23.5,1738.4,18,8,0,5,9,3,0,0,0,0,15209,7.2,17877,222,44,-2175,-1409,22.2,1520.9
4450237694,1,19,5,1,8,9,9,0,0,0,0,18529,7.2,19610,251,63,1334,656,25.1,1852.9,38,4,0,9,8,11,1,1,0,0,17195,7.0,18954,202,60,-1334,-656,20.2,1719.5
4513778272,0,14,0,1,8,8,8,1,1,0,0,16720,6.8,16905,181,48,-1884,-2885,18.1,1672.0,13,3,0,8,8,4,0,0,0,0,18604,7.4,19790,248,66,1884,2885,24.8,1860.4
4509854436,0,12,3,0,11,14,8,0,0,0,0,18229,7.2,19238,198,48,-1502,-321,19.8,1822.9,12,0,1,14,11,14,1,1,0,0,19731,7.4,19559,186,43,1502,321,18.6,1973.1
4450519397,0,20,7,1,7,4,12,2,1,1,0,16431,6.8,17901,204,54,617,866,20.4,1643.1,19,5,0,4,7,6,0,0,0,0,15814,6.6,17035,236,52,-617,-866,23.6,1581.4
4523291821,0,11,1,1,5,6,5,0,0,0,0,15978,6.8,17338,225,50,455,-1138,22.5,1597.8,15,2,0,6,5,7,0,0,0,0,15523,7.0,18476,191,40,-455,1138,19.1,1552.3
4522459455,0,19,3,1,7,9,8,0,0,0,0,17780,6.6,17456,245,40,474,-775,24.5,1778.0,14,2,0,9,7,10,0,0,0,0,17306,7.0,18231,207,51,-474,775,20.7,1730.6
4491522681,0,14,2,0,3,4,2,0,0,0,0,15369,7.0,17785,221,57,-482,-349,22.1,1536.9,19,6,1,4,3,5,1,1,0,0,15851,7.0,18134,257,56,482,349,25.7,1585.1
4523531334,1,14,2,1,11,8,18,0,0,0,0,19275,7.2,18899,233,58,2711,1931,23.3,1927.5,16,2,0,8,11,15,1,1,0,0,16564,6.8,16968,183,48,-2711,-1931,18.3,1656.4
4470582176,0,33,4,1,8,9,9,0,0,0,0,18026,7.0,17839,198,44,726,-455,19.8,1802.6,17,2,0,9,8,12,0,0,0,0,17300,7.0,18294,186,68,-726,455,18.6,1730.0
4512606539,1,16,2,1,7,3,11,1,1,0,0,17365,6.8,17243,223,56,2208,-313,22.3,1736.5,13,2,0,3,7,6,0,0,0,0,15157,6.8,17556,192,56,-2208,313,19.2,1515.7
4440235143,1,15,3,1,9,8,13,1,0,1,0,18146,6.6,17263,199,40,383,-1655,19.9,1814.6,19,2,0,8,9,10,0,0,0,0,17763,7.4,18918,201,60,-383,1655,20.1,1776.3
4522566957,1,14,4,1,4,4,5,2,1,1,0,16814,7.0,18549,220,70,791,224,22.0,1681.4,16,1,0,4,4,6,0,0,0,0,16023,7.0,18325,228,56,-791,-224,22.8,1602.3
4522265559,1,17,2,0,2,4,2,1,1,0,0,14863,6.8,17436,195,72,-720,432,19.5,1486.3,15,1,1,4,2,4,0,0,0,0,15583,6.8,17004,223,36,720,-432,22.3,1558.3
4516590665,1,10,0,0,5,12,4,1,1,0,0,15708,7.0,17799,219,59,-3205,-2487,21.9,1570.8,15,3,1,12,5,8,1,0,1,1,18913,7.4,20286,231,47,3205,2487,23.1,1891.3
4527637091,0,15,2,0,4,8,2,0,0,0,0,14709,6.6,17092,217,38,-2591,-1250,21.7,1470.9,13,3,1,8,4,10,1,1,0,0,17300,7.2,18342,236,55,2591,1250,23.6,1730.0
4482626954,1,16,3,1,12,1,10,0,0,0,0,18849,7.4,19281,231,43,5077,3251,23.1,1884.9,16,4,0,1,12,0,0,0,0,0,13772,6.6,16030,224,41,-5077,-3251,22.4,1377.2
4506806960,1,15,2,1,11,2,10,1,1,0,0,19528,7.2,19357,234,40,5351,3549,23.4,1952.8,14,2,0,2,11,2,0,0,0,0,14177,6.4,15808,211,50,-5351,-3549,21.1,1417.7
4527082240,1,17,1,1,4,1,5,2,1,1,0,16973,7.2,19798,271,72,2420,2428,27.1,1697.3,12,4,0,1,4,2,0,0,0,0,14553,6.6,17370,247,48,-2420,-2428,24.7,1455.3
4522643294,0,13,13,0,4,9,8,0,0,0,0,15400,6.6,16910,219,34,-2564,-1518,21.9,1540.0,38,1,1,9,4,10,0,0,0,0,17964,6.8,18428,229,56,2564,1518,22.9,1796.4
4516639706,1,13,2,0,2,2,3,0,0,0,0,15397,6.8,17958,247,44,908,-79,24.7,1539.7,16,2,1,2,2,1,2,1,1,0,14489,6.8,18037,221,60,-908,79,22.1,1448.9
4521663948,0,16,3,0,10,5,13,1,1,0,0,18287,7.2,18402,213,52,2242,727,21.3,1828.7,36,1,1,5,10,3,0,0,0,0,16045,6.8,17675,225,47,-2242,-727,22.5,1604.5
4516037651,0,47,1,0,7,5,5,0,0,0,0,16089,6.8,17265,198,45,-490,-217,19.8,1608.9,17,0,1,5,7,4,1,1,0,0,16579,6.8,17482,229,57,490,217,22.9,1657.9
4489166333,0,15,2,1,5,9,3,0,0,0,0,16452,6.6,17540,232,51,-480,353,23.2,1645.2,15,1,0,9,5,10,0,0,0,0,16932,6.8,17187,192,32,480,-353,19.2,1693.2
4460536979,1,12,2,1,12,1,10,1,1,0,0,18048,7.0,19291,185,55,4294,2844,18.5,1804.8,15,0,0,1,12,0,0,0,0,0,13754,6.4,16447,176,68,-4294,-2844,17.6,1375.4
4522833025,0,12,2,1,5,6,3,1,1,0,0,16024,7.0,18727,228,56,-566,-1162,22.8,1602.4,15,4,0,6,5,8,0,0,0,0,16590,7.2,19889,229,55,566,1162,22.9,1659.0
4525540898,1,15,1,1,6,3,7,1,0,1,0,16421,6.4,16972,207,52,936,-497,20.7,1642.1,38,4,0,3,6,3,1,1,0,0,15485,7.2,17469,231,60,-936,497,23.1,1548.5
4525983160,1,11,4,1,11,4,13,1,1,0,0,18866,7.0,18926,225,41,3992,2506,22.5,1886.6,19,1,0,4,11,3,0,0,0,0,14874,6.4,16420,189,45,-3992,-2506,18.9,1487.4
4457232742,1,15,2,1,11,3,13,1,1,0,0,17655,7.2,18905,208,44,1906,1369,20.8,1765.5,13,0,0,3,11,3,0,0,0,0,15749,7.0,17536,221,57,-1906,-1369,22.1,1574.9
4491485082,0,24,3,1,3,2,5,1,0,1,0,14783,6.6,16564,205,54,401,95,20.5,1478.3,18,6,0,2,3,4,1,1,0,0,14382,6.8,16469,209,42,-401,-95,20.9,1438.2
4504703717,0,19,2,1,6,7,7,1,0,1,0,16050,6.8,17391,191,48,-513,-1056,19.1,1605.0,97,4,0,7,6,10,0,0,0,0,16563,6.8,18447,235,36,513,1056,23.5,1656.3
4523326284,1,21,2,1,8,6,9,2,1,1,0,17808,7.0,18545,246,44,2489,1473,24.6,1780.8,17,3,0,6,8,4,0,0,0,0,15319,6.6,17072,191,42,-2489,-1473,19.1,1531.9
4511076108,0,20,2,1,2,4,1,0,0,0,0,14659,6.8,17566,235,45,-1944,-1062,23.5,1465.9,16,1,0,4,2,4,1,0,1,0,16603,7.0,18628,240,62,1944,1062,24.0,1660.3
4492271178,0,17,6,1,3,12,2,1,0,1,0,14683,6.6,16048,215,39,-4600,-3906,21.5,1468.3,18,2,0,12,3,11,0,0,0,0,19283,7.4,19954,209,67,4600,3906,20.9,1928.3
4514465799,0,14,4,1,5,11,3,0,0,0,0,14790,6.6,16593,185,42,-3951,-2608,18.5,1479.0,32,2,0,11,5,15,1,1,0,0,18741,7.2,19201,225,51,3951,2608,22.5,1874.1
4519205334,0,14,2,0,4,8,3,2,1,1,0,14885,6.8,17810,192,59,-4790,-2126,19.2,1488.5,89,2,1,8,4,5,0,0,0,1,19675,7.4,19936,232,67,4790,2126,23.2,1967.5
4477682436,1,11,3,0,4,9,4,0,0,0,0,15233,7.0,17625,220,44,-1121,-858,22.0,1523.3,18,2,1,9,4,6,1,1,0,0,16354,7.0,18483,210,40,1121,858,21.0,1635.4
4520789246,0,11,0,0,5,10,5,0,0,0,0,14740,6.4,15556,156,49,-4229,-4184,15.6,1474.0,16,3,1,10,5,12,1,1,0,0,18969,7.4,19740,220,64,4229,4184,22.0,1896.9
4510825805,1,18,2,1,8,2,13,1,1,0,0,17226,7.2,18501,224,52,3923,3613,22.4,1722.6,14,2,0,2,8,3,0,0,0,0,13303,6.0,14888,183,23,-3923,-3613,18.3,1330.3
4522609707,0,17,4,1,5,3,6,1,1,0,0,16053,7.0,17817,227,52,1614,1179,22.7,1605.3,51,6,0,3,5,4,0,0,0,0,14439,6.6,16638,206,50,-1614,-1179,20.6,1443.9
4526837862,1,14,2,1,4,7,6,1,0,1,0,15289,7.0,16623,210,52,-1041,-1114,21.0,1528.9,10,1,0,7,4,5,1,1,0,0,16330,6.8,17737,196,52,1041,1114,19.6,1633.0
4522526213,0,13,3,0,3,7,2,0,0,0,0,15692,7.0,17807,234,55,-560,476,23.4,1569.2,12,4,1,7,3,4,1,1,0,0,16252,6.8,17331,199,56,560,-476,19.9,1625.2
4525242190,0,19,1,1,4,1,4,1,1,0,0,15224,6.6,17138,218,54,1168,481,21.8,1522.4,15,2,0,1,4,0,0,0,0,0,14056,6.4,16657,231,48,-1168,-481,23.1,1405.6
4469768643,1,11,2,1,10,4,8,0,0,0,0,17596,7.4,19125,211,55,2031,1116,21.1,1759.6,14,3,0,4,10,4,1,0,1,0,15565,7.2,18009,230,39,-2031,-1116,23.0,1556.5
4470320666,1,48,0,0,10,4,10,2,1,1,0,17973,7.2,20040,196,64,2507,3196,19.6,1797.3,17,1,1,4,10,5,0,0,0,0,15466,6.6,16844,209,48,-2507,-3196,20.9,1546.6
4512913824,1,14,5,1,11,5,12,1,1,0,0,18632,7.2,19093,227,44,2907,1175,22.7,1863.2,42,3,0,5,11,8,0,0,0,0,15725,7.0,17918,204,53,-2907,-1175,20.4,1572.5
4466931235,1,22,7,1,9,4,10,1,1,0,0,18132,7.0,18076,228,40,2883,2111,22.8,1813.2,21,4,0,4,9,2,0,0,0,0,15249,6.2,15965,227,36,-2883,-2111,22.7,1524.9
4527181614,1,16,2,1,10,8,10,0,0,0,0,17665,6.8,17473,207,44,753,-587,20.7,1766.5,16,4,0,8,10,6,0,0,0,0,16912,6.8,18060,191,45,-753,587,19.1,1691.2
4513035037,0,26,2,0,3,10,3,0,0,0,0,14983,7.0,17248,203,44,-3217,-1601,20.3,1498.3,12,4,1,10,3,12,2,1,1,0,18200,7.0,18849,223,51,3217,1601,22.3,1820.0
4527466220,0,37,4,0,3,6,3,1,0,1,0,15552,7.0,18535,240,48,-1462,-607,24.0,1555.2,18,0,1,6,3,7,1,1,0,0,17014,7.0,19142,245,54,1462,607,24.5,1701.4
4497858921,0,15,2,1,5,4,4,0,0,0,0,15634,6.8,16355,201,45,71,-359,20.1,1563.4,14,1,0,4,5,4,1,1,0,0,15563,6.8,16714,222,38,-71,359,22.2,1556.3
4497740999,1,22,6,0,8,4,12,1,1,0,0,18232,7.2,18215,228,52,2655,2106,22.8,1823.2,17,4,1,4,8,3,0,0,0,0,15577,6.4,16109,226,36,-2655,-2106,22.6,1557.7
4524067975,0,14,6,0,1,6,1,0,0,0,0,13075,6.4,15488,169,56,-6309,-3115,16.9,1307.5,19,1,1,6,1,5,0,0,0,1,19384,7.2,18603,270,48,6309,3115,27.0,1938.4
4513247424,1,22,3,1,6,7,4,0,0,0,0,16956,7.2,19155,242,61,-172,594,24.2,1695.6,17,3,0,7,6,10,1,1,0,0,17128,7.2,18561,213,61,172,-594,21.3,1712.8
4523302957,0,18,4,1,6,5,3,0,0,0,0,16056,7.0,17480,198,46,810,98,19.8,1605.6,58,5,0,5,6,3,1,1,0,0,15246,6.8,17382,192,58,-810,-98,19.2,1524.6
4452588232,1,12,0,1,7,3,10,1,1,0,0,17822,7.2,19861,237,63,2435,1428,23.7,1782.2,16,2,0,3,7,4,0,0,0,0,15387,6.8,18433,215,62,-2435,-1428,21.5,1538.7
4500435110,1,132,0,0,13,5,8,0,0,0,3,22845,7.4,19608,250,51,8234,6026,25.0,2284.5,24,2,1,5,13,5,0,0,0,0,14611,6.0,13582,158,40,-8234,-6026,15.8,1461.1
4503269239,1,21,4,1,10,3,12,2,1,1,0,18557,7.2,19603,235,47,3848,2704,23.5,1855.7,16,4,0,3,10,3,0,0,0,0,14709,6.6,16899,200,40,-3848,-2704,20.0,1470.9
4509882748,0,16,1,1,7,6,9,0,0,0,0,17048,6.6,16378,227,52,1453,-254,22.7,1704.8,18,1,0,6,7,4,0,0,0,0,15595,6.6,16632,188,53,-1453,254,18.8,1559.5
4415410070,1,19,2,1,2,2,2,1,1,0,0,15430,7.0,18761,246,71,467,-298,24.6,1543.0,11,0,0,2,2,2,0,0,0,0,14963,7.0,19059,236,64,-467,298,23.6,1496.3
4452824789,0,34,3,0,2,7,2,0,0,0,0,14135,6.8,17185,220,37,-2711,-2547,22.0,1413.5,13,2,1,7,2,7,0,0,0,0,16846,7.2,19732,230,58,2711,2547,23.0,1684.6
4515248158,0,14,3,1,2,6,3,0,0,0,0,15584,6.8,17939,234,53,-1037,-1057,23.4,1558.4,15,4,0,6,2,13,0,0,0,0,16621,7.2,18996,222,56,1037,1057,22.2,1662.1
4471229287,0,20,3,0,3,8,5,0,0,0,0,13980,6.2,15030,193,44,-3739,-3541,19.3,1398.0,39,1,1,8,3,9,2,1,1,0,17719,7.2,18571,246,48,3739,3541,24.6,1771.9
4526736580,1,12,3,0,8,7,7,1,1,0,0,16573,6.8,17651,219,38,-438,-634,21.9,1657.3,20,7,1,7,8,7,0,0,0,0,17011,7.2,18285,245,43,438,634,24.5,1701.1
4515763607,0,16,1,0,4,7,1,0,0,0,0,14125,6.6,16758,170,44,-2858,-520,17.0,1412.5,17,0,1,7,4,9,1,1,0,0,16983,7.0,17278,224,48,2858,520,22.4,1698.3
4462003786,0,18,2,1,1,7,1,1,1,0,0,14419,6.2,16385,235,50,-3324,-3139,23.5,1441.9,15,5,0,7,1,7,0,0,0,0,17743,7.4,19524,246,60,3324,3139,24.6,1774.3
4507080672,1,18,2,1,10,5,14,1,1,0,0,17379,7.0,18458,200,52,1138,-7,20.0,1737.9,17,2,0,5,10,3,0,0,0,0,16241,7.0,18465,246,44,-1138,7,24.6,1624.1
4470196498,1,14,1,0,8,11,8,0,0,0,0,16483,6.8,16652,186,50,-1412,-405,18.6,1648.3,14,3,1,11,8,18,1,1,0,0,17895,6.8,17057,208,38,1412,405,20.8,1789.5
4527324320,0,16,5,0,2,13,2,0,0,0,0,13738,6.4,15483,169,52,-6260,-3364,16.9,1373.8,39,4,1,13,2,15,0,0,0,0,19998,7.0,18847,238,34,6260,3364,23.8,1999.8
4525943268,0,17,3,0,7,10,4,0,0,0,0,15970,6.8,17608,196,55,-2046,-691,19.6,1597.0,15,2,1,10,7,10,0,0,0,0,18016,7.0,18299,226,40,2046,691,22.6,1801.6
4525224702,0,15,3,1,4,3,2,1,0,1,0,16408,7.2,19181,263,53,2591,1567,26.3,1640.8,15,2,0,3,4,1,1,1,0,0,13817,6.8,17614,208,35,-2591,-1567,20.8,1381.7
4518005964,0,19,6,1,1,4,1,2,1,1,0,14056,6.6,16260,223,50,-1903,-2537,22.3,1405.6,22,5,0,4,1,3,0,0,0,0,15959,7.0,18797,231,55,1903,2537,23.1,1595.9
4503476155,1,25,4,1,7,9,7,0,0,0,0,16929,7.0,17547,228,41,-1149,-1888,22.8,1692.9,15,3,0,9,7,7,0,0,0,0,18078,7.2,19435,232,50,1149,1888,23.2,1807.8
4456261396,1,70,2,1,8,3,8,1,1,0,0,17166,7.4,20100,208,63,2027,2259,20.8,1716.6,13,4,0,3,8,1,0,0,0,0,15139,6.8,17841,218,48,-2027,-2259,21.8,1513.9
4520923371,0,38,3,1,3,3,6,1,1,0,0,16653,7.0,18507,261,60,1152,-29,26.1,1665.3,15,2,0,3,3,6,0,0,0,0,15501,7.2,18536,228,60,-1152,29,22.8,1550.1
4503188502,1,20,9,1,6,6,6,0,0,0,0,16266,7.0,18203,208,40,1300,127,20.8,1626.6,27,7,0,6,6,4,1,1,0,0,14966,7.2,18076,155,66,-1300,-127,15.5,1496.6
4471038751,1,15,3,1,10,13,14,0,0,0,1,18697,6.8,17238,213,24,-198,-1159,21.3,1869.7,16,4,0,13,10,9,1,0,1,1,18895,6.8,18397,188,64,198,1159,18.8,1889.5
4492577817,0,14,4,1,3,9,2,1,1,0,0,13769,6.2,15094,174,54,-4147,-3023,17.4,1376.9,16,4,0,9,3,7,0,0,0,0,17916,7.0,18117,217,48,4147,3023,21.7,1791.6
4511221654,0,15,2,0,9,16,11,0,0,0,0,17434,7.0,17974,188,43,-3478,-2027,18.8,1743.4,16,3,1,16,9,21,1,1,0,0,20912,7.4,20001,196,52,3478,2027,19.6,2091.2
4497608843,0,39,0,1,9,7,8,0,0,0,0,16969,7.0,18552,181,41,416,936,18.1,1696.9,13,3,0,7,9,4,1,1,0,0,16553,6.8,17616,231,42,-416,-936,23.1,1655.3
4502701964,1,15,10,1,6,5,3,1,0,1,0,17293,7.0,18795,231,60,1339,614,23.1,1729.3,48,4,0,5,6,6,1,1,0,0,15954,7.2,18181,236,48,-1339,-614,23.6,1595.4
4525297517,0,18,4,1,7,8,7,0,0,0,0,16927,6.8,17042,223,42,-498,-861,22.3,1692.7,21,3,0,8,7,7,0,0,0,0,17425,7.0,17903,228,51,498,861,22.8,1742.5
4524368575,0,14,2,0,8,9,5,1,0,1,0,15782,6.8,16191,182,36,-2323,-2444,18.2,1578.2,15,3,1,9,8,8,1,1,0,0,18105,7.0,18635,185,58,2323,2444,18.5,1810.5
4527268691,0,17,2,1,13,8,12,0,0,0,0,18116,6.8,18447,187,40,838,914,18.7,1811.6,36,1,0,8,13,9,2,1,1,0,17278,7.2,17533,204,44,-838,-914,20.4,1727.8
4526546441,0,15,0,0,8,9,1,1,1,0,0,16953,7.0,18996,238,52,-515,649,23.8,1695.3,17,3,1,9,8,11,0,0,0,0,17468,7.2,18347,211,40,515,-649,21.1,1746.8
4518118061,0,18,3,0,13,10,17,0,0,0,0,19372,7.0,18078,201,47,1734,1173,20.1,1937.2,15,2,1,10,13,17,1,1,0,0,17638,6.6,16905,195,40,-1734,-1173,19.5,1763.8
4523435488,1,12,1,0,10,10,9,1,0,1,0,17566,7.2,18896,183,48,-528,-296,18.3,1756.6,13,1,1,10,10,5,1,1,0,0,18094,7.2,19192,228,60,528,296,22.8,1809.4
4524332447,1,18,4,0,5,4,3,1,1,0,0,15296,6.8,16908,187,56,733,810,18.7,1529.6,24,4,1,4,5,1,0,0,0,0,14563,6.2,16098,204,32,-733,-810,20.4,1456.3
4510728488,1,18,2,1,6,4,4,1,1,0,0,17277,7.2,19610,229,54,1687,1089,22.9,1727.7,36,3,0,4,6,5,1,0,1,0,15590,7.2,18521,232,56,-1687,-1089,23.2,1559.0
4527034667,0,17,2,0,8,5,10,1,0,1,0,17812,7.0,19113,234,41,2554,2046,23.4,1781.2,13,3,1,5,8,4,1,1,0,0,15258,6.6,17067,212,35,-2554,-2046,21.2,1525.8
4486453937,0,17,5,0,6,8,5,0,0,0,0,15748,6.6,16524,222,36,-1304,-552,22.2,1574.8,40,6,1,8,6,12,1,1,0,0,17052,6.8,17076,216,46,1304,552,21.6,1705.2
4485854145,0,16,2,0,6,13,7,0,0,0,0,15522,6.8,16999,182,55,-3819,-2264,18.2,1552.2,14,4,1,13,6,16,1,1,0,0,19341,7.2,19263,220,40,3819,2264,22.0,1934.1
4527479839,1,45,1,0,8,7,10,0,0,0,0,16347,6.8,16992,185,40,-559,-794,18.5,1634.7,15,4,1,7,8,4,1,0,1,0,16906,7.0,17786,215,49,559,794,21.5,1690.6
4453471235,1,39,2,0,4,6,4,0,0,0,0,15462,7.2,18980,239,55,-1870,-71,23.9,1546.2,20,2,1,6,4,6,1,1,0,0,17332,7.2,19051,238,60,1870,71,23.8,1733.2
4527682051,1,15,3,0,8,7,6,1,1,0,0,17204,7.0,18534,236,42,1072,1587,23.6,1720.4,14,2,1,7,8,7,0,0,0,0,16132,6.6,16947,222,38,-1072,-1587,22.2,1613.2
4482208801,0,18,0,0,3,5,6,0,0,0,1,16690,6.8,17992,248,48,-1060,-586,24.8,1669.0,43,1,1,5,3,7,2,1,1,1,17750,7.0,18578,214,75,1060,586,21.4,1775.0
4468111504,1,19,1,1,10,6,12,2,1,1,0,17706,7.0,18096,214,41,145,-1102,21.4,1770.6,9,3,0,6,10,8,0,0,0,0,17561,7.0,19198,221,64,-145,1102,22.1,1756.1
4499534916,1,18,4,1,8,1,5,2,1,1,1,19383,7.6,21403,271,59,4656,3776,27.1,1938.3,12,2,0,1,8,0,0,0,0,0,14727,6.8,17627,249,58,-4656,-3776,24.9,1472.7
4517633575,0,12,6,0,1,6,0,0,0,0,0,14625,6.8,17769,241,56,-1299,-49,24.1,1462.5,53,1,1,6,1,3,1,1,0,0,15924,7.0,17818,218,47,1299,49,21.8,1592.4
4527030870,1,35,4,1,9,6,10,2,1,1,1,18768,7.0,19351,200,48,2945,2977,20.0,1876.8,19,2,0,6,9,8,0,0,0,0,15823,6.6,16374,215,43,-2945,-2977,21.5,1582.3
4484473320,1,19,2,1,5,4,5,0,0,0,0,15679,6.6,16202,224,36,812,237,22.4,1567.9,18,6,0,4,5,7,0,0,0,0,14867,6.4,15965,220,36,-812,-237,22.0,1486.7
4520494460,1,39,3,0,4,7,7,1,1,0,0,15240,6.8,17092,196,60,-1080,-1362,19.6,1524.0,13,1,1,7,4,6,0,0,0,0,16320,7.0,18454,220,47,1080,1362,22.0,1632.0
4443689481,1,19,3,1,9,6,8,1,1,0,0,17344,6.8,17484,191,48,992,-609,19.1,1734.4,14,0,0,6,9,6,0,0,0,0,16352,7.0,18093,206,57,-992,609,20.6,1635.2
4513564406,0,19,3,1,9,6,8,1,1,0,0,18161,7.0,19168,213,53,1926,2400,21.3,1816.1,10,3,0,6,9,9,0,0,0,0,16235,6.8,16768,202,29,-1926,-2400,20.2,1623.5
4526423830,0,16,0,1,10,9,10,0,0,0,0,18034,6.8,17170,211,43,1179,-675,21.1,1803.4,16,2,0,9,10,11,0,0,0,0,16855,7.0,17845,222,32,-1179,675,22.2,1685.5
4458512740,1,15,2,1,9,2,13,0,0,0,0,18383,7.0,18694,233,37,4152,1466,23.3,1838.3,15,2,0,2,9,2,1,0,1,0,14231,7.0,17228,213,48,-4152,-1466,21.3,1423.1
4519625285,1,20,1,1,8,4,11,2,1,1,0,17385,6.8,18040,221,56,2745,1478,22.1,1738.5,16,3,0,4,8,6,0,0,0,0,14640,6.6,16562,203,37,-2745,-1478,20.3,1464.0
4519159286,1,15,1,1,3,4,2,1,1,0,0,16120,6.8,17683,223,56,1171,-1140,22.3,1612.0,13,2,0,4,3,3,0,0,0,0,14949,7.2,18823,207,46,-1171,1140,20.7,1494.9
4469758473,1,16,2,1,9,3,10,1,1,0,1,20273,7.2,19742,254,51,4982,1971,25.4,2027.3,39,0,0,3,9,4,0,0,0,0,15291,6.8,17771,195,74,-4982,-1971,19.5,1529.1
4517863926,1,15,2,1,6,4,12,2,1,1,0,17784,7.0,17328,223,48,1500,-1268,22.3,1778.4,15,1,0,4,6,6,0,0,0,0,16284,7.2,18596,233,72,-1500,1268,23.3,1628.4
4513054985,0,13,2,1,5,7,6,0,0,0,0,15747,6.8,17503,192,41,-1123,-1230,19.2,1574.7,14,2,0,7,5,6,1,1,0,0,16870,7.0,18733,227,59,1123,1230,22.7,1687.0
4496705148,1,18,3,1,7,3,7,0,0,0,0,17150,7.2,19389,225,60,1443,2143,22.5,1715.0,17,2,0,3,7,5,0,0,0,0,15707,6.8,17246,229,44,-1443,-2143,22.9,1570.7
4525139840,1,16,3,1,10,4,13,0,0,0,0,17408,7.2,18740,193,47,2366,1147,19.3,1740.8,14,4,0,4,10,5,1,1,0,0,15042,6.8,17593,231,44,-2366,-1147,23.1,1504.2
4522859365,1,16,5,0,9,2,16,1,1,0,0,18984,7.4,20083,254,54,4620,2871,25.4,1898.4,16,2,1,2,9,3,0,0,0,0,14364,6.6,17212,171,59,-4620,-2871,17.1,1436.4
4508120759,1,18,2,1,9,3,9,1,1,0,0,18582,7.6,19702,243,51,3881,3409,24.3,1858.2,11,4,0,3,9,4,0,0,0,0,14701,6.6,16293,217,40,-3881,-3409,21.7,1470.1
4517524555,1,15,2,1,2,0,1,0,0,0,0,15486,7.0,18701,251,68,1386,1830,25.1,1548.6,18,3,0,0,2,0,0,0,0,0,14100,6.4,16871,234,54,-1386,-1830,23.4,1410.0
4460980858,0,14,4,0,4,7,4,0,0,0,0,14630,6.4,16426,188,59,-1976,-2992,18.8,1463.0,19,1,1,7,4,7,1,1,0,0,16606,7.4,19418,230,49,1976,2992,23.0,1660.6
4502754210,1,18,1,1,10,8,6,0,0,0,1,19353,6.8,18423,223,60,3458,3204,22.3,1935.3,13,4,0,8,10,13,0,0,0,0,15895,6.2,15219,163,48,-3458,-3204,16.3,1589.5
4499849238,1,24,3,0,8,6,7,2,1,1,0,17527,7.2,19414,236,64,1625,1945,23.6,1752.7,16,2,1,6,8,2,0,0,0,0,15902,6.8,17469,208,52,-1625,-1945,20.8,1590.2
4519148589,0,105,5,1,8,6,13,1,1,0,0,17474,6.8,17436,217,53,1320,-413,21.7,1747.4,65,3,0,6,8,11,0,0,0,0,16154,6.8,17849,223,40,-1320,413,22.3,1615.4
4466552109,0,26,1,1,3,5,3,1,1,0,0,15043,6.8,17227,225,47,-1591,-1829,22.5,1504.3,15,2,0,5,3,4,1,0,1,0,16634,7.4,19056,236,52,1591,1829,23.6,1663.4
4452201690,0,15,1,1,7,7,8,0,0,0,0,16432,6.8,16967,191,36,367,-1025,19.1,1643.2,32,2,0,7,7,7,1,1,0,0,16065,7.0,17992,212,47,-367,1025,21.2,1606.5
4500599044,0,89,3,0,7,5,8,1,0,1,0,16269,7.2,18306,202,52,459,1388,20.2,1626.9,16,2,1,5,7,8,1,1,0,0,15810,6.6,16918,212,44,-459,-1388,21.2,1581.0
4495602033,0,18,1,0,7,8,8,0,0,0,0,17472,6.8,18276,229,52,-214,-356,22.9,1747.2,13,3,1,8,7,9,2,1,1,0,17686,7.0,18632,211,52,214,356,21.1,1768.6
4523558547,0,17,3,1,9,6,7,0,0,0,0,17187,7.0,18178,213,40,626,98,21.3,1718.7,14,1,0,6,9,4,0,0,0,0,16561,7.0,18080,231,40,-626,-98,23.1,1656.1
4527044244,0,16,1,0,3,5,2,0,0,0,0,15314,7.0,17971,226,45,-888,1328,22.6,1531.4,15,2,1,5,3,3,1,0,1,0,16202,6.8,16643,220,37,888,-1328,22.0,1620.2
4503020882,1,14,4,1,7,5,11,1,1,0,0,17650,7.0,18670,243,67,2518,2382,24.3,1765.0,14,2,0,5,7,8,0,0,0,0,15132,6.6,16288,196,32,-2518,-2382,19.6,1513.2
4519382005,0,18,1,1,11,7,7,0,0,0,0,18197,7.0,18621,205,46,1470,1240,20.5,1819.7,11,2,0,7,11,7,1,1,0,0,16727,6.8,17381,206,58,-1470,-1240,20.6,1672.7
4459901632,1,31,2,1,6,4,7,0,0,0,0,17200,7.2,18984,235,59,2208,1929,23.5,1720.0,20,1,0,4,6,5,0,0,0,0,14992,6.6,17055,215,40,-2208,-1929,21.5,1499.2
4458619259,0,16,3,0,3,9,2,0,0,0,0,14861,6.8,16993,225,38,-3337,-1701,22.5,1486.1,30,3,1,9,3,10,0,0,0,0,18198,7.2,18694,223,51,3337,1701,22.3,1819.8
4485980330,1,15,6,0,2,6,2,0,0,0,0,16241,7.2,18365,236,57,250,942,23.6,1624.1,38,0,1,6,2,8,1,1,0,0,15991,6.8,17423,196,56,-250,-942,19.6,1599.1
4525813376,0,53,5,0,5,11,5,0,0,0,0,15189,7.0,17359,195,48,-4907,-2701,19.5,1518.9,18,3,1,11,5,8,1,1,0,1,20096,7.4,20060,250,51,4907,2701,25.0,2009.6
4477061244,1,13,2,1,9,5,8,0,0,0,0,18564,7.2,19783,212,60,2005,2005,21.2,1856.4,12,1,0,5,9,7,0,0,0,0,16559,7.2,17778,236,44,-2005,-2005,23.6,1655.9
4494587066,0,14,1,0,6,7,7,1,0,1,1,17927,6.8,18100,213,45,396,-1813,21.3,1792.7,36,2,1,7,6,8,1,1,0,0,17531,7.4,19913,229,73,-396,1813,22.9,1753.1
4495323290,1,16,1,0,4,3,6,1,0,1,0,15164,7.0,17014,216,51,-185,-1101,21.6,1516.4,12,3,1,3,4,1,1,1,0,0,15349,7.2,18115,233,68,185,1101,23.3,1534.9
4467505832,0,16,0,0,5,11,10,0,0,0,0,16476,7.0,17056,215,52,-1221,-214,21.5,1647.6,14,2,1,11,5,18,1,1,0,0,17697,6.6,17270,186,50,1221,214,18.6,1769.7
4514341381,0,15,0,0,2,10,2,0,0,0,0,13550,6.4,15932,183,30,-4770,-3411,18.3,1355.0,41,1,1,10,2,7,1,1,0,0,18320,7.4,19343,236,56,4770,3411,23.6,1832.0
4522113197,0,13,2,1,3,4,1,1,1,0,0,14664,6.8,16863,218,41,-1770,-1276,21.8,1466.4,18,2,0,4,3,4,1,0,1,0,16434,7.0,18139,219,63,1770,1276,21.9,1643.4
4483692276,1,15,2,1,6,5,7,1,0,1,0,17674,7.2,19752,225,80,2521,3096,22.5,1767.4,56,1,0,5,6,8,0,0,0,0,15153,6.6,16656,217,36,-2521,-3096,21.7,1515.3
4474739496,1,15,5,1,8,4,10,1,1,0,0,17640,7.0,18174,207,55,4035,3311,20.7,1764.0,51,3,0,4,8,9,0,0,0,0,13605,6.0,14863,155,40,-4035,-3311,15.5,1360.5
4478188896,1,20,2,1,6,4,5,1,1,0,0,16588,7.2,19189,229,62,1782,1959,22.9,1658.8,17,2,0,4,6,1,1,0,1,0,14806,6.8,17230,189,44,-1782,-1959,18.9,1480.6
4514417841,1,15,2,1,5,3,5,1,0,1,0,16153,6.8,17913,227,35,1184,-80,22.7,1615.3,42,3,0,3,5,3,1,1,0,0,14969,7.0,17993,208,70,-1184,80,20.8,1496.9
4523070101,1,15,4,0,5,5,10,1,1,0,0,15871,7.0,18125,219,43,1007,1105,21.9,1587.1,16,1,1,5,5,8,1,0,1,0,14864,6.8,17020,164,43,-1007,-1105,16.4,1486.4
4483174323,1,33,2,1,10,2,13,0,0,0,0,18715,7.2,19675,226,67,4058,3407,22.6,1871.5,14,1,0,2,10,2,0,0,0,0,14657,6.6,16268,229,44,-4058,-3407,22.9,1465.7
4502093227,0,41,2,0,2,5,1,0,0,0,0,14449,6.4,16336,220,45,-1979,-338,22.0,1444.9,16,13,1,5,2,8,1,1,0,0,16428,6.8,16674,186,68,1979,338,18.6,1642.8
4482256172,1,23,1,0,3,7,3,0,0,0,0,15277,6.8,17286,234,52,-2105,-88,23.4,1527.7,18,4,1,7,3,15,1,1,0,0,17382,7.0,17374,191,54,2105,88,19.1,1738.2
4525231253,0,14,5,1,3,7,2,1,1,0,0,14961,6.6,16723,220,55,-2212,-2725,22.0,1496.1,41,4,0,7,3,5,0,0,0,0,17173,7.4,19448,235,56,2212,2725,23.5,1717.3
4521127128,0,18,1,0,6,7,7,1,0,1,0,16450,7.0,18541,238,48,-702,-89,23.8,1645.0,12,2,1,7,6,10,1,1,0,0,17152,7.0,18630,226,47,702,89,22.6,1715.2
4516839645,1,17,0,1,6,8,6,0,0,0,0,16273,7.0,17751,193,55,-1115,-883,19.3,1627.3,16,4,0,8,6,7,1,1,0,0,17388,7.2,18634,208,72,1115,883,20.8,1738.8
4527002962,1,23,1,0,2,6,1,1,1,0,0,14087,6.4,16178,217,44,-1808,-1818,21.7,1408.7,17,3,1,6,2,7,0,0,0,0,15895,7.2,17996,183,50,1808,1818,18.3,1589.5
4505621420,0,16,1,0,3,7,2,1,0,1,1,16532,6.8,18522,245,52,151,878,24.5,1653.2,41,6,1,7,3,9,1,1,0,0,16381,7.0,17644,215,40,-151,-878,21.5,1638.1
4498150653,1,26,3,0,10,6,10,0,0,0,0,19488,7.4,20329,230,67,4492,3211,23.0,1948.8,12,0,1,6,10,3,1,1,0,0,14996,6.8,17118,181,45,-4492,-3211,18.1,1499.6
4484243751,0,38,2,0,5,9,3,1,1,0,0,15278,6.4,16785,186,43,-1993,-2178,18.6,1527.8,17,3,1,9,5,5,0,0,0,0,17271,7.0,18963,211,49,1993,2178,21.1,1727.1
4504653278,1,27,3,1,9,1,12,1,1,0,0,18329,7.6,20471,225,63,4973,3174,22.5,1832.9,38,2,0,1,9,0,0,0,0,0,13356,6.8,17297,199,36,-4973,-3174,19.9,1335.6
4476043495,1,14,2,0,8,6,9,0,0,0,0,16694,6.8,17192,227,32,370,92,22.7,1669.4,32,4,1,6,8,6,1,1,0,0,16324,6.8,17100,213,48,-370,-92,21.3,1632.4
4518066287,1,12,3,0,6,14,9,0,0,0,0,16284,6.6,16793,208,52,-3235,-2207,20.8,1628.4,22,1,1,14,6,11,2,1,1,0,19519,6.8,19000,215,44,3235,2207,21.5,1951.9
4460355612,0,33,1,0,10,7,11,1,0,1,1,19186,7.2,18375,183,51,1377,795,18.3,1918.6,14,2,1,7,10,8,1,1,0,0,17809,7.0,17580,201,52,-1377,-795,20.1,1780.9
4514301047,0,35,1,0,5,9,5,0,0,0,0,14997,6.6,16532,196,40,-2865,-1441,19.6,1499.7,16,4,1,9,5,7,1,1,0,0,17862,6.8,17973,237,32,2865,1441,23.7,1786.2
4524902053,0,13,1,1,2,6,4,0,0,0,0,14796,6.4,16514,225,50,-2944,-2835,22.5,1479.6,16,0,0,6,2,7,1,1,0,0,17740,7.2,19349,231,49,2944,2835,23.1,1774.0
4477758358,0,15,5,0,6,6,7,0,0,0,0,15800,6.8,17954,203,48,-966,111,20.3,1580.0,19,3,1,6,6,7,0,0,0,0,16766,7.0,17843,220,47,966,-111,22.0,1676.6
4497616954,1,12,5,0,5,2,3,1,1,0,0,16226,7.0,18917,250,56,2229,2851,25.0,1622.6,15,3,1,2,5,2,0,0,0,0,13997,6.4,16066,197,40,-2229,-2851,19.7,1399.7
4515356970,1,18,4,0,8,7,4,0,0,0,0,16935,7.0,18740,210,60,469,1328,21.0,1693.5,17,6,1,7,8,12,0,0,0,0,16466,7.0,17412,212,32,-469,-1328,21.2,1646.6
4486240093,1,18,1,1,8,1,13,1,1,0,0,18078,6.8,18559,247,50,5354,4695,24.7,1807.8,15,4,0,1,8,0,0,0,0,0,12724,6.0,13864,166,46,-5354,-4695,16.6,1272.4
4496867693,0,37,5,0,2,9,0,0,0,0,0,14321,6.8,16982,208,44,-4557,-3571,20.8,1432.1,20,1,1,9,2,8,0,0,0,0,18878,7.2,20553,260,59,4557,3571,26.0,1887.8
4526718235,1,10,5,0,16,13,16,2,1,1,0,19437,7.0,18500,188,32,546,680,18.8,1943.7,15,1,1,13,16,10,0,0,0,0,18891,7.0,17820,191,52,-546,-680,19.1,1889.1
4459957549,1,16,2,0,7,5,7,0,0,0,0,17212,7.0,18257,225,60,559,-140,22.5,1721.2,13,2,1,5,7,7,1,1,0,0,16653,7.0,18397,225,60,-559,140,22.5,1665.3
4488211195,0,14,4,1,5,6,3,0,0,0,0,15899,6.8,17722,232,47,-903,-1584,23.2,1589.9,33,5,0,6,5,7,1,1,0,0,16802,7.2,19306,249,45,903,1584,24.9,1680.2
4475435726,1,16,4,0,5,3,9,2,1,1,0,16457,7.0,17837,228,68,1418,716,22.8,1645.7,18,4,1,3,5,2,0,0,0,0,15039,6.4,17121,238,40,-1418,-716,23.8,1503.9
4524954902,0,14,9,0,6,8,10,0,0,0,0,16172,6.8,18147,189,60,-1257,333,18.9,1617.2,19,4,1,8,6,11,1,1,0,0,17429,7.0,17814,226,36,1257,-333,22.6,1742.9
4497591005,1,23,0,0,6,10,4,0,0,0,0,15895,6.6,16900,222,44,-1664,-602,22.2,1589.5,19,2,1,10,6,10,1,1,0,0,17559,7.0,17502,218,45,1664,602,21.8,1755.9
4508316147,1,21,3,1,7,4,7,1,1,0,0,17247,7.0,18201,223,48,2145,870,22.3,1724.7,15,4,0,4,7,5,0,0,0,0,15102,6.8,17331,231,29,-2145,-870,23.1,1510.2
4500339262,1,12,2,1,7,4,7,1,0,1,0,18821,7.2,19339,259,68,4074,2842,25.9,1882.1,13,1,0,4,7,6,0,0,0,0,14747,6.4,16497,189,36,-4074,-2842,18.9,1474.7
4515343206,1,17,3,1,12,11,10,0,0,0,0,18882,7.2,19357,224,56,291,839,22.4,1888.2,20,3,0,11,12,13,0,0,0,0,18591,6.8,18518,222,38,-291,-839,22.2,1859.1
4524587710,1,36,3,0,9,9,10,1,0,1,0,17308,6.8,16585,209,48,832,-504,20.9,1730.8,15,1,1,9,9,6,1,1,0,0,16476,6.6,17089,183,56,-832,504,18.3,1647.6
4444307438,0,15,3,0,4,9,6,0,0,0,0,14605,6.6,16395,181,40,-3921,-3284,18.1,1460.5,18,2,1,9,4,12,1,1,0,0,18526,7.0,19679,242,50,3921,3284,24.2,1852.6
4495664229,1,48,0,1,3,7,7,0,0,0,0,14887,6.6,16190,214,48,-1725,-2004,21.4,1488.7,17,5,0,7,3,6,1,1,0,0,16612,6.8,18194,242,48,1725,2004,24.2,1661.2
4455545387,0,14,1,0,3,11,4,0,0,0,0,14341,6.6,16688,184,64,-5295,-3863,18.4,1434.1,18,3,1,11,3,10,1,1,0,0,19636,7.6,20551,260,64,5295,3863,26.0,1963.6
4522633983,1,17,2,1,8,4,8,1,1,0,0,18208,7.2,19824,248,56,4538,3618,24.8,1820.8,10,0,0,4,8,1,0,0,0,0,13670,6.4,16206,176,51,-4538,-3618,17.6,1367.0
4518612412,1,19,4,1,7,3,10,0,0,0,0,17379,7.6,20465,265,64,1524,2071,26.5,1737.9,18,5,0,3,7,7,1,1,0,0,15855,7.0,18394,268,60,-1524,-2071,26.8,1585.5
4478702787,0,21,5,0,5,9,3,1,1,0,0,15832,6.6,17750,229,60,-2174,-325,22.9,1583.2,22,6,1,9,5,11,0,0,0,0,18006,7.0,18075,221,39,2174,325,22.1,1800.6
4459896509,0,44,2,1,7,5,3,2,1,1,0,16066,6.8,17944,224,50,-1247,400,22.4,1606.6,15,3,0,5,7,3,0,0,0,1,17313,6.8,17544,225,55,1247,-400,22.5,1731.3
4511070503,1,14,1,1,4,5,3,1,1,0,0,15698,7.4,18966,214,64,-544,671,21.4,1569.8,12,2,0,5,4,5,0,0,0,0,16242,6.8,18295,238,44,544,-671,23.8,1624.2
4517041040,0,16,3,1,1,7,1,0,0,0,0,13886,6.6,15720,222,36,-3413,-3079,22.2,1388.6,18,3,0,7,1,3,1,1,0,0,17299,7.2,18799,245,46,3413,3079,24.5,1729.9
4496837103,0,13,2,0,2,7,3,1,0,1,0,14624,6.8,16881,210,57,-2089,537,21.0,1462.4,39,5,1,7,2,10,0,0,0,0,16713,6.6,16344,215,38,2089,-537,21.5,1671.3
4517910135,0,40,3,0,4,10,4,1,1,0,0,15494,6.8,17574,211,44,-2846,-2039,21.1,1549.4,13,5,1,10,4,12,0,0,0,0,18340,7.4,19613,213,44,2846,2039,21.3,1834.0
4525797575,0,16,1,0,7,10,8,0,0,0,0,16900,6.8,16827,161,47,-1920,-3055,16.1,1690.0,17,5,1,10,7,8,1,1,0,0,18820,7.2,19882,225,70,1920,3055,22.5,1882.0
4506216514,1,57,2,1,4,2,5,1,1,0,0,16647,7.4,20048,240,84,2179,2663,24.0,1664.7,39,2,0,2,4,1,0,0,0,0,14468,6.8,17385,226,44,-2179,-2663,22.6,1446.8
4437156744,0,26,1,0,5,13,6,1,1,0,0,15558,6.4,16462,203,47,-3180,-3271,20.3,1555.8,35,5,1,13,5,14,0,0,0,0,18738,7.4,19733,218,34,3180,3271,21.8,1873.8
4524888423,1,22,3,0,10,3,15,1,1,0,0,18488,7.4,19504,224,49,3096,2404,22.4,1848.8,152,5,1,3,10,2,0,0,0,0,15392,6.8,17100,210,54,-3096,-2404,21.0,1539.2
4437860358,0,26,5,1,10,6,23,0,0,0,0,17482,6.8,17024,206,38,1875,-622,20.6,1748.2,17,4,0,6,10,6,1,1,0,0,15607,6.8,17646,179,60,-1875,622,17.9,1560.7
4520613547,0,16,3,1,4,9,5,0,0,0,0,16500,7.0,18352,249,50,-981,-1105,24.9,1650.0,10,3,0,9,4,10,2,1,1,0,17481,7.2,19457,193,61,981,1105,19.3,1748.1
4525621331,0,19,4,0,9,6,10,0,0,0,0,17719,7.0,18085,215,44,618,-308,21.5,1771.9,15,4,1,6,9,7,1,1,0,0,17101,7.2,18393,213,84,-618,308,21.3,1710.1
4464799134,1,19,4,1,12,5,9,0,0,0,0,19143,7.4,20064,243,36,3469,3684,24.3,1914.3,18,3,0,5,12,8,1,1,0,0,15674,6.6,16380,199,47,-3469,-3684,19.9,1567.4
4493419814,1,12,0,1,9,10,13,1,0,1,0,17665,6.8,18891,211,44,-1426,-272,21.1,1766.5,15,0,0,10,9,14,1,1,0,0,19091,7.2,19163,214,64,1426,272,21.4,1909.1
4492179998,0,15,2,0,4,7,3,1,1,0,0,14622,6.6,17798,176,67,-2542,-388,17.6,1462.2,15,3,1,7,4,10,0,0,0,0,17164,7.0,18186,238,48,2542,388,23.8,1716.4
4455587892,1,39,1,1,7,4,3,0,0,0,0,17399,7.4,20087,245,60,2105,2310,24.5,1739.9,22,14,0,4,7,5,0,0,0,0,15294,7.0,17777,205,52,-2105,-2310,20.5,1529.4
4439408623,1,19,0,0,1,2,1,1,1,0,0,14862,7.0,18359,237,56,9,-172,23.7,1486.2,13,2,1,2,1,2,1,0,1,0,14853,7.2,18531,199,80,-9,172,19.9,1485.3
4520490742,0,20,4,1,5,8,7,1,1,0,0,14566,5.8,13119,164,37,-2663,-2578,16.4,1456.6,16,3,0,8,5,14,0,0,0,0,17229,6.6,15697,209,42,2663,2578,20.9,1722.9
4519438725,1,10,1,1,5,6,9,1,1,0,0,15822,7.0,17481,219,48,-1572,-2164,21.9,1582.2,24,1,0,6,5,3,1,0,1,0,17394,7.2,19645,248,56,1572,2164,24.8,1739.4
4484792751,0,157,2,1,6,8,4,2,1,1,0,16385,6.6,17327,215,58,-219,-589,21.5,1638.5,14,1,0,8,6,15,0,0,0,0,16604,6.8,17916,199,48,219,589,19.9,1660.4
4475232216,0,14,2,1,3,4,3,1,0,1,0,14986,6.4,16975,229,53,-495,-724,22.9,1498.6,16,1,0,4,3,4,1,1,0,0,15481,7.0,17699,246,42,495,724,24.6,1548.1
4450814847,0,16,3,1,9,3,8,0,0,0,0,17997,7.6,20432,210,56,3087,2543,21.0,1799.7,40,2,0,3,9,4,1,1,0,0,14910,7.2,17889,225,60,-3087,-2543,22.5,1491.0
4472905174,1,17,3,1,6,3,4,1,1,0,0,16404,7.0,19029,246,43,736,1019,24.6,1640.4,15,3,0,3,6,4,0,0,0,0,15668,6.8,18010,203,73,-736,-1019,20.3,1566.8
4521969261,1,11,0,1,5,6,4,1,1,0,0,15548,7.0,18653,181,68,-1238,-1708,18.1,1554.8,17,1,0,6,5,5,0,0,0,0,16786,7.4,20361,219,60,1238,1708,21.9,1678.6
4517169026,1,11,1,1,11,5,12,2,1,1,1,19696,7.2,18881,222,48,3802,1762,22.2,1969.6,21,0,0,5,11,6,0,0,0,0,15894,6.8,17119,209,60,-3802,-1762,20.9,1589.4
4499662774,1,38,4,1,10,9,18,0,0,0,0,18720,7.2,19060,232,30,520,897,23.2,1872.0,17,3,0,9,10,9,2,1,1,0,18200,7.0,18163,202,64,-520,-897,20.2,1820.0
4515929191,0,17,5,0,5,10,5,0,0,0,0,15668,6.8,16531,183,60,-4404,-3165,18.3,1566.8,17,2,1,10,5,9,1,1,0,0,20072,7.2,19696,256,48,4404,3165,25.6,2007.2
4491140067,0,15,3,1,9,3,14,0,0,0,0,18017,7.0,18434,208,40,2917,930,20.8,1801.7,18,4,0,3,9,1,0,0,0,0,15100,6.8,17504,210,54,-2917,-930,21.0,1510.0
4522165350,0,12,2,1,6,5,8,0,0,0,0,16455,7.2,18248,214,50,-614,-1330,21.4,1645.5,36,4,0,5,6,5,2,1,1,0,17069,7.4,19578,243,73,614,1330,24.3,1706.9
4514246517,0,14,2,0,3,6,3,0,0,0,0,15049,6.8,17845,200,47,-964,-271,20.0,1504.9,18,1,1,6,3,4,2,1,1,0,16013,7.0,18116,196,46,964,271,19.6,1601.3
4522541214,1,14,3,0,8,4,8,0,0,0,0,17938,7.2,18237,232,48,3072,1589,23.2,1793.8,15,2,1,4,8,4,1,1,0,0,14866,6.8,16648,207,42,-3072,-1589,20.7,1486.6
4462463336,0,11,6,1,5,15,5,1,1,0,0,16275,7.0,17526,199,64,-4202,-3846,19.9,1627.5,19,4,0,15,5,9,0,0,0,0,20477,7.8,21372,248,44,4202,3846,24.8,2047.7
4519903713,0,33,2,0,4,11,5,1,1,0,0,15788,6.6,17331,223,52,-3084,-3141,22.3,1578.8,11,0,1,11,4,9,0,0,0,0,18872,7.6,20472,230,64,3084,3141,23.0,1887.2
4512536744,0,20,7,1,5,5,3,0,0,0,0,16098,7.0,17950,244,47,65,351,24.4,1609.8,17,8,0,5,5,9,0,0,0,0,16033,6.6,17599,208,63,-65,-351,20.8,1603.3
4509798845,0,12,2,1,7,10,14,1,0,1,0,15674,6.4,16123,176,53,-3579,-3233,17.6,1567.4,14,3,0,10,7,18,1,1,0,0,19253,7.2,19356,203,65,3579,3233,20.3,1925.3
4517836453,1,12,5,1,3,7,3,0,0,0,0,15159,6.6,17052,235,60,-1984,-1530,23.5,1515.9,18,2,0,7,3,16,1,1,0,0,17143,6.8,18582,238,47,1984,1530,23.8,1714.3
4527598275,0,54,3,0,7,8,10,0,0,0,0,16238,6.8,17694,202,50,-982,1441,20.2,1623.8,11,4,1,8,7,10,1,1,0,0,17220,6.6,16253,185,64,982,-1441,18.5,1722.0
4497564028,1,20,6,0,13,2,13,1,0,1,0,19969,7.2,19752,255,55,6763,6488,25.5,1996.9,15,2,1,2,13,2,0,0,0,0,13206,5.8,13264,192,32,-6763,-6488,19.2,1320.6
4511489800,1,37,2,1,10,8,16,1,0,1,0,19376,7.2,19330,241,35,2068,1158,24.1,1937.6,11,0,0,8,10,7,0,0,0,0,17308,6.8,18172,204,49,-2068,-1158,20.4,1730.8
4521752962,1,29,3,1,7,5,5,2,1,1,0,16426,7.0,18407,222,55,-108,59,22.2,1642.6,14,4,0,5,7,4,0,0,0,0,16534,6.8,18348,247,44,108,-59,24.7,1653.4
4484466757,1,9,3,0,8,1,9,1,1,0,0,19331,7.4,20193,254,62,5885,4652,25.4,1933.1,15,0,1,1,8,0,0,0,0,0,13446,6.4,15541,169,59,-5885,-4652,16.9,1344.6
4519547868,1,38,3,0,10,10,12,2,1,1,1,19197,7.2,18709,222,51,1167,-431,22.2,1919.7,16,4,1,10,10,6,0,0,0,0,18030,7.2,19140,219,56,-1167,431,21.9,1803.0
4489770592,0,17,3,0,6,9,4,0,0,0,0,15136,7.0,18082,170,67,-3212,-786,17.0,1513.6,81,6,1,9,6,9,1,1,0,0,18348,7.0,18868,227,52,3212,786,22.7,1834.8
4525339465,0,17,2,0,5,7,8,0,0,0,0,16208,7.0,18110,218,54,-1656,-1363,21.8,1620.8,12,3,1,7,5,7,1,1,0,0,17864,7.2,19473,242,73,1656,1363,24.2,1786.4
4515287778,1,16,2,1,4,6,4,0,0,0,0,16131,7.0,17990,242,57,-207,-1282,24.2,1613.1,16,3,0,6,4,3,1,0,1,0,16338,7.2,19272,223,65,207,1282,22.3,1633.8
4522494083,1,15,3,1,12,5,13,0,0,0,0,19835,7.4,19690,223,48,4675,3054,22.3,1983.5,13,2,0,5,12,5,1,1,0,0,15160,6.8,16636,169,48,-4675,-3054,16.9,1516.0
4520631494,1,13,14,1,6,2,3,0,0,0,0,16807,7.4,19637,222,57,1295,1167,22.2,1680.7,62,2,0,2,6,2,1,1,0,0,15512,7.2,18470,237,60,-1295,-1167,23.7,1551.2
4507750551,1,14,3,1,8,2,8,0,0,0,0,17055,7.0,17638,225,34,2603,1105,22.5,1705.5,19,2,0,2,8,0,1,1,0,0,14452,6.8,16533,238,44,-2603,-1105,23.8,1445.2
4526326638,0,84,3,1,5,7,4,1,1,0,0,16605,7.0,17961,207,69,31,-189,20.7,1660.5,17,2,0,7,5,7,0,0,0,0,16574,7.0,18150,207,63,-31,189,20.7,1657.4
4471977008,1,15,4,0,5,6,3,1,1,0,0,16298,7.4,19831,231,64,96,2988,23.1,1629.8,17,2,1,6,5,8,0,0,0,0,16202,6.6,16843,201,44,-96,-2988,20.1,1620.2
4522858469,1,15,2,0,10,3,10,0,0,0,0,17264,7.4,19660,230,36,2474,2494,23.0,1726.4,13,4,1,3,10,2,0,0,0,0,14790,6.8,17166,230,51,-2474,-2494,23.0,1479.0
4480361494,0,19,5,0,8,7,14,0,0,0,0,17758,6.8,17663,233,55,920,-386,23.3,1775.8,16,3,1,7,8,5,1,1,0,0,16838,6.8,18049,214,63,-920,386,21.4,1683.8
4517807085,1,17,1,1,6,3,7,1,0,1,1,17299,6.6,17431,223,36,1870,-729,22.3,1729.9,14,5,0,3,6,4,1,1,0,0,15429,7.0,18160,226,60,-1870,729,22.6,1542.9
4439650627,0,11,3,0,3,8,4,0,0,0,0,14099,6.4,15839,200,32,-4496,-4428,20.0,1409.9,18,3,1,8,3,10,2,1,1,0,18595,7.4,20267,227,84,4496,4428,22.7,1859.5
4520727484,0,17,2,1,1,5,1,0,0,0,0,12713,6.0,14245,192,23,-2976,-2255,19.2,1271.3,14,1,0,5,1,8,2,1,1,0,15689,6.6,16500,237,44,2976,2255,23.7,1568.9
4473231539,1,23,2,1,6,6,4,1,1,0,0,17262,7.0,19094,231,65,251,-74,23.1,1726.2,20,6,0,6,6,5,0,0,0,0,17011,7.2,19168,236,64,-251,74,23.6,1701.1
4496832374,1,18,2,0,9,6,11,1,1,0,0,18077,6.8,17869,235,40,1669,113,23.5,1807.7,16,3,1,6,9,4,0,0,0,0,16408,7.0,17756,218,48,-1669,-113,21.8,1640.8
4470307479,0,18,2,1,5,4,4,0,0,0,0,15843,6.6,16776,220,42,792,-622,22.0,1584.3,16,3,0,4,5,4,0,0,0,0,15051,6.8,17398,185,49,-792,622,18.5,1505.1
4462203064,1,15,6,0,7,4,8,0,0,0,0,17008,7.2,18978,216,44,1238,1037,21.6,1700.8,18,2,1,4,7,5,1,1,0,0,15770,6.8,17941,231,52,-1238,-1037,23.1,1577.0
4503099396,1,21,6,1,5,7,5,0,0,0,0,16514,6.8,18012,244,48,-17,-514,24.4,1651.4,17,4,0,7,5,10,1,1,0,0,16531,7.0,18526,209,48,17,514,20.9,1653.1
4524832772,1,38,3,0,4,5,5,0,0,0,0,15177,6.8,18017,189,55,-833,-116,18.9,1517.7,16,2,1,5,4,5,0,0,0,0,16010,7.0,18133,252,32,833,116,25.2,1601.0
4495401040,1,13,3,1,11,8,18,1,1,0,0,17568,6.6,16755,206,46,1236,1018,20.6,1756.8,16,0,0,8,11,9,0,0,0,0,16332,6.4,15737,183,45,-1236,-1018,18.3,1633.2
4489079383,1,16,3,0,5,5,7,1,1,0,0,15441,6.6,17550,201,52,-575,-208,20.1,1544.1,18,1,1,5,5,3,0,0,0,0,16016,6.8,17758,213,64,575,208,21.3,1601.6
4463080911,0,17,4,0,6,7,7,0,0,0,0,17132,7.2,19401,237,71,789,1620,23.7,1713.2,14,3,1,7,6,6,0,0,0,0,16343,7.0,17781,209,32,-789,-1620,20.9,1634.3
4495930806,0,12,1,1,9,4,10,2,1,1,1,18654,7.0,17865,226,36,3054,439,22.6,1865.4,16,3,0,4,9,5,0,0,0,0,15600,6.8,17426,221,56,-3054,-439,22.1,1560.0
4523290421,0,17,3,1,7,10,7,0,0,0,0,16995,6.8,17908,217,44,-1666,-759,21.7,1699.5,17,5,0,10,7,15,1,1,0,0,18661,7.0,18667,243,60,1666,759,24.3,1866.1
4522530131,0,17,1,0,1,5,1,1,1,0,0,14301,6.8,17056,214,45,-679,-1331,21.4,1430.1,13,4,1,5,1,2,0,0,0,0,14980,7.0,18387,216,43,679,1331,21.6,1498.0
4515606448,0,15,2,0,4,6,7,1,1,0,0,15520,7.0,17369,207,59,-1949,-1983,20.7,1552.0,37,2,1,6,4,10,1,0,1,0,17469,7.2,19352,230,56,1949,1983,23.0,1746.9
4513010497,0,12,2,0,2,8,1,0,0,0,0,15097,7.0,18355,223,72,-2575,-982,22.3,1509.7,12,3,1,8,2,9,1,1,0,0,17672,7.2,19337,226,44,2575,982,22.6,1767.2
4478533693,1,16,2,1,5,4,5,1,1,0,0,15862,6.8,17599,220,56,-292,-440,22.0,1586.2,53,5,0,4,5,7,0,0,0,0,16154,7.0,18039,224,52,292,440,22.4,1615.4
4436737489,0,17,0,0,9,8,7,0,0,0,0,17061,7.0,18530,197,42,744,461,19.7,1706.1,34,2,1,8,9,14,0,0,0,0,16317,7.0,18069,178,34,-744,-461,17.8,1631.7
4512587987,0,15,2,1,3,9,3,0,0,0,0,14719,6.6,16608,195,52,-3485,-2423,19.5,1471.9,37,3,0,9,3,12,1,1,0,0,18204,7.2,19031,237,50,3485,2423,23.7,1820.4
4420577274,0,17,5,1,5,5,7,1,0,1,0,16242,7.0,18244,235,56,-598,-146,23.5,1624.2,24,2,0,5,5,11,1,1,0,0,16840,7.0,18390,229,59,598,146,22.9,1684.0
4493134423,0,32,3,1,6,9,4,0,0,0,0,16672,7.0,18758,231,52,-1112,311,23.1,1667.2,16,0,0,9,6,8,0,0,0,0,17784,6.8,18447,211,36,1112,-311,21.1,1778.4
4518426899,0,14,2,0,5,7,5,0,0,0,0,16565,7.0,17659,220,48,-245,-1208,22.0,1656.5,15,1,1,7,5,3,0,0,0,0,16810,7.0,18867,244,51,245,1208,24.4,1681.0
4519804931,1,14,3,1,6,3,6,1,1,0,0,16432,7.0,18560,240,44,1804,1547,24.0,1643.2,33,2,0,3,6,3,0,0,0,0,14628,6.8,17013,200,43,-1804,-1547,20.0,1462.8
4524777842,0,46,3,0,5,6,8,0,0,0,0,15750,7.0,17334,214,43,-1727,-619,21.4,1575.0,14,4,1,6,5,8,0,0,0,0,17477,6.8,17953,223,56,1727,619,22.3,1747.7
4446010317,0,10,4,0,7,9,6,0,0,0,0,16317,6.6,16985,205,44,-2448,-1976,20.5,1631.7,18,4,1,9,7,7,1,1,0,1,18765,7.2,18961,238,42,2448,1976,23.8,1876.5
4516065991,0,20,4,0,4,4,5,0,0,0,0,15831,7.2,17839,247,55,-152,16,24.7,1583.1,37,4,1,4,4,6,0,0,0,0,15983,7.0,17823,243,40,152,-16,24.3,1598.3
4500168780,1,18,3,1,10,6,12,2,1,1,1,19639,7.2,19616,241,57,2778,1130,24.1,1963.9,22,5,0,6,10,8,0,0,0,0,16861,7.2,18486,240,54,-2778,-1130,24.0,1686.1
4496627466,1,70,3,1,9,5,9,1,1,0,0,17492,6.8,18028,219,40,687,563,21.9,1749.2,13,2,0,5,9,7,0,0,0,0,16805,7.0,17465,224,58,-687,-563,22.4,1680.5
4519189625,1,16,0,1,6,1,7,0,0,0,0,16602,7.2,19275,246,54,2919,2298,24.6,1660.2,12,1,0,1,6,0,0,0,0,0,13683,6.6,16977,214,41,-2919,-2298,21.4,1368.3
4526993807,0,15,2,1,8,6,14,0,0,0,0,15724,6.2,15396,203,28,-866,-2133,20.3,1572.4,23,1,0,6,8,5,1,0,1,0,16590,7.0,17529,198,51,866,2133,19.8,1659.0
4510612584,1,14,1,1,4,3,1,1,1,0,0,15843,6.8,17751,243,46,1301,1123,24.3,1584.3,15,0,0,3,4,6,0,0,0,0,14542,6.6,16628,205,40,-1301,-1123,20.5,1454.2
4509912325,0,91,6,0,2,7,4,1,1,0,0,14507,6.4,16400,215,52,-2328,-1153,21.5,1450.7,39,4,1,7,2,7,1,0,1,0,16835,6.8,17553,189,52,2328,1153,18.9,1683.5
4455553618,1,81,0,0,4,4,4,1,1,0,0,15742,7.2,18562,244,52,-896,-1292,24.4,1574.2,14,2,1,4,4,4,0,0,0,0,16638,7.4,19854,252,72,896,1292,25.2,1663.8
4497672608,0,36,1,1,5,9,7,0,0,0,0,15440,6.8,17277,175,57,-2494,-2755,17.5,1544.0,12,2,0,9,5,10,0,0,0,0,17934,7.2,20032,237,57,2494,2755,23.7,1793.4
4519506293,0,17,2,0,3,8,4,0,0,0,0,13493,6.2,14240,167,36,-5355,-5889,16.7,1349.3,19,0,1,8,3,9,1,1,0,0,18848,7.4,20129,234,84,5355,5889,23.4,1884.8
4508899687,1,16,3,0,3,3,1,0,0,0,0,15379,7.0,17670,232,48,236,-37,23.2,1537.9,16,6,1,3,3,5,1,1,0,0,15143,6.8,17707,217,52,-236,37,21.7,1514.3
4413130871,0,15,2,0,3,3,2,1,0,1,0,15885,7.0,18531,243,52,-257,-883,24.3,1588.5,16,1,1,3,3,6,0,0,0,0,16142,7.2,19414,232,76,257,883,23.2,1614.2
4497486422,0,23,4,1,7,10,8,1,0,1,1,18063,6.6,16794,228,48,-163,-674,22.8,1806.3,16,3,0,10,7,19,1,1,0,0,18226,6.8,17468,201,58,163,674,20.1,1822.6
4482020430,1,16,6,0,5,5,10,0,0,0,0,15151,6.8,16795,203,29,-244,78,20.3,1515.1,15,1,1,5,5,6,0,0,0,0,15395,6.4,16717,215,38,244,-78,21.5,1539.5
4515299589,0,18,0,0,7,7,4,0,0,0,0,16113,6.8,17158,205,47,-211,320,20.5,1611.3,41,3,1,7,7,9,1,1,0,0,16324,6.6,16838,191,40,211,-320,19.1,1632.4
4523399536,1,16,3,1,6,2,6,1,1,0,0,16610,7.0,18953,231,56,1353,1332,23.1,1661.0,23,1,0,2,6,2,0,0,0,0,15257,6.8,17621,236,46,-1353,-1332,23.6,1525.7
4514817366,1,66,6,1,9,3,17,1,1,0,0,16987,7.2,18514,189,40,2608,3387,18.9,1698.7,25,1,0,3,9,5,0,0,0,0,14379,6.4,15127,172,43,-2608,-3387,17.2,1437.9
4524144902,1,13,1,1,6,8,13,0,0,0,0,15835,6.8,17352,217,40,-1973,-1497,21.7,1583.5,14,1,0,8,6,8,0,0,0,0,17808,7.2,18849,236,60,1973,1497,23.6,1780.8
4514633280,0,47,3,0,14,11,14,0,0,0,0,20887,7.0,18795,215,32,2049,699,21.5,2088.7,169,4,1,11,14,11,2,1,1,0,18838,6.8,18096,191,58,-2049,-699,19.1,1883.8
4493317372,1,12,1,1,5,4,5,1,1,0,0,15807,7.0,18131,219,59,70,409,21.9,1580.7,14,1,0,4,5,8,0,0,0,0,15737,7.0,17722,221,60,-70,-409,22.1,1573.7
4523523505,1,12,2,1,7,1,12,1,1,0,0,17149,7.0,19250,216,53,3370,2895,21.6,1714.9,15,0,0,1,7,0,0,0,0,0,13779,6.4,16355,209,52,-3370,-2895,20.9,1377.9
4522026969,0,17,3,1,6,7,4,1,0,1,1,17620,6.8,18344,227,56,1345,1361,22.7,1762.0,40,4,0,7,6,14,1,1,0,0,16275,6.6,16983,199,45,-1345,-1361,19.9,1627.5
4467471076,1,39,5,0,6,3,5,2,1,1,0,16941,7.0,18581,229,47,2104,1643,22.9,1694.1,19,5,1,3,6,3,0,0,0,0,14837,7.0,16938,213,44,-2104,-1643,21.3,1483.7
4523682981,1,17,1,1,11,2,12,1,1,0,0,19967,7.0,19474,246,68,5887,4222,24.6,1996.7,16,1,0,2,11,2,0,0,0,0,14080,6.2,15252,209,44,-5887,-4222,20.9,1408.0
4525183626,0,17,1,1,5,4,6,1,1,0,0,15941,7.0,17661,236,55,-2,-1484,23.6,1594.1,29,3,0,4,5,2,0,0,0,0,15943,7.2,19145,237,67,2,1484,23.7,1594.3
4523737577,1,19,1,1,11,5,12,0,0,0,0,19057,7.0,19088,236,64,2455,1940,23.6,1905.7,12,3,0,5,11,10,0,0,0,0,16602,6.8,17148,226,43,-2455,-1940,22.6,1660.2
4521391433,0,15,2,1,9,6,11,1,1,0,0,18363,7.2,18844,220,52,2120,358,22.0,1836.3,13,4,0,6,9,5,0,0,0,0,16243,7.0,18486,215,56,-2120,-358,21.5,1624.3
4525161155,0,13,3,0,4,8,5,1,0,1,0,15577,6.6,16808,235,42,-2268,-1851,23.5,1557.7,21,3,1,8,4,7,1,1,0,0,17845,7.0,18659,239,63,2268,1851,23.9,1784.5
4514495731,1,12,1,0,12,5,19,0,0,0,0,19933,7.2,19756,248,36,4171,3497,24.8,1993.3,15,0,1,5,12,7,1,1,0,0,15762,6.4,16259,202,56,-4171,-3497,20.2,1576.2
4524267353,1,14,2,0,3,3,4,0,0,0,0,16688,7.0,18637,215,59,1004,458,21.5,1668.8,60,2,1,3,3,4,0,0,0,0,15684,7.0,18179,231,72,-1004,-458,23.1,1568.4
4455324807,1,43,0,0,7,10,5,0,0,0,0,17444,7.2,18454,197,56,-180,-102,19.7,1744.4,17,1,1,10,7,12,2,1,1,0,17624,7.0,18556,204,52,180,102,20.4,1762.4
4488128761,0,32,2,1,10,11,10,0,0,0,0,17593,6.8,17439,178,49,-1538,-1233,17.8,1759.3,15,1,0,11,10,15,2,1,1,0,19131,7.0,18672,201,55,1538,1233,20.1,1913.1
4488789257,0,18,2,1,5,7,8,0,0,0,0,15885,6.6,16848,220,43,-1566,-2539,22.0,1588.5,17,5,0,7,5,7,1,1,0,0,17451,7.2,19387,221,80,1566,2539,22.1,1745.1
4464955883,1,14,3,0,1,3,0,0,0,0,0,13918,7.0,17849,200,55,-1932,-41,20.0,1391.8,62,2,1,3,1,7,1,1,0,0,15850,6.8,17890,225,52,1932,41,22.5,1585.0
4524068171,0,18,3,1,9,6,8,0,0,0,0,16961,6.6,17237,191,48,531,-881,19.1,1696.1,17,2,0,6,9,13,1,1,0,0,16430,7.2,18118,198,60,-531,881,19.8,1643.0
4499920365,0,13,4,1,9,5,8,0,0,0,0,18096,7.2,18969,232,36,2526,1379,23.2,1809.6,16,2,0,5,9,4,1,1,0,0,15570,6.8,17590,194,49,-2526,-1379,19.4,1557.0
4497766397,0,17,3,1,6,7,2,0,0,0,0,15894,6.6,16813,205,48,-399,-868,20.5,1589.4,19,4,0,7,6,4,1,1,0,0,16293,7.0,17681,213,44,399,868,21.3,1629.3
4517819782,1,18,1,1,4,4,4,0,0,0,0,16333,7.2,18597,244,64,1315,1402,24.4,1633.3,14,2,0,4,4,4,1,0,1,0,15018,7.0,17195,206,50,-1315,-1402,20.6,1501.8
4509242024,1,40,2,0,6,4,4,0,0,0,0,16085,7.4,19076,204,56,275,872,20.4,1608.5,15,1,1,4,6,5,1,1,0,0,15810,7.2,18204,223,62,-275,-872,22.3,1581.0
4455649494,0,17,1,1,3,4,3,0,0,0,0,15484,7.0,18326,232,60,-930,185,23.2,1548.4,17,5,0,4,3,3,1,1,0,0,16414,7.0,18141,249,52,930,-185,24.9,1641.4
4519672552,0,29,3,0,9,7,10,0,0,0,0,17126,6.8,17604,195,52,1386,679,19.5,1712.6,18,2,1,7,9,4,1,1,0,0,15740,6.6,16925,202,48,-1386,-679,20.2,1574.0
4495025348,1,13,2,0,8,7,4,2,1,1,0,17683,7.6,20153,237,56,1289,2602,23.7,1768.3,16,2,1,7,8,7,0,0,0,0,16394,6.6,17551,208,36,-1289,-2602,20.8,1639.4
4526952901,1,12,7,1,6,5,3,2,1,1,1,17948,7.0,18736,247,48,2435,894,24.7,1794.8,18,1,0,5,6,7,0,0,0,0,15513,6.8,17842,219,35,-2435,-894,21.9,1551.3
4512162103,0,13,5,0,5,7,4,0,0,0,0,15196,6.4,16908,191,48,-1707,-1286,19.1,1519.6,62,3,1,7,5,10,1,1,0,0,16903,7.0,18194,216,51,1707,1286,21.6,1690.3
4486823240,1,17,2,1,9,6,13,0,0,0,0,18267,7.4,19241,226,48,2253,2082,22.6,1826.7,16,2,0,6,9,7,0,0,0,0,16014,6.8,17159,178,55,-2253,-2082,17.8,1601.4
4497898410,0,44,3,0,2,12,3,0,0,0,0,13899,6.4,15844,195,38,-6134,-6414,19.5,1389.9,24,6,1,12,2,9,1,1,0,0,20033,8.2,22258,236,83,6134,6414,23.6,2003.3
4512128800,1,14,2,1,6,6,11,0,0,0,0,16700,7.0,17393,218,40,1806,4,21.8,1670.0,14,1,0,6,6,3,1,1,0,0,14894,6.6,17389,203,39,-1806,-4,20.3,1489.4
4525953219,0,19,1,1,7,7,6,1,1,0,0,15990,6.8,17803,190,50,-1425,-1068,19.0,1599.0,9,2,0,7,7,6,0,0,0,0,17415,7.2,18871,241,41,1425,1068,24.1,1741.5
4412982614,1,22,6,1,6,10,5,0,0,0,0,16003,6.8,17857,214,52,-1761,-1446,21.4,1600.3,22,4,0,10,6,9,0,0,0,0,17764,7.2,19303,238,32,1761,1446,23.8,1776.4
4518060637,1,14,2,0,9,5,13,0,0,0,0,17099,7.2,19592,225,48,1344,2079,22.5,1709.9,16,1,1,5,9,2,1,1,0,0,15755,6.8,17513,238,48,-1344,-2079,23.8,1575.5
4522552557,1,26,3,1,9,1,14,0,0,0,0,18518,7.4,19380,224,55,4619,2904,22.4,1851.8,51,3,0,1,9,2,1,1,0,0,13899,6.6,16476,205,62,-4619,-2904,20.5,1389.9
4479665099,1,16,3,0,5,5,8,0,0,0,0,16871,7.2,18870,227,49,659,-111,22.7,1687.1,12,3,1,5,5,5,1,1,0,0,16212,7.0,18981,238,51,-659,111,23.8,1621.2
4513253618,0,20,0,0,8,8,5,1,0,1,0,16763,6.8,17433,193,54,-219,-1440,19.3,1676.3,15,2,1,8,8,6,1,1,0,0,16982,7.2,18873,183,58,219,1440,18.3,1698.2
4515771570,1,15,1,0,3,4,4,0,0,0,0,15022,7.0,18105,220,48,-1211,-108,22.0,1502.2,17,1,1,4,3,5,0,0,0,0,16233,6.8,18213,216,67,1211,108,21.6,1623.3
4480113908,0,18,2,1,12,11,10,0,0,0,0,18849,7.2,18593,216,42,702,4,21.6,1884.9,19,3,0,11,12,12,1,1,0,0,18147,7.0,18589,182,54,-702,-4,18.2,1814.7
4465719445,1,21,3,1,10,5,12,1,1,0,0,18046,7.4,19739,226,52,2299,1804,22.6,1804.6,17,6,0,5,10,5,0,0,0,0,15747,7.2,17935,229,48,-2299,-1804,22.9,1574.7
4521267611,0,12,4,0,10,12,6,1,1,0,0,17391,6.8,18031,202,56,-3064,-537,20.2,1739.1,18,1,1,12,10,11,1,0,1,1,20455,7.2,18568,180,51,3064,537,18.0,2045.5
4500695387,1,22,5,0,4,4,4,0,0,0,0,14942,6.6,17678,200,51,-763,395,20.0,1494.2,41,4,1,4,4,9,1,1,0,0,15705,6.8,17283,241,50,763,-395,24.1,1570.5
4520317076,0,15,4,0,2,8,1,0,0,0,0,14206,6.6,16793,200,50,-3427,-1792,20.0,1420.6,19,1,1,8,2,7,1,1,0,0,17633,7.0,18585,253,48,3427,1792,25.3,1763.3
4517646191,1,15,2,0,8,7,10,1,1,0,0,17000,6.6,16417,204,49,218,-204,20.4,1700.0,14,5,1,7,8,5,0,0,0,0,16782,6.8,16621,209,55,-218,204,20.9,1678.2
4458474426,0,15,0,1,7,12,5,2,1,1,0,16074,6.8,16408,185,50,-3268,-4457,18.5,1607.4,17,3,0,12,7,10,0,0,0,0,19342,7.6,20865,206,55,3268,4457,20.6,1934.2
4492030196,0,19,6,0,5,5,6,0,0,0,0,15943,6.6,17366,229,47,-467,-1361,22.9,1594.3,15,2,1,5,5,5,0,0,0,0,16410,7.0,18727,235,56,467,1361,23.5,1641.0
4521989162,1,19,3,1,4,9,3,1,1,0,0,16289,6.8,17304,223,67,-1764,-1997,22.3,1628.9,17,2,0,9,4,11,0,0,0,0,18053,7.2,19301,244,51,1764,1997,24.4,1805.3
4471385992,1,19,7,1,6,2,5,1,1,0,0,16105,7.2,18285,223,56,2275,1667,22.3,1610.5,51,3,0,2,6,2,0,0,0,0,13830,6.8,16618,204,39,-2275,-1667,20.4,1383.0
4521135230,1,16,1,1,8,1,8,1,1,0,0,17613,7.2,19092,234,48,3949,2440,23.4,1761.3,40,3,0,1,8,2,0,0,0,0,13664,6.6,16652,216,44,-3949,-2440,21.6,1366.4
4466182344,1,40,6,1,9,3,11,1,1,0,0,18309,7.6,20268,234,56,3039,2335,23.4,1830.9,18,2,0,3,9,3,0,0,0,0,15270,7.0,17933,223,46,-3039,-2335,22.3,1527.0
4502356627,0,39,1,1,10,10,11,1,0,1,0,18600,7.2,19763,183,83,-589,1794,18.3,1860.0,13,3,0,10,10,8,0,0,0,1,19189,7.0,17969,223,51,589,-1794,22.3,1918.9
4432479644,0,13,1,0,6,12,4,0,0,0,0,16337,7.0,16985,202,52,-2529,-2091,20.2,1633.7,36,4,1,12,6,15,1,1,0,0,18866,7.2,19076,214,48,2529,2091,21.4,1886.6
4489508995,0,16,3,0,4,11,2,0,0,0,0,15515,6.8,17838,231,50,-2272,-2400,23.1,1551.5,34,4,1,11,4,7,1,1,0,0,17787,7.6,20238,225,44,2272,2400,22.5,1778.7
4527222225,0,42,3,0,7,4,5,2,1,1,0,16468,6.8,17897,224,44,142,-58,22.4,1646.8,18,8,1,4,7,6,0,0,0,0,16326,7.0,17955,209,64,-142,58,20.9,1632.6
4503948096,1,15,2,1,7,3,4,1,1,0,0,16656,6.8,17435,214,67,1786,-261,21.4,1665.6,15,1,0,3,7,3,0,0,0,0,14870,6.8,17696,206,49,-1786,261,20.6,1487.0
4503986448,0,18,4,1,7,4,5,0,0,0,0,16681,7.0,18270,265,39,1403,389,26.5,1668.1,44,4,0,4,7,5,0,0,0,0,15278,7.0,17881,224,35,-1403,-389,22.4,1527.8
4520397947,1,19,2,1,13,7,9,0,0,0,0,19529,7.2,19763,204,36,3476,2025,20.4,1952.9,35,4,0,7,13,5,1,1,0,0,16053,7.0,17738,182,45,-3476,-2025,18.2,1605.3
4520687203,1,21,3,1,11,6,8,0,0,0,1,19022,7.0,19112,217,48,3028,2524,21.7,1902.2,18,3,0,6,11,8,0,0,0,0,15994,6.4,16588,190,51,-3028,-2524,19.0,1599.4
4501534072,0,51,5,0,6,5,7,0,0,0,0,15913,7.0,17268,195,68,-125,-637,19.5,1591.3,22,3,1,5,6,7,1,1,0,0,16038,6.8,17905,232,48,125,637,23.2,1603.8
4525837702,1,22,9,1,7,1,12,1,1,0,0,17696,7.2,18389,223,55,3650,2712,22.3,1769.6,19,6,0,1,7,1,0,0,0,0,14046,6.2,15677,237,32,-3650,-2712,23.7,1404.6
4522228780,1,15,2,1,7,9,8,0,0,0,0,16025,6.4,16142,197,42,-2344,-1592,19.7,1602.5,17,2,0,9,7,7,1,0,1,1,18369,6.8,17734,211,40,2344,1592,21.1,1836.9
4456176215,0,21,1,0,3,7,2,1,1,0,0,14505,6.8,17362,216,52,-4531,-2325,21.6,1450.5,14,1,1,7,3,8,1,0,1,1,19036,7.2,19687,252,58,4531,2325,25.2,1903.6
4525369835,0,41,2,0,2,7,4,1,1,0,0,15032,7.0,18462,232,68,-2785,-453,23.2,1503.2,22,3,1,7,2,7,1,0,1,0,17817,7.2,18915,228,55,2785,453,22.8,1781.7
4485481619,0,14,1,0,3,4,0,0,0,0,0,15084,7.2,19173,224,68,-1302,1008,22.4,1508.4,14,1,1,4,3,5,1,1,0,0,16386,7.0,18165,226,60,1302,-1008,22.6,1638.6
4521820831,1,17,4,1,6,3,2,1,0,1,0,17149,7.0,18751,257,57,2610,1716,25.7,1714.9,16,3,0,3,6,2,1,1,0,0,14539,6.6,17035,203,49,-2610,-1716,20.3,1453.9
4526460873,1,16,4,0,4,6,2,1,1,0,0,14993,6.8,16922,223,44,-1449,-539,22.3,1499.3,19,6,1,6,4,6,0,0,0,0,16442,6.8,17461,255,40,1449,539,25.5,1644.2
4448346419,1,15,4,0,6,4,8,0,0,0,0,15924,6.8,17006,191,45,-510,-837,19.1,1592.4,43,2,1,4,6,7,1,1,0,0,16434,7.0,17843,225,60,510,837,22.5,1643.4
4526573036,1,15,4,1,2,1,2,1,0,1,0,15538,6.8,18222,264,57,982,682,26.4,1553.8,16,6,0,1,2,1,1,1,0,0,14556,6.8,17540,258,48,-982,-682,25.8,1455.6
4526279271,0,13,2,0,3,7,1,0,0,0,0,15078,7.0,17979,219,48,-1823,-810,21.9,1507.8,30,2,1,7,3,9,1,1,0,0,16901,7.0,18789,225,57,1823,810,22.5,1690.1
4511823167,0,32,1,0,4,2,3,0,0,0,0,15008,6.8,17416,225,40,1219,1558,22.5,1500.8,16,17,1,2,4,1,1,1,0,0,13789,6.6,15858,193,44,-1219,-1558,19.3,1378.9
4527233294,1,14,12,1,8,8,12,0,0,0,0,16873,6.8,17879,215,45,375,296,21.5,1687.3,40,1,0,8,8,14,1,1,0,0,16498,7.0,17583,202,40,-375,-296,20.2,1649.8
4514643182,0,13,1,0,5,9,7,0,0,0,0,15449,6.6,16663,195,56,-2975,-2542,19.5,1544.9,17,3,1,9,5,15,1,1,0,0,18424,7.2,19205,258,48,2975,2542,25.8,1842.4
4450110737,1,146,5,1,13,9,13,1,1,0,0,19929,7.6,20672,224,67,2558,2349,22.4,1992.9,38,1,0,9,13,14,0,0,0,0,17371,7.2,18323,208,38,-2558,-2349,20.8,1737.1
4524656905,0,16,3,0,9,8,10,1,1,0,0,17586,7.2,18812,227,56,319,1558,22.7,1758.6,15,2,1,8,9,6,0,0,0,0,17267,6.8,17254,232,35,-319,-1558,23.2,1726.7
4511130155,0,25,0,0,4,7,3,0,0,0,0,13886,6.0,14445,178,42,-4582,-3594,17.8,1388.6,14,5,1,7,4,6,2,1,1,1,18468,6.8,18039,210,51,4582,3594,21.0,1846.8
4523974037,0,17,17,0,6,5,6,0,0,0,0,16999,7.2,18578,232,59,389,-279,23.2,1699.9,46,3,1,5,6,6,2,1,1,0,16610,7.2,18857,216,64,-389,279,21.6,1661.0
4525583733,1,20,21,1,4,4,7,0,0,0,0,15582,6.4,15958,238,43,977,134,23.8,1558.2,42,2,0,4,4,7,1,1,0,0,14605,6.4,15824,204,36,-977,-134,20.4,1460.5
4483310485,1,19,2,0,2,1,3,1,1,0,0,14909,7.0,18031,245,52,410,720,24.5,1490.9,14,3,1,1,2,1,0,0,0,0,14499,6.8,17311,237,52,-410,-720,23.7,1449.9
4505924248,0,15,3,0,2,5,3,0,0,0,0,14993,6.6,17018,241,44,-1481,-1877,24.1,1499.3,17,3,1,5,2,5,1,1,0,0,16474,7.2,18895,226,61,1481,1877,22.6,1647.4
4515416526,0,20,5,0,2,4,1,0,0,0,0,14790,7.2,18109,240,58,-1156,466,24.0,1479.0,17,5,1,4,2,5,1,1,0,0,15946,6.8,17643,240,48,1156,-466,24.0,1594.6
4508327940,0,83,3,0,5,7,5,0,0,0,0,16600,7.0,18188,250,52,-189,-1118,25.0,1660.0,17,4,1,7,5,10,1,1,0,0,16789,7.4,19306,207,64,189,1118,20.7,1678.9
4518002897,1,38,3,0,4,5,2,0,0,0,0,15306,7.2,17734,226,48,-211,232,22.6,1530.6,18,2,1,5,4,7,1,1,0,0,15517,7.0,17502,202,56,211,-232,20.2,1551.7
4489645082,1,44,7,0,8,5,9,0,0,0,0,17345,7.0,18111,183,41,1421,-792,18.3,1734.5,19,3,1,5,8,4,1,1,0,0,15924,7.0,18903,207,68,-1421,792,20.7,1592.4
4518328574,1,42,6,1,3,6,1,1,0,1,1,16873,6.8,17662,240,53,1942,450,24.0,1687.3,38,5,0,6,3,4,0,0,0,0,14931,6.8,17212,168,42,-1942,-450,16.8,1493.1
4477556217,0,18,0,0,2,9,3,0,0,0,0,14797,6.8,16690,213,52,-4265,-3190,21.3,1479.7,14,2,1,9,2,7,2,1,1,1,19062,7.2,19880,244,60,4265,3190,24.4,1906.2
4526208806,0,16,1,1,6,8,6,0,0,0,0,15186,6.8,16381,204,24,-2666,-1972,20.4,1518.6,38,4,0,8,6,14,1,1,0,0,17852,7.0,18353,218,57,2666,1972,21.8,1785.2
4486384947,1,21,4,1,5,4,11,0,0,0,0,16282,6.8,17378,213,49,882,512,21.3,1628.2,19,3,0,4,5,3,2,1,1,0,15400,6.6,16866,228,52,-882,-512,22.8,1540.0
4511414132,0,13,3,1,5,5,7,0,0,0,0,15658,7.0,17569,224,45,-1047,-1618,22.4,1565.8,14,3,0,5,5,5,0,0,0,0,16705,7.2,19187,251,54,1047,1618,25.1,1670.5
4504495749,1,23,2,1,17,9,29,0,0,0,0,22449,7.4,19137,209,60,4624,2511,20.9,2244.9,85,3,0,9,17,17,0,0,0,0,17825,6.6,16626,180,40,-4624,-2511,18.0,1782.5
4473156248,1,20,6,0,9,8,8,0,0,0,0,18457,7.2,19590,218,64,1378,1678,21.8,1845.7,17,3,1,8,9,5,2,1,1,0,17079,6.8,17912,219,70,-1378,-1678,21.9,1707.9
4512476997,1,13,3,0,7,10,11,0,0,0,0,16135,6.8,16250,184,46,-2299,-3211,18.4,1613.5,17,3,1,10,7,11,2,1,1,0,18434,7.2,19461,235,59,2299,3211,23.5,1843.4
4518506408,0,14,3,1,8,5,4,1,0,1,1,17951,7.2,18661,244,50,2114,1904,24.4,1795.1,18,3,0,5,8,4,1,1,0,0,15837,6.4,16757,220,56,-2114,-1904,22.0,1583.7
4477117307,0,18,1,1,4,6,8,0,0,0,0,15251,7.0,18342,197,39,-2343,-2231,19.7,1525.1,11,5,0,6,4,5,2,1,1,0,17594,7.4,20573,238,80,2343,2231,23.8,1759.4
4459784621,0,11,1,0,5,9,4,0,0,0,0,15102,6.8,18032,174,68,-5691,-2006,17.4,1510.2,14,2,1,9,5,8,2,1,1,2,20793,7.4,20038,226,56,5691,2006,22.6,2079.3
4518078785,1,11,4,0,15,7,16,1,0,1,0,20880,7.4,21004,231,41,4294,2560,23.1,2088.0,12,0,1,7,15,7,1,1,0,0,16586,7.0,18444,216,61,-4294,-2560,21.6,1658.6
4516176660,1,17,2,1,13,5,14,2,1,1,0,20403,7.4,20886,238,58,5365,4901,23.8,2040.3,10,2,0,5,13,5,0,0,0,0,15038,6.4,15985,178,44,-5365,-4901,17.8,1503.8
4526407759,1,18,4,1,8,6,6,1,1,0,0,16166,6.8,17100,188,49,-209,-353,18.8,1616.6,16,3,0,6,8,9,0,0,0,0,16375,7.0,17453,215,59,209,353,21.5,1637.5
4462104144,0,17,4,0,7,8,6,0,0,0,0,15330,6.2,15016,186,24,-1183,-1425,18.6,1533.0,19,3,1,8,7,10,1,1,0,0,16513,6.6,16441,199,37,1183,1425,19.9,1651.3
4443048030,0,16,3,0,7,7,8,0,0,0,0,16401,7.2,18527,189,61,-1979,-771,18.9,1640.1,15,2,1,7,7,5,2,1,1,0,18380,7.2,19298,240,53,1979,771,24.0,1838.0
4523370740,1,12,3,0,4,6,3,0,0,0,0,14796,6.6,17144,209,50,-2183,-1025,20.9,1479.6,18,1,1,6,4,5,1,1,0,0,16979,6.8,18169,236,56,2183,1025,23.6,1697.9
4469941685,1,13,6,1,4,4,2,0,0,0,0,15731,7.2,18954,250,47,-85,-632,25.0,1573.1,41,2,0,4,4,3,0,0,0,0,15816,7.2,19586,229,75,85,632,22.9,1581.6
4478759244,0,17,3,1,9,6,7,0,0,0,0,18626,7.2,18656,226,54,2318,339,22.6,1862.6,80,2,0,6,9,4,1,0,1,0,16308,7.2,18317,239,40,-2318,-339,23.9,1630.8
4525208534,0,16,2,0,2,5,1,0,0,0,0,14182,6.8,16753,220,52,-1700,-1053,22.0,1418.2,12,2,1,5,2,3,0,0,0,0,15882,6.8,17806,223,43,1700,1053,22.3,1588.2
4519502540,1,123,2,1,8,11,9,1,0,1,0,17429,7.0,18630,198,55,-1209,-747,19.8,1742.9,15,3,0,11,8,10,0,0,0,0,18638,7.4,19377,212,48,1209,747,21.2,1863.8
4497828297,1,15,2,1,9,3,8,1,1,0,0,17556,7.4,19338,211,52,2201,1421,21.1,1755.6,34,1,0,3,9,3,0,0,0,0,15355,7.0,17917,227,49,-2201,-1421,22.7,1535.5
4489607487,0,16,2,0,3,6,3,0,0,0,0,15092,7.0,18501,204,70,-1857,-699,20.4,1509.2,19,2,1,6,3,6,2,1,1,0,16949,7.2,19200,252,53,1857,699,25.2,1694.9
4481782791,1,18,1,0,5,4,6,0,0,0,0,16250,6.6,17489,231,48,1245,1084,23.1,1625.0,15,3,1,4,5,5,0,0,0,0,15005,6.6,16405,216,52,-1245,-1084,21.6,1500.5
4526930343,1,13,1,1,6,6,6,1,1,0,0,16019,6.6,17728,193,47,-612,-167,19.3,1601.9,16,1,0,6,6,8,0,0,0,0,16631,7.0,17895,218,51,612,167,21.8,1663.1
4468265290,1,16,6,1,6,6,2,2,1,1,0,15693,6.6,17206,199,56,355,818,19.9,1569.3,17,2,0,6,6,5,0,0,0,0,15338,6.6,16388,192,48,-355,-818,19.2,1533.8
4526195389,1,18,3,1,4,6,2,1,0,1,0,15500,6.8,17374,218,56,-1006,-1606,21.8,1550.0,45,3,0,6,4,5,1,1,0,0,16506,7.2,18980,221,48,1006,1606,22.1,1650.6
4478790073,1,11,7,0,8,3,10,1,1,0,0,17775,7.2,19408,256,49,2009,2090,25.6,1777.5,19,1,1,3,8,2,0,0,0,0,15766,6.6,17318,248,53,-2009,-2090,24.8,1576.6
4523824469,0,42,5,1,5,8,6,0,0,0,0,16178,6.8,17363,221,48,-1320,-687,22.1,1617.8,55,1,0,8,5,10,1,0,1,0,17498,7.2,18050,185,52,1320,687,18.5,1749.8
4523668637,0,54,2,1,8,4,6,2,1,1,0,16774,7.2,18465,240,48,300,-568,24.0,1677.4,12,2,0,4,8,5,0,0,0,0,16474,7.4,19033,231,68,-300,568,23.1,1647.4
4514345833,0,14,3,0,9,7,10,2,1,1,1,19049,7.0,17924,202,56,1618,-74,20.2,1904.9,14,3,1,7,9,8,0,0,0,0,17431,6.8,17998,209,42,-1618,74,20.9,1743.1
4450617242,0,13,1,0,4,5,5,0,0,0,0,14459,6.8,17799,173,49,-2859,143,17.3,1445.9,13,1,1,5,4,8,0,0,0,0,17318,7.0,17656,242,46,2859,-143,24.2,1731.8
4519053131,0,17,2,1,13,5,16,0,0,0,0,19336,7.2,19116,212,30,4627,4784,21.2,1933.6,14,3,0,5,13,6,0,0,0,0,14709,6.0,14332,175,29,-4627,-4784,17.5,1470.9
4526326403,1,40,3,0,5,6,5,1,1,0,0,16154,6.8,18329,235,42,-773,609,23.5,1615.4,11,1,1,6,5,8,1,0,1,0,16927,6.8,17720,201,48,773,-609,20.1,1692.7
4518443170,1,18,0,0,5,5,5,0,0,0,0,15238,6.8,17288,184,60,-719,825,18.4,1523.8,16,2,1,5,5,4,0,0,0,0,15957,6.8,16463,211,44,719,-825,21.1,1595.7
4464848388,1,13,1,0,4,5,3,2,1,1,0,15255,7.2,18352,228,47,-965,658,22.8,1525.5,14,1,1,5,4,5,0,0,0,0,16220,7.0,17694,223,44,965,-658,22.3,1622.0
4524829735,0,35,3,0,7,9,9,0,0,0,0,17482,7.2,18618,233,42,-561,-489,23.3,1748.2,16,3,1,9,7,9,0,0,0,0,18043,7.2,19107,224,41,561,489,22.4,1804.3
4462311511,0,36,4,1,1,6,2,0,0,0,0,13981,6.6,16753,220,52,-2494,-996,22.0,1398.1,14,2,0,6,1,3,0,0,0,0,16475,6.8,17749,250,44,2494,996,25.0,1647.5
4518710566,0,12,4,0,5,5,10,0,0,0,0,15748,7.0,17980,203,52,-326,833,20.3,1574.8,89,4,1,5,5,5,2,1,1,0,16074,6.6,17147,204,54,326,-833,20.4,1607.4
4520399524,1,15,0,0,2,4,3,0,0,0,0,14808,6.8,16826,219,50,-1352,-2339,21.9,1480.8,14,3,1,4,2,5,0,0,0,0,16160,7.4,19165,257,51,1352,2339,25.7,1616.0
4500070797,0,14,3,0,5,7,2,0,0,0,0,14318,6.6,16916,180,45,-1575,-1224,18.0,1431.8,14,0,1,7,5,5,1,1,0,0,15893,7.0,18140,193,50,1575,1224,19.3,1589.3
4512586696,1,21,2,0,4,6,8,0,0,0,0,15235,6.8,17736,208,59,-1089,378,20.8,1523.5,17,4,1,6,4,8,1,1,0,0,16324,6.6,17358,208,50,1089,-378,20.8,1632.4
4521833199,0,16,4,0,2,2,2,0,0,0,0,15280,7.2,18773,257,64,447,609,25.7,1528.0,16,3,1,2,2,2,1,1,0,0,14833,6.8,18164,240,51,-447,-609,24.0,1483.3
4525339326,1,14,2,1,1,3,1,1,1,0,0,14832,7.0,17330,228,60,-196,-282,22.8,1483.2,18,2,0,3,1,4,0,0,0,0,15028,7.0,17612,226,48,196,282,22.6,1502.8
4513988125,1,36,7,1,6,4,11,1,1,0,0,16612,6.8,17712,218,56,1094,287,21.8,1661.2,18,2,0,4,6,4,0,0,0,0,15518,6.8,17425,221,60,-1094,-287,22.1,1551.8
4506468475,1,17,4,1,7,8,8,1,1,0,0,16535,7.0,17930,230,28,-1123,-1665,23.0,1653.5,15,1,0,8,7,7,1,0,1,0,17658,7.0,19595,225,68,1123,1665,22.5,1765.8
4517525849,0,14,5,0,6,8,4,0,0,0,0,16126,7.0,18226,201,61,-842,749,20.1,1612.6,18,0,1,8,6,6,1,1,0,0,16968,6.6,17477,230,51,842,-749,23.0,1696.8
4500649869,1,13,3,1,3,2,3,1,1,0,0,15298,7.0,17946,232,60,383,-759,23.2,1529.8,16,1,0,2,3,0,0,0,0,0,14915,7.2,18705,233,72,-383,759,23.3,1491.5
4521803146,1,13,4,1,12,7,15,1,1,0,0,19933,7.2,18730,219,60,2473,565,21.9,1993.3,17,1,0,7,12,8,0,0,0,0,17460,7.0,18165,200,39,-2473,-565,20.0,1746.0
4458785938,0,12,1,0,3,9,3,0,0,0,0,14851,6.6,16367,183,66,-3151,-3729,18.3,1485.1,15,1,1,9,3,9,0,0,0,0,18002,7.4,20096,207,46,3151,3729,20.7,1800.2
4406716520,0,16,0,0,5,9,5,0,0,0,0,15477,6.4,15965,173,47,-2635,-2694,17.3,1547.7,12,3,1,9,5,12,1,1,0,0,18112,7.0,18659,241,43,2635,2694,24.1,1811.2
4466045865,1,12,1,0,5,8,6,1,0,1,0,17389,7.0,18695,231,63,110,-402,23.1,1738.9,14,2,1,8,5,9,0,0,0,0,17279,7.2,19097,231,59,-110,402,23.1,1727.9
4514213426,0,21,2,0,4,11,4,1,1,0,0,15168,6.6,16728,197,56,-3764,-1700,19.7,1516.8,21,2,1,11,4,12,0,0,0,0,18932,6.8,18428,198,56,3764,1700,19.8,1893.2
4518315271,0,39,2,1,4,4,6,1,1,0,0,15811,7.0,17771,212,63,161,-97,21.2,1581.1,15,22,0,4,4,6,0,0,0,0,15650,6.6,17868,222,45,-161,97,22.2,1565.0
4483729967,1,13,1,1,3,4,6,0,0,0,0,15223,6.8,17157,217,56,-299,-238,21.7,1522.3,25,3,0,4,3,7,1,1,0,0,15522,6.8,17395,203,72,299,238,20.3,1552.2
4477622010,0,15,3,0,2,12,3,1,1,0,0,13902,6.6,16677,173,60,-4535,-3079,17.3,1390.2,18,3,1,12,2,10,0,0,0,0,18437,7.2,19756,240,47,4535,3079,24.0,1843.7
4511770317,0,15,2,0,8,6,8,1,1,0,0,16627,6.8,17397,212,50,166,-497,21.2,1662.7,14,0,1,6,8,6,1,0,1,0,16461,7.0,17894,209,53,-166,497,20.9,1646.1
4439065205,0,28,3,0,6,9,9,0,0,0,0,16552,7.0,17597,215,48,-1026,-982,21.5,1655.2,19,3,1,9,6,7,1,1,0,0,17578,7.0,18579,234,52,1026,982,23.4,1757.8
4522791415,0,16,2,0,4,11,3,0,0,0,0,14689,6.6,16679,195,49,-5354,-4248,19.5,1468.9,15,4,1,11,4,10,1,1,0,0,20043,7.6,20927,244,61,5354,4248,24.4,2004.3
4523424930,1,15,6,1,4,4,7,0,0,0,0,16784,7.2,18335,267,47,992,-861,26.7,1678.4,14,2,0,4,4,5,1,1,0,0,15792,7.2,19196,224,80,-992,861,22.4,1579.2
4515764294,0,16,1,0,4,12,4,0,0,0,0,16280,6.8,17372,223,54,-3279,-1466,22.3,1628.0,15,2,1,12,4,15,1,1,0,0,19559,7.2,18838,252,59,3279,1466,25.2,1955.9
4486956653,1,24,5,1,7,7,8,0,0,0,0,16866,6.8,17575,194,54,-1543,-523,19.4,1686.6,16,1,0,7,7,7,1,0,1,1,18409,7.0,18098,207,48,1543,523,20.7,1840.9
4524837884,0,11,1,0,5,5,5,0,0,0,0,15617,7.0,18169,209,48,-951,-546,20.9,1561.7,41,4,1,5,5,5,1,1,0,0,16568,7.2,18715,206,60,951,546,20.6,1656.8
4472644738,1,18,3,1,8,10,7,0,0,0,0,16403,7.0,18111,218,33,-1445,-736,21.8,1640.3,56,7,0,10,8,9,1,0,1,0,17848,7.0,18847,210,54,1445,736,21.0,1784.8
4525615697,0,60,2,1,6,5,9,0,0,0,0,16641,7.2,19419,202,75,109,1368,20.2,1664.1,13,2,0,5,6,7,1,1,0,0,16532,6.8,18051,217,59,-109,-1368,21.7,1653.2
4526369291,0,31,2,1,5,14,2,2,1,1,0,16431,6.6,16968,219,64,-3488,-2682,21.9,1643.1,15,3,0,14,5,18,0,0,0,0,19919,7.4,19650,240,43,3488,2682,24.0,1991.9
4509031908,0,11,1,1,7,10,4,1,1,0,0,16505,6.6,17778,206,39,-1861,-1195,20.6,1650.5,13,0,0,10,7,11,0,0,0,0,18366,7.0,18973,221,44,1861,1195,22.1,1836.6
4517594548,1,20,3,0,5,4,5,0,0,0,0,16522,7.0,18641,236,57,1958,2380,23.6,1652.2,15,2,1,4,5,5,0,0,0,0,14564,6.6,16261,195,44,-1958,-2380,19.5,1456.4
4522394082,1,19,14,1,8,3,11,1,1,0,0,18200,7.2,19337,218,67,3719,1813,21.8,1820.0,62,3,0,3,8,1,0,0,0,0,14481,6.8,17524,214,60,-3719,-1813,21.4,1448.1
4523361669,0,16,3,1,5,10,6,1,1,0,0,16331,6.6,16667,220,51,-2814,-2623,22.0,1633.1,15,2,0,10,5,10,1,0,1,0,19145,7.0,19290,220,64,2814,2623,22.0,1914.5
4525167024,1,21,4,0,8,7,9,0,0,0,0,17737,7.2,18303,193,50,1083,451,19.3,1773.7,16,4,1,7,8,2,0,0,0,0,16654,7.2,17852,207,44,-1083,-451,20.7,1665.4
4462139682,1,30,3,1,9,5,8,1,1,0,0,17826,7.2,18216,220,54,3074,1273,22.0,1782.6,16,1,0,5,9,2,0,0,0,0,14752,6.4,16943,205,37,-3074,-1273,20.5,1475.2
4521700370,1,15,3,1,10,4,7,0,0,0,0,17710,7.0,18758,205,56,3297,2983,20.5,1771.0,16,1,0,4,10,3,1,1,0,0,14413,6.4,15775,183,44,-3297,-2983,18.3,1441.3
4521097121,0,23,1,0,3,9,4,1,1,0,0,15732,7.0,17644,201,72,-2080,-202,20.1,1573.2,13,3,1,9,3,12,1,0,1,0,17812,7.2,17846,202,48,2080,202,20.2,1781.2
4520687269,0,63,6,0,9,4,5,0,0,0,0,18184,7.4,20169,238,52,2989,4519,23.8,1818.4,23,18,1,4,9,6,0,0,0,0,15195,6.4,15650,192,44,-2989,-4519,19.2,1519.5
4519711392,1,12,2,0,5,7,6,1,1,0,0,16484,6.6,17799,242,44,-94,-844,24.2,1648.4,13,4,1,7,5,7,0,0,0,0,16578,7.0,18643,201,48,94,844,20.1,1657.8
4475775063,1,13,3,1,7,4,9,0,0,0,0,16275,6.8,17390,224,47,1606,615,22.4,1627.5,44,3,0,4,7,4,0,0,0,0,14669,6.4,16775,208,36,-1606,-615,20.8,1466.9
4515694077,0,17,6,1,7,2,6,0,0,0,0,17376,7.0,18907,238,43,2809,1740,23.8,1737.6,22,2,0,2,7,3,1,0,1,0,14567,6.6,17167,234,44,-2809,-1740,23.4,1456.7
4493638317,1,14,5,0,3,4,2,1,0,1,0,15318,6.8,17968,235,49,-942,120,23.5,1531.8,16,2,1,4,3,5,1,1,0,0,16260,6.8,17848,263,44,942,-120,26.3,1626.0
4527387593,0,12,3,1,3,5,3,0,0,0,0,15869,7.0,18217,261,48,-397,-163,26.1,1586.9,15,2,0,5,3,5,1,1,0,0,16266,7.0,18380,227,54,397,163,22.7,1626.6
4520412909,0,11,1,0,6,6,7,0,0,0,0,15805,7.2,18656,216,56,-1134,940,21.6,1580.5,14,4,1,6,6,9,1,1,0,0,16939,7.0,17716,239,48,1134,-940,23.9,1693.9
4510989189,1,19,3,1,10,0,7,0,0,0,0,17684,7.4,19113,224,35,3847,2027,22.4,1768.4,13,3,0,0,10,0,0,0,0,0,13837,6.8,17086,217,53,-3847,-2027,21.7,1383.7
4522155540,0,15,1,0,2,3,2,2,1,1,0,15537,6.8,17374,244,59,1024,415,24.4,1553.7,13,1,1,3,2,2,0,0,0,0,14513,6.8,16959,224,45,-1024,-415,22.4,1451.3
4511315940,1,12,4,0,2,2,1,1,1,0,0,14092,6.4,16918,201,49,-1999,-2041,20.1,1409.2,42,4,1,2,2,3,0,0,0,0,16091,7.0,18959,257,59,1999,2041,25.7,1609.1
4514142967,1,18,2,0,10,12,15,1,1,0,0,17877,6.8,17302,186,43,-920,-1562,18.6,1787.7,19,3,1,12,10,9,1,0,1,0,18797,7.2,18864,231,40,920,1562,23.1,1879.7
4511008520,0,17,1,0,2,5,1,1,1,0,0,13352,6.6,16455,188,44,-3059,-2718,18.8,1335.2,12,1,1,5,2,3,1,0,1,0,16411,7.0,19173,252,48,3059,2718,25.2,1641.1
4514102317,0,14,2,1,6,11,5,0,0,0,0,15777,7.0,17772,215,37,-2930,136,21.5,1577.7,14,1,0,11,6,8,1,1,0,0,18707,6.8,17636,215,42,2930,-136,21.5,1870.7
4484374414,0,17,4,1,3,11,3,0,0,0,0,14953,6.6,17005,221,57,-3903,-2090,22.1,1495.3,15,4,0,11,3,18,1,1,0,0,18856,7.2,19095,239,47,3903,2090,23.9,1885.6
4505884702,1,13,3,0,6,2,5,0,0,0,0,17059,7.2,18997,268,52,2714,2819,26.8,1705.9,82,1,1,2,6,2,0,0,0,0,14345,6.6,16178,209,38,-2714,-2819,20.9,1434.5
4510772679,0,41,2,0,5,7,8,0,0,0,0,15328,6.4,16143,191,39,-1980,-3337,19.1,1532.8,14,3,1,7,5,9,1,1,0,0,17308,7.0,19480,227,60,1980,3337,22.7,1730.8
4473029808,1,47,4,0,12,2,18,0,0,0,0,19336,7.4,19593,221,59,4680,2780,22.1,1933.6,14,2,1,2,12,2,0,0,0,0,14656,6.8,16813,214,60,-4680,-2780,21.4,1465.6
4478381770,0,19,7,0,1,6,1,0,0,0,0,14910,6.8,17888,245,56,-1557,-1039,24.5,1491.0,16,7,1,6,1,7,1,1,0,0,16467,7.2,18927,225,56,1557,1039,22.5,1646.7
4468797183,1,10,2,0,7,7,6,2,1,1,2,19453,7.0,18832,239,64,3773,1957,23.9,1945.3,13,0,1,7,7,6,0,0,0,0,15680,6.6,16875,170,52,-3773,-1957,17.0,1568.0
4494013671,1,29,1,1,3,6,2,2,1,1,0,14740,6.6,16655,201,44,-1402,-2295,20.1,1474.0,21,2,0,6,3,9,0,0,0,0,16142,7.0,18950,233,51,1402,2295,23.3,1614.2
4451870121,1,35,5,0,11,3,12,1,1,0,0,18929,7.4,19632,220,55,4175,3930,22.0,1892.9,16,2,1,3,11,3,1,0,1,0,14754,6.6,15702,201,44,-4175,-3930,20.1,1475.4
4526229522,0,14,2,1,3,8,2,1,1,0,0,16451,6.8,18027,234,72,-700,-1628,23.4,1645.1,13,0,0,8,3,12,0,0,0,0,17151,7.2,19655,222,46,700,1628,22.2,1715.1
4512529380,0,14,3,0,6,8,5,0,0,0,0,16881,7.2,18875,241,52,-259,1059,24.1,1688.1,15,2,1,8,6,9,0,0,0,0,17140,7.0,17816,188,47,259,-1059,18.8,1714.0
4513710414,1,15,4,1,6,2,8,1,1,0,0,16318,7.0,18426,226,59,2463,1390,22.6,1631.8,56,2,0,2,6,1,0,0,0,0,13855,6.8,17036,200,56,-2463,-1390,20.0,1385.5
4521693404,0,14,2,1,5,2,6,1,0,1,0,17511,7.4,20020,253,59,2795,2702,25.3,1751.1,12,2,0,2,5,2,1,1,0,0,14716,7.0,17318,244,52,-2795,-2702,24.4,1471.6
4486105297,1,18,2,1,7,10,9,0,0,0,0,16154,6.6,16080,199,41,-2005,-1736,19.9,1615.4,18,5,0,10,7,10,0,0,0,0,18159,6.8,17816,229,46,2005,1736,22.9,1815.9
4491856529,1,91,3,1,7,9,7,1,1,0,0,16452,6.8,17156,191,43,-2343,-2076,19.1,1645.2,21,5,0,9,7,5,1,0,1,0,18795,7.2,19232,261,44,2343,2076,26.1,1879.5
4455218616,1,14,0,1,11,2,15,0,0,0,0,17395,6.8,17215,170,40,3298,1038,17.0,1739.5,14,4,0,2,11,1,0,0,0,0,14097,6.6,16177,210,44,-3298,-1038,21.0,1409.7
4517480470,0,12,3,0,10,16,11,1,1,0,0,16681,6.4,16014,168,35,-3637,-2456,16.8,1668.1,18,5,1,16,10,17,0,0,0,0,20318,7.2,18470,219,49,3637,2456,21.9,2031.8
4485749350,1,18,1,1,8,5,5,1,1,0,0,16104,6.8,17424,175,56,530,227,17.5,1610.4,15,5,0,5,8,4,0,0,0,0,15574,6.8,17197,227,47,-530,-227,22.7,1557.4
4482303478,0,14,2,0,2,12,1,0,0,0,0,14100,6.6,16725,204,48,-5508,-3521,20.4,1410.0,14,1,1,12,2,15,1,1,0,0,19608,7.6,20246,239,56,5508,3521,23.9,1960.8
4482389592,1,16,3,0,7,5,9,1,1,0,0,16460,7.0,18782,222,52,192,616,22.2,1646.0,52,1,1,5,7,8,0,0,0,0,16268,7.2,18166,236,46,-192,-616,23.6,1626.8
4505847017,1,35,6,0,7,5,6,0,0,0,0,16555,7.2,18712,204,57,201,303,20.4,1655.5,45,7,1,5,7,6,1,1,0,0,16354,7.2,18409,210,64,-201,-303,21.0,1635.4
4477453234,0,18,2,1,2,1,3,0,0,0,0,14485,6.6,17358,211,40,-953,-862,21.1,1448.5,19,3,0,1,2,2,0,0,0,0,15438,7.0,18220,246,60,953,862,24.6,1543.8
4504961741,0,14,3,0,2,7,2,0,0,0,0,15461,6.8,17683,206,60,-1912,-2257,20.6,1546.1,16,2,1,7,2,7,2,1,1,0,17373,7.2,19940,243,55,1912,2257,24.3,1737.3
4510905499,1,56,3,1,8,2,11,2,1,1,0,17127,7.2,19195,221,56,2735,2319,22.1,1712.7,15,3,0,2,8,2,0,0,0,0,14392,6.6,16876,208,56,-2735,-2319,20.8,1439.2
4472447425,1,16,3,0,10,5,13,1,1,0,0,19134,7.6,20399,227,71,3440,2199,22.7,1913.4,16,2,1,5,10,4,0,0,0,0,15694,6.8,18200,209,66,-3440,-2199,20.9,1569.4
4515559203,1,15,2,1,3,1,3,0,0,0,0,16981,7.2,20082,269,64,1775,1652,26.9,1698.1,60,3,0,1,3,2,2,1,1,0,15206,7.0,18430,256,72,-1775,-1652,25.6,1520.6
4495498094,0,12,2,0,5,8,5,0,0,0,0,16317,7.0,17669,209,56,-1025,-1767,20.9,1631.7,14,2,1,8,5,4,0,0,0,0,17342,7.2,19436,245,56,1025,1767,24.5,1734.2
4503163360,0,16,0,0,3,4,6,0,0,0,0,14663,6.4,16086,206,38,-893,-670,20.6,1466.3,17,3,1,4,3,4,0,0,0,0,15556,6.8,16756,212,56,893,670,21.2,1555.6
4520057356,0,16,3,0,3,6,2,0,0,0,0,15731,6.6,17150,251,42,-1057,-1798,25.1,1573.1,20,1,1,6,3,9,1,1,0,0,16788,7.2,18948,220,64,1057,1798,22.0,1678.8
4496140999,1,17,1,1,8,3,7,1,1,0,0,18363,7.2,20337,233,68,4507,4079,23.3,1836.3,15,3,0,3,8,2,0,0,0,0,13856,6.6,16258,194,44,-4507,-4079,19.4,1385.6
4508198441,0,18,3,0,2,9,4,0,0,0,0,14691,6.8,17573,207,67,-4024,-1999,20.7,1469.1,13,3,1,9,2,18,1,1,0,0,18715,7.4,19572,242,55,4024,1999,24.2,1871.5
4518819945,0,11,1,0,8,13,8,0,0,0,0,15818,6.4,16673,172,28,-4100,-3722,17.2,1581.8,20,2,1,13,8,11,0,0,0,0,19918,7.4,20395,220,59,4100,3722,22.0,1991.8
4513358950,0,17,2,1,2,7,1,1,0,1,0,14733,6.8,17627,224,52,-2267,-2546,22.4,1473.3,15,3,0,7,2,4,1,1,0,0,17000,7.6,20173,244,71,2267,2546,24.4,1700.0
4520393819,0,18,1,0,3,8,7,0,0,0,0,13944,6.6,15850,185,48,-3179,-2574,18.5,1394.4,20,8,1,8,3,7,1,1,0,0,17123,7.0,18424,230,48,3179,2574,23.0,1712.3
4495200388,0,16,2,0,3,6,2,0,0,0,0,13489,6.0,14875,192,20,-2345,-2959,19.2,1348.9,19,2,1,6,3,5,1,1,0,0,15834,6.8,17834,198,60,2345,2959,19.8,1583.4
4526923386,1,20,8,1,10,6,10,1,0,1,0,18099,7.4,18678,203,44,3236,3464,20.3,1809.9,41,5,0,6,10,3,0,0,0,0,14863,6.2,15214,163,36,-3236,-3464,16.3,1486.3
4518804913,0,12,3,1,2,5,0,0,0,0,0,13408,6.4,16175,192,31,-3160,-3099,19.2,1340.8,15,2,0,5,2,6,1,1,0,0,16568,7.2,19274,224,76,3160,3099,22.4,1656.8
4519178537,0,16,3,0,4,5,3,0,0,0,0,14893,6.8,17322,203,48,-1002,-378,20.3,1489.3,16,2,1,5,4,4,1,1,0,0,15895,6.8,17700,233,48,1002,378,23.3,1589.5
4496697436,0,12,4,0,5,10,6,0,0,0,0,15622,6.6,16556,200,43,-3909,-2136,20.0,1562.2,17,3,1,10,5,8,2,1,1,2,19531,7.2,18692,222,49,3909,2136,22.2,1953.1
4505237084,0,15,2,1,5,4,4,0,0,0,0,15742,6.8,17504,219,55,501,642,21.9,1574.2,13,1,0,4,5,5,1,1,0,0,15241,6.6,16862,196,52,-501,-642,19.6,1524.1
4448300044,1,17,2,1,12,9,8,0,0,0,0,19355,7.6,20151,208,60,2070,1019,20.8,1935.5,12,3,0,9,12,9,0,0,0,0,17285,7.2,19132,217,51,-2070,-1019,21.7,1728.5
4512939837,0,17,3,1,4,11,3,0,0,0,0,15431,7.0,17705,214,54,-3460,-2389,21.4,1543.1,17,5,0,11,4,10,1,1,0,0,18891,7.6,20094,233,56,3460,2389,23.3,1889.1
4524902181,0,88,3,0,7,7,6,1,1,0,0,16476,6.6,17474,210,53,335,731,21.0,1647.6,22,2,1,7,7,4,0,0,0,0,16141,6.6,16743,206,40,-335,-731,20.6,1614.1
4470980027,1,24,3,0,12,8,17,1,1,0,0,18360,6.8,17412,202,39,525,476,20.2,1836.0,18,1,1,8,12,7,0,0,0,0,17835,6.6,16936,218,38,-525,-476,21.8,1783.5
4523660012,1,13,1,1,7,8,8,0,0,0,0,17004,7.2,19083,193,52,-417,81,19.3,1700.4,40,1,0,8,7,7,1,1,0,0,17421,7.2,19002,206,59,417,-81,20.6,1742.1
4521831054,0,44,4,1,9,6,8,1,0,1,0,17897,7.2,19344,217,53,1692,1998,21.7,1789.7,12,3,0,6,9,8,1,1,0,0,16205,7.0,17346,206,44,-1692,-1998,20.6,1620.5
4491827833,0,16,0,0,5,10,5,0,0,0,0,16324,6.8,17213,193,59,-943,-708,19.3,1632.4,40,3,1,10,5,13,1,1,0,0,17267,7.0,17921,174,60,943,708,17.4,1726.7
4481500252,0,15,4,0,3,8,6,0,0,0,0,16621,6.6,17456,244,48,-2115,-456,24.4,1662.1,10,2,1,8,3,15,2,1,1,0,18736,6.8,17912,222,64,2115,456,22.2,1873.6
4465357470,0,19,2,0,5,6,3,0,0,0,0,15722,6.8,17153,224,40,-488,-98,22.4,1572.2,16,3,1,6,5,7,1,1,0,0,16210,6.8,17251,192,48,488,98,19.2,1621.0
4526361954,1,24,0,1,8,2,9,1,1,0,1,17422,6.8,17192,211,24,2394,-1292,21.1,1742.2,36,5,0,2,8,3,0,0,0,0,15028,7.0,18484,210,76,-2394,1292,21.0,1502.8
4514283603,1,17,1,1,6,8,4,1,1,0,0,16021,6.8,18021,199,48,-620,-384,19.9,1602.1,14,5,0,8,6,9,0,0,0,0,16641,7.2,18405,217,44,620,384,21.7,1664.1
4527482253,0,12,0,1,5,11,5,0,0,0,0,17219,6.8,18160,241,59,-1213,-769,24.1,1721.9,53,2,0,11,5,14,0,0,0,0,18432,7.2,18929,183,56,1213,769,18.3,1843.2
4522491015,1,38,4,1,3,3,6,2,1,1,0,14854,7.0,16846,212,44,-630,-865,21.2,1485.4,17,1,0,3,3,2,0,0,0,0,15484,7.0,17711,203,68,630,865,20.3,1548.4
4505610970,1,26,5,1,15,8,24,0,0,0,0,19917,7.0,18396,209,28,3759,1339,20.9,1991.7,14,5,0,8,15,8,1,1,0,0,16158,6.8,17057,172,55,-3759,-1339,17.2,1615.8
4517503916,1,15,5,0,6,13,9,1,1,0,0,16035,6.6,16424,160,52,-4685,-3600,16.0,1603.5,19,4,1,13,6,23,0,0,0,0,20720,7.6,20024,244,51,4685,3600,24.4,2072.0
4492333957,1,14,1,1,9,5,7,1,0,1,0,18348,7.2,19545,216,62,3111,2739,21.6,1834.8,13,0,0,5,9,4,1,1,0,0,15237,6.8,16806,202,51,-3111,-2739,20.2,1523.7
4459886824,1,11,3,1,10,12,11,1,0,1,0,18177,6.8,17640,203,40,-1253,-1627,20.3,1817.7,18,1,0,12,10,15,1,1,0,0,19430,7.2,19267,235,42,1253,1627,23.5,1943.0
4514097912,1,18,2,0,10,6,9,0,0,0,0,18673,6.8,18121,223,38,3397,1493,22.3,1867.3,15,2,1,6,10,8,0,0,0,0,15276,6.6,16628,186,44,-3397,-1493,18.6,1527.6
4520362854,1,36,3,1,3,0,3,0,0,0,0,16248,7.0,18185,239,60,2086,1397,23.9,1624.8,15,4,0,0,3,0,1,1,0,0,14162,6.6,16788,241,56,-2086,-1397,24.1,1416.2
4483846553,0,11,3,0,4,4,5,0,0,0,0,14782,6.8,16617,211,47,-1430,-2438,21.1,1478.2,38,1,1,4,4,3,2,1,1,0,16212,7.2,19055,236,64,1430,2438,23.6,1621.2
4500460530,1,23,1,1,9,2,12,1,1,0,0,17913,7.4,19102,218,53,3453,1775,21.8,1791.3,10,0,0,2,9,2,0,0,0,0,14460,6.8,17327,215,57,-3453,-1775,21.5,1446.0
4506187953,1,13,0,0,6,5,5,0,0,0,0,15687,6.6,18199,206,46,-423,716,20.6,1568.7,16,5,1,5,6,6,0,0,0,0,16110,7.0,17483,219,44,423,-716,21.9,1611.0
4520634321,1,16,4,1,2,5,2,0,0,0,0,15011,7.0,17250,223,60,-1399,-763,22.3,1501.1,22,4,0,5,2,7,1,1,0,0,16410,7.0,18013,208,60,1399,763,20.8,1641.0
4524627425,0,19,3,0,4,7,6,1,0,1,0,15412,6.8,17498,192,63,-1271,101,19.2,1541.2,17,8,1,7,4,8,0,0,0,0,16683,7.0,17397,233,37,1271,-101,23.3,1668.3
4478853146,1,17,2,0,10,5,11,1,0,1,1,19323,7.4,19481,220,57,2728,1681,22.0,1932.3,15,4,1,5,10,7,0,0,0,0,16595,7.0,17800,241,34,-2728,-1681,24.1,1659.5
4524043423,1,12,2,1,8,7,5,0,0,0,0,17975,7.2,18967,248,51,1283,518,24.8,1797.5,15,1,0,7,8,2,1,1,0,0,16692,7.0,18449,217,68,-1283,-518,21.7,1669.2
4511940066,0,38,4,1,4,7,1,1,0,1,0,15198,6.8,17307,214,50,-2090,-2188,21.4,1519.8,17,3,0,7,4,7,1,1,0,0,17288,7.2,19495,222,71,2090,2188,22.2,1728.8
4515396713,1,13,3,1,5,4,5,1,0,1,0,16582,6.8,18262,216,66,380,-239,21.6,1658.2,58,4,0,4,5,6,1,1,0,0,16202,6.8,18501,246,41,-380,239,24.6,1620.2
4485840157,0,14,1,1,6,8,5,0,0,0,0,16892,7.0,18225,226,48,-44,277,22.6,1689.2,14,1,0,8,6,10,1,1,0,0,16936,7.0,17948,185,48,44,-277,18.5,1693.6
4485270113,1,20,4,1,8,6,11,1,1,0,0,18074,7.4,19942,252,59,1634,1007,25.2,1807.4,13,4,0,6,8,7,0,0,0,0,16440,7.0,18935,223,56,-1634,-1007,22.3,1644.0
4479142877,0,27,2,0,5,8,3,0,0,0,0,14874,6.6,16504,177,44,-2695,-1042,17.7,1487.4,18,5,1,8,5,14,1,1,0,0,17569,6.8,17546,249,44,2695,1042,24.9,1756.9
4524178693,1,12,4,0,7,11,11,0,0,0,0,17659,7.0,18496,244,58,-987,89,24.4,1765.9,15,4,1,11,7,17,2,1,1,0,18646,7.2,18407,206,49,987,-89,20.6,1864.6
4519322442,1,19,2,1,8,7,8,0,0,0,0,17012,6.8,17394,204,55,-992,-490,20.4,1701.2,18,1,0,7,8,8,1,1,0,0,18004,6.8,17884,240,46,992,490,24.0,1800.4
4456030876,0,16,3,1,5,9,4,0,0,0,0,15968,6.8,17837,226,55,-1624,-1067,22.6,1596.8,17,4,0,9,5,13,1,1,0,0,17592,7.2,18904,198,64,1624,1067,19.8,1759.2
4518047197,0,17,1,0,3,10,3,0,0,0,0,14558,6.4,15833,194,42,-3177,-3271,19.4,1455.8,36,1,1,10,3,11,1,1,0,0,17735,7.2,19104,207,52,3177,3271,20.7,1773.5
4520324538,1,16,0,0,7,7,11,1,1,0,0,17162,7.2,18810,216,56,-810,123,21.6,1716.2,19,5,1,7,7,10,0,0,0,0,17972,7.2,18687,272,47,810,-123,27.2,1797.2
4524310829,1,22,5,1,5,3,6,2,1,1,0,16007,6.8,17370,202,45,701,-628,20.2,1600.7,20,5,0,3,5,2,0,0,0,0,15306,7.0,17998,236,62,-701,628,23.6,1530.6
4438432164,0,15,2,0,8,10,9,0,0,0,0,16722,6.6,16113,190,47,-978,-1232,19.0,1672.2,18,3,1,10,8,14,1,1,0,0,17700,6.8,17345,200,41,978,1232,20.0,1770.0
4517996305,0,18,3,0,1,9,1,0,0,0,0,13599,6.4,15596,229,32,-5031,-5211,22.9,1359.9,16,3,1,9,1,6,0,0,0,0,18630,7.6,20807,241,71,5031,5211,24.1,1863.0
4473252626,1,18,4,1,12,13,15,1,0,1,0,18275,6.6,17102,173,39,-1963,-1936,17.3,1827.5,19,5,0,13,12,20,1,1,0,0,20238,7.2,19038,214,49,1963,1936,21.4,2023.8
4508478137,1,14,5,1,6,3,8,1,1,0,0,17352,6.8,18631,257,63,1963,804,25.7,1735.2,45,2,0,3,6,7,0,0,0,0,15389,6.8,17827,210,52,-1963,-804,21.0,1538.9
4511796772,1,19,1,1,5,2,5,0,0,0,0,16779,7.0,18382,268,52,2386,395,26.8,1677.9,14,2,0,2,5,4,0,0,0,0,14393,7.0,17987,204,64,-2386,-395,20.4,1439.3
4523428362,1,16,3,1,9,2,9,1,0,1,0,18870,7.0,18945,252,43,4909,2760,25.2,1887.0,14,3,0,2,9,1,1,1,0,0,13961,6.6,16185,202,47,-4909,-2760,20.2,1396.1
4509699185,1,39,2,1,8,7,5,1,0,1,0,17329,7.4,19915,226,64,881,2559,22.6,1732.9,17,2,0,7,8,7,0,0,0,0,16448,6.8,17356,199,40,-881,-2559,19.9,1644.8
4495320946,1,23,4,1,13,7,14,0,0,0,0,19713,7.0,18607,217,52,2795,999,21.7,1971.3,45,0,0,7,13,8,0,0,0,0,16918,6.8,17608,177,56,-2795,-999,17.7,1691.8
4526576560,0,18,5,0,4,8,6,1,1,0,0,15589,7.0,18306,219,64,-2268,-1810,21.9,1558.9,31,6,1,8,4,8,0,0,0,0,17857,7.4,20116,261,58,2268,1810,26.1,1785.7
4382920718,1,21,3,0,15,16,10,2,1,1,0,19247,6.8,16835,205,44,-1709,-1585,20.5,1924.7,80,6,1,16,15,16,0,0,0,0,20956,7.0,18420,182,44,1709,1585,18.2,2095.6
4525329096,0,13,4,1,2,4,2,0,0,0,0,14842,7.0,17857,231,48,270,679,23.1,1484.2,17,2,0,4,2,3,1,1,0,0,14572,6.8,17178,193,41,-270,-679,19.3,1457.2
4495284570,1,17,4,0,7,5,10,1,1,0,0,17009,6.8,17881,222,40,1121,836,22.2,1700.9,15,4,1,5,7,4,0,0,0,0,15888,6.8,17045,228,52,-1121,-836,22.8,1588.8
4520561506,1,17,2,0,2,5,1,0,0,0,0,14981,7.0,18767,222,76,-1607,-48,22.2,1498.1,18,3,1,5,2,6,1,1,0,0,16588,7.2,18815,259,48,1607,48,25.9,1658.8
4410686846,0,17,4,0,3,12,1,0,0,0,0,13800,6.4,15275,165,44,-4921,-2826,16.5,1380.0,17,3,1,12,3,16,1,1,0,0,18721,7.0,18101,208,60,4921,2826,20.8,1872.1
4524119242,1,19,0,1,10,2,12,1,1,0,0,18549,7.2,19419,203,63,4378,3157,20.3,1854.9,9,6,0,2,10,2,0,0,0,0,14171,6.6,16262,214,44,-4378,-3157,21.4,1417.1
4525832598,1,13,3,1,4,6,6,1,1,0,0,16040,6.8,17697,235,54,-572,35,23.5,1604.0,69,3,0,6,4,13,0,0,0,0,16612,7.0,17662,221,45,572,-35,22.1,1661.2
4513777315,0,17,3,1,10,7,11,1,1,0,0,18454,7.2,19370,230,53,1455,602,23.0,1845.4,19,4,0,7,10,5,0,0,0,0,16999,7.0,18768,247,48,-1455,-602,24.7,1699.9
4522252043,1,13,0,1,6,3,8,0,0,0,0,18236,7.2,19626,234,76,3586,3431,23.4,1823.6,13,1,0,3,6,4,0,0,0,0,14650,6.6,16195,221,47,-3586,-3431,22.1,1465.0
4512481936,1,49,2,0,4,9,4,0,0,0,0,15370,6.6,17168,200,72,-2929,-1515,20.0,1537.0,18,2,1,9,4,13,1,1,0,0,18299,7.0,18683,217,62,2929,1515,21.7,1829.9
4506000995,0,19,4,0,3,6,3,0,0,0,0,15676,6.8,17248,267,35,-703,-1216,26.7,1567.6,46,4,1,6,3,8,1,1,0,0,16379,6.8,18464,224,56,703,1216,22.4,1637.9
4442356832,0,29,3,1,4,11,5,0,0,0,0,15046,6.8,17088,214,36,-4939,-3731,21.4,1504.6,16,2,0,11,4,16,1,0,1,0,19985,7.6,20819,251,69,4939,3731,25.1,1998.5
4521179969,0,16,1,0,9,12,13,0,0,0,0,17867,6.6,17671,218,49,-1354,-798,21.8,1786.7,15,6,1,12,9,23,0,0,0,0,19221,7.2,18469,214,42,1354,798,21.4,1922.1
4490487724,1,18,1,1,3,7,2,0,0,0,0,15065,6.6,17137,231,50,-2595,-2856,23.1,1506.5,17,8,0,7,3,6,1,0,1,0,17660,7.4,19993,260,51,2595,2856,26.0,1766.0
4298181346,1,18,7,1,8,6,8,1,1,0,0,17505,7.2,19310,223,59,786,1888,22.3,1750.5,17,2,0,6,8,7,0,0,0,0,16719,6.6,17422,220,44,-786,-1888,22.0,1671.9
4521806939,1,17,3,1,10,5,11,1,1,0,0,17556,6.8,17943,206,40,2153,799,20.6,1755.6,16,2,0,5,10,7,0,0,0,0,15403,6.8,17144,202,51,-2153,-799,20.2,1540.3
4513275057,0,20,6,1,8,2,8,1,1,0,0,16846,7.4,19790,224,54,2487,1963,22.4,1684.6,24,5,0,2,8,1,0,0,0,0,14359,6.8,17827,223,48,-2487,-1963,22.3,1435.9
4458825692,0,43,3,0,5,6,4,0,0,0,0,16019,6.8,18530,222,48,-758,733,22.2,1601.9,21,4,1,6,5,7,0,0,0,0,16777,7.0,17797,215,56,758,-733,21.5,1677.7
4466097305,0,13,3,0,3,7,2,1,1,0,0,14761,6.4,16905,194,53,-2553,-2532,19.4,1476.1,17,1,1,7,3,8,1,0,1,0,17314,7.0,19437,224,52,2553,2532,22.4,1731.4
4514011142,0,8,0,1,7,10,7,1,0,1,1,16859,7.0,17173,198,47,-2416,-2252,19.8,1685.9,12,2,0,10,7,12,1,1,0,1,19275,7.4,19425,221,39,2416,2252,22.1,1927.5
4494136830,0,15,1,1,5,3,6,1,1,0,0,16224,6.8,18284,254,53,586,348,25.4,1622.4,16,1,0,3,5,3,0,0,0,0,15638,6.8,17936,245,50,-586,-348,24.5,1563.8
4512554301,0,15,3,0,4,5,1,1,1,0,0,16755,6.8,18760,263,68,695,1686,26.3,1675.5,17,2,1,5,4,4,0,0,0,0,16060,6.6,17074,225,39,-695,-1686,22.5,1606.0
4496483368,1,48,3,1,4,3,3,2,1,1,0,15656,7.0,17844,227,48,85,-706,22.7,1565.6,18,3,0,3,4,3,0,0,0,0,15571,7.0,18550,217,63,-85,706,21.7,1557.1
4514073335,1,10,0,1,7,3,3,1,1,0,0,17116,7.2,19290,237,65,3328,3696,23.7,1711.6,11,2,0,3,7,3,0,0,0,0,13788,6.4,15594,173,43,-3328,-3696,17.3,1378.8
4487380203,0,17,1,0,2,8,1,1,1,0,0,14476,6.6,16263,201,57,-4094,-3320,20.1,1447.6,18,2,1,8,2,8,0,0,0,0,18570,7.2,19583,252,66,4094,3320,25.2,1857.0
4520358901,1,16,3,0,1,5,1,1,0,1,0,15743,6.8,18383,264,61,-251,557,26.4,1574.3,19,0,1,5,1,11,1,1,0,0,15994,7.0,17826,210,56,251,-557,21.0,1599.4
4497704200,1,15,4,1,7,3,8,0,0,0,0,17602,6.8,18119,254,52,2956,2140,25.4,1760.2,20,2,0,3,7,4,0,0,0,0,14646,6.4,15979,205,50,-2956,-2140,20.5,1464.6
4487268052,0,45,5,0,4,3,5,1,1,0,0,15398,7.2,17861,200,54,378,321,20.0,1539.8,55,6,1,3,4,2,1,0,1,0,15020,7.0,17540,227,48,-378,-321,22.7,1502.0
4514382046,1,19,0,0,4,7,6,0,0,0,0,15295,6.8,16951,225,45,-1755,-1014,22.5,1529.5,15,7,1,7,4,13,0,0,0,0,17050,7.0,17965,218,54,1755,1014,21.8,1705.0
4464183105,0,17,5,1,1,3,1,0,0,0,0,15221,6.8,17418,266,45,-179,-463,26.6,1522.1,14,4,0,3,1,4,1,1,0,0,15400,6.6,17881,240,46,179,463,24.0,1540.0
4524741088,0,17,2,1,5,8,3,1,1,0,0,15256,6.6,16807,192,55,-1857,-2651,19.2,1525.6,14,2,0,8,5,10,0,0,0,0,17113,7.4,19458,209,58,1857,2651,20.9,1711.3
4505820252,1,14,1,0,2,3,2,2,1,1,0,16394,7.4,20016,264,85,1447,1753,26.4,1639.4,13,3,1,3,2,1,0,0,0,0,14947,6.8,18263,227,54,-1447,-1753,22.7,1494.7
4511479972,0,15,6,0,8,8,9,0,0,0,0,16345,7.0,17692,206,43,-1208,-213,20.6,1634.5,18,5,1,8,8,9,2,1,1,0,17553,7.0,17905,223,56,1208,213,22.3,1755.3
4495247088,1,13,3,0,5,5,6,1,0,1,0,16897,7.2,18457,218,68,942,952,21.8,1689.7,14,5,1,5,5,4,0,0,0,0,15955,6.8,17505,220,57,-942,-952,22.0,1595.5
4447165019,0,16,4,0,10,4,12,0,0,0,0,17748,7.2,19278,175,41,2329,2416,17.5,1774.8,16,2,1,4,10,4,1,0,1,0,15419,6.6,16862,218,55,-2329,-2416,21.8,1541.9
4522182843,1,14,2,0,8,11,9,0,0,0,0,17735,7.4,18655,203,56,-1421,-1547,20.3,1773.5,15,0,1,11,8,11,0,0,0,0,19156,7.4,20202,246,52,1421,1547,24.6,1915.6
4524674585,0,33,1,0,5,13,2,0,0,0,0,16145,7.0,17749,221,40,-2746,-1939,22.1,1614.5,13,1,1,13,5,14,1,1,0,0,18891,7.2,19688,229,58,2746,1939,22.9,1889.1
4499779050,1,15,4,1,4,8,4,1,0,1,1,16201,6.4,15667,204,47,-468,-1886,20.4,1620.1,18,4,0,8,4,10,1,1,0,0,16669,6.8,17553,210,51,468,1886,21.0,1666.9
4524888119,1,12,3,0,4,5,3,1,1,0,0,15131,6.8,17618,223,44,-735,46,22.3,1513.1,17,2,1,5,4,5,0,0,0,0,15866,7.0,17572,221,55,735,-46,22.1,1586.6
4521451457,1,63,0,1,5,7,4,0,0,0,0,15691,6.8,17738,190,60,-854,-1069,19.0,1569.1,17,1,0,7,5,5,2,1,1,0,16545,7.0,18807,227,52,854,1069,22.7,1654.5
4516541266,0,51,1,0,2,5,4,1,0,1,0,14772,6.8,17784,214,59,-2395,-2173,21.4,1477.2,15,2,1,5,2,5,1,1,0,0,17167,7.4,19957,258,68,2395,2173,25.8,1716.7
4516176117,0,17,1,0,3,5,1,1,1,0,0,15577,6.8,17552,220,48,-546,-1470,22.0,1557.7,18,4,1,5,3,7,0,0,0,0,16123,7.2,19022,229,52,546,1470,22.9,1612.3
4517665139,0,19,4,0,4,8,5,0,0,0,0,15264,6.4,16327,208,44,-3212,-1661,20.8,1526.4,19,5,1,8,4,10,0,0,0,0,18476,7.0,17988,217,42,3212,1661,21.7,1847.6
4524181297,0,14,4,1,11,6,17,0,0,0,0,18212,7.0,18286,201,47,1924,1938,20.1,1821.2,14,3,0,6,11,5,0,0,0,0,16288,6.6,16348,212,52,-1924,-1938,21.2,1628.8
4496666783,0,19,2,1,2,5,1,0,0,0,0,14321,6.4,16217,203,44,-1296,-382,20.3,1432.1,18,6,0,5,2,5,1,1,0,0,15617,6.6,16599,226,38,1296,382,22.6,1561.7
4449452387,0,18,1,0,5,5,1,1,1,0,1,15891,6.4,15926,179,36,-498,-1785,17.9,1589.1,13,3,1,5,5,4,0,0,0,0,16389,6.8,17711,196,55,498,1785,19.6,1638.9
4520853492,0,19,2,0,11,7,14,1,0,1,0,18361,7.0,18709,234,43,1531,1680,23.4,1836.1,12,2,1,7,11,13,1,1,0,0,16830,6.8,17029,207,44,-1531,-1680,20.7,1683.0
4518437302,0,14,2,0,3,7,3,0,0,0,0,14501,6.6,16545,195,64,-2930,-2779,19.5,1450.1,17,5,1,7,3,5,1,1,0,0,17431,7.2,19324,239,60,2930,2779,23.9,1743.1
4527166498,1,17,2,1,13,5,21,1,1,0,0,19680,7.2,18528,204,44,5397,2928,20.4,1968.0,17,4,0,5,13,5,0,0,0,0,14283,6.4,15600,175,38,-5397,-2928,17.5,1428.3
4492858161,1,19,3,1,13,2,10,0,0,0,1,20998,7.2,19521,228,53,8347,5234,22.8,2099.8,16,1,0,2,13,0,0,0,0,0,12651,5.8,14287,181,35,-8347,-5234,18.1,1265.1
4478754286,0,16,2,0,8,15,9,1,1,0,0,15797,6.2,15229,168,34,-4801,-5205,16.8,1579.7,16,5,1,15,8,14,0,0,0,0,20598,7.4,20434,219,50,4801,5205,21.9,2059.8
4525314215,0,16,2,1,5,4,2,0,0,0,0,15372,7.0,17632,228,48,-443,-732,22.8,1537.2,44,5,0,4,5,3,0,0,0,0,15815,7.2,18364,237,56,443,732,23.7,1581.5
4444970542,1,63,0,0,8,3,11,1,1,0,0,17701,7.2,19075,246,52,2252,1577,24.6,1770.1,14,2,1,3,8,3,0,0,0,0,15449,6.8,17498,228,46,-2252,-1577,22.8,1544.9
4524250490,1,16,3,0,6,4,1,0,0,0,0,16327,7.0,18521,190,59,1570,1320,19.0,1632.7,16,1,1,4,6,1,1,1,0,0,14757,6.8,17201,214,56,-1570,-1320,21.4,1475.7
4507113802,1,16,2,1,14,8,20,1,0,1,1,21070,7.2,19275,219,46,4266,2076,21.9,2107.0,15,2,0,8,14,10,1,1,0,0,16804,7.0,17199,191,49,-4266,-2076,19.1,1680.4
4525312579,0,80,5,0,6,7,3,0,0,0,0,15894,7.0,17808,212,52,-1019,-1564,21.2,1589.4,23,7,1,7,6,4,1,1,0,0,16913,7.2,19372,229,44,1019,1564,22.9,1691.3
4509433346,1,13,1,1,4,5,5,1,1,0,0,15057,6.8,16805,220,39,-1548,-1574,22.0,1505.7,16,2,0,5,4,4,0,0,0,0,16605,6.8,18379,247,43,1548,1574,24.7,1660.5
4527186536,0,18,0,1,4,7,5,1,1,0,0,16640,7.0,18123,223,60,159,-369,22.3,1664.0,10,2,0,7,4,4,1,0,1,0,16481,7.2,18492,214,44,-159,369,21.4,1648.1
4458803817,0,15,5,1,11,8,13,0,0,0,1,18723,6.8,17268,188,35,1844,-34,18.8,1872.3,19,0,0,8,11,6,1,1,0,0,16879,6.6,17302,210,40,-1844,34,21.0,1687.9
4522520315,0,15,4,1,10,3,11,0,0,0,0,18719,7.4,19257,236,52,3523,1757,23.6,1871.9,14,0,0,3,10,2,1,1,0,0,15196,6.6,17500,220,64,-3523,-1757,22.0,1519.6
4453159239,1,13,3,0,5,10,3,0,0,0,0,15067,6.6,16500,203,38,-3574,-387,20.3,1506.7,11,0,1,10,5,14,1,0,1,0,18641,6.6,16887,218,40,3574,387,21.8,1864.1
4466272322,1,15,4,1,6,3,8,1,1,0,1,18247,7.0,18839,235,59,3400,2400,23.5,1824.7,39,1,0,3,6,3,1,0,1,0,14847,6.6,16439,209,48,-3400,-2400,20.9,1484.7
4495318581,1,15,3,1,6,3,9,1,1,0,0,16233,7.0,18524,215,60,1081,199,21.5,1623.3,13,3,0,3,6,1,0,0,0,0,15152,7.2,18325,220,60,-1081,-199,22.0,1515.2
4508196606,1,17,2,1,9,2,12,2,1,1,0,17611,7.0,18390,232,45,3878,3016,23.2,1761.1,18,2,0,2,9,4,0,0,0,0,13733,6.4,15374,205,44,-3878,-3016,20.5,1373.3
4520501061,1,14,3,0,6,6,6,0,0,0,0,17023,7.2,19264,255,66,671,804,25.5,1702.3,18,0,1,6,6,10,0,0,0,0,16352,6.8,18460,231,60,-671,-804,23.1,1635.2
4518196735,0,14,3,1,5,4,6,2,1,1,0,16982,6.8,17866,225,34,1935,162,22.5,1698.2,17,4,0,4,5,6,0,0,0,0,15047,6.8,17704,208,64,-1935,-162,20.8,1504.7
4484098460,1,83,3,0,6,6,2,1,1,0,0,16995,7.6,19978,241,64,-418,185,24.1,1699.5,14,1,1,6,6,8,0,0,0,0,17413,7.4,19793,237,73,418,-185,23.7,1741.3
4508781088,1,16,2,0,7,7,7,1,0,1,0,17215,7.0,18989,256,47,324,2076,25.6,1721.5,19,5,1,7,7,13,0,0,0,0,16891,6.6,16913,234,42,-324,-2076,23.4,1689.1
4482504692,0,17,3,0,7,2,5,0,0,0,0,16503,7.0,19371,218,51,2169,2322,21.8,1650.3,13,5,1,2,7,4,1,1,0,0,14334,6.6,17049,220,56,-2169,-2322,22.0,1433.4
4517734414,1,12,1,1,10,2,5,1,1,0,0,18717,7.4,20051,247,57,4865,4641,24.7,1871.7,15,0,0,2,10,4,0,0,0,0,13852,6.6,15410,191,32,-4865,-4641,19.1,1385.2
4522599677,0,17,1,1,4,1,4,1,1,0,0,16223,7.2,19667,232,66,1423,1022,23.2,1622.3,14,5,0,1,4,1,1,0,1,0,14800,7.0,18645,242,68,-1423,-1022,24.2,1480.0
4496025643,1,18,1,0,10,7,9,0,0,0,0,18485,7.4,19949,228,52,2300,2148,22.8,1848.5,16,3,1,7,10,6,0,0,0,0,16185,7.2,17801,187,43,-2300,-2148,18.7,1618.5
4477069725,1,16,3,0,5,6,7,1,1,0,0,16539,7.4,19570,242,62,-65,1208,24.2,1653.9,19,6,1,6,5,7,0,0,0,0,16604,7.0,18362,230,43,65,-1208,23.0,1660.4
4520799474,1,11,1,1,18,10,15,1,1,0,0,21352,7.6,20771,224,59,4287,3938,22.4,2135.2,13,0,0,10,18,11,0,0,0,0,17065,6.8,16833,135,35,-4287,-3938,13.5,1706.5
4439955992,0,12,0,1,1,8,2,0,0,0,0,13967,6.6,15942,196,52,-3789,-4083,19.6,1396.7,14,2,0,8,1,13,0,0,0,0,17756,7.4,20025,223,52,3789,4083,22.3,1775.6
4505988768,0,34,4,0,3,8,1,0,0,0,0,13960,6.2,15667,202,39,-4808,-4098,20.2,1396.0,16,3,1,8,3,9,1,1,0,0,18768,7.4,19765,241,73,4808,4098,24.1,1876.8
4523523934,0,10,2,0,5,13,3,0,0,0,0,15126,6.8,16897,206,31,-4864,-2252,20.6,1512.6,15,3,1,13,5,11,0,0,0,0,19990,7.4,19149,217,57,4864,2252,21.7,1999.0
4525941193,1,40,3,1,4,6,5,1,0,1,0,16368,7.0,18857,216,56,-180,-890,21.6,1636.8,13,4,0,6,4,5,1,1,0,0,16548,7.4,19747,224,56,180,890,22.4,1654.8
4507908715,0,16,3,0,3,5,2,0,0,0,0,14992,6.4,16189,214,53,-1984,-2084,21.4,1499.2,19,4,1,5,3,8,1,1,0,0,16976,6.8,18273,246,56,1984,2084,24.6,1697.6
4471153063,0,15,1,1,9,7,8,0,0,0,0,19122,7.2,19334,238,56,3089,1750,23.8,1912.2,12,1,0,7,9,10,0,0,0,0,16033,6.8,17584,169,52,-3089,-1750,16.9,1603.3
4519249108,0,16,3,0,0,6,0,0,0,0,0,12698,6.2,15550,195,48,-3784,-4019,19.5,1269.8,13,2,1,6,0,11,1,1,0,0,16482,7.4,19569,222,60,3784,4019,22.2,1648.2
4520888635,1,16,4,1,7,6,7,0,0,0,0,16160,6.8,17319,206,60,-106,-62,20.6,1616.0,57,2,0,6,7,5,0,0,0,0,16266,6.8,17381,229,36,106,62,22.9,1626.6
4517647905,1,14,3,1,6,8,7,1,1,0,0,16058,7.0,17515,217,51,-677,-1382,21.7,1605.8,59,5,0,8,6,6,1,0,1,0,16735,7.2,18897,214,56,677,1382,21.4,1673.5
4524760091,1,9,1,0,4,8,4,0,0,0,0,16009,7.0,17560,214,47,-1917,823,21.4,1600.9,14,1,1,8,4,11,1,1,0,1,17926,6.8,16737,198,36,1917,-823,19.8,1792.6
4486777926,0,18,4,1,6,6,8,0,0,0,0,15380,7.0,17373,193,55,-2064,-2639,19.3,1538.0,36,5,0,6,6,5,0,0,0,0,17444,7.6,20012,242,60,2064,2639,24.2,1744.4
4520801995,0,17,2,0,2,10,1,0,0,0,0,15239,7.0,18073,232,52,-3449,-1995,23.2,1523.9,17,0,1,10,2,13,1,1,0,0,18688,7.6,20068,231,57,3449,1995,23.1,1868.8
4522403826,0,16,3,1,6,8,11,0,0,0,0,15758,7.0,16369,204,34,-1561,-1578,20.4,1575.8,17,1,0,8,6,9,0,0,0,0,17319,7.0,17947,213,48,1561,1578,21.3,1731.9
4513110398,1,19,1,0,5,6,3,1,1,0,0,14820,6.4,16224,167,47,-1671,-1100,16.7,1482.0,17,4,1,6,5,10,0,0,0,0,16491,6.8,17324,223,52,1671,1100,22.3,1649.1
4526315432,0,13,1,0,7,11,10,1,1,0,0,17124,6.8,17615,228,43,-1565,-173,22.8,1712.4,35,2,1,11,7,18,0,0,0,0,18689,7.0,17788,173,58,1565,173,17.3,1868.9
4432139971,0,12,2,0,2,6,1,0,0,0,0,14247,6.8,16785,216,56,-1179,-557,21.6,1424.7,12,3,1,6,2,3,0,0,0,0,15426,6.8,17342,194,52,1179,557,19.4,1542.6
4441908556,1,17,2,1,10,6,15,1,1,0,0,18176,7.0,18682,216,47,2287,376,21.6,1817.6,19,3,0,6,10,3,0,0,0,0,15889,7.2,18306,202,52,-2287,-376,20.2,1588.9
4527309087,1,18,4,1,11,6,7,1,1,0,0,17795,7.2,19039,213,45,1395,1943,21.3,1779.5,14,2,0,6,11,8,0,0,0,0,16400,6.8,17096,198,50,-1395,-1943,19.8,1640.0
4515916030,1,87,3,0,12,4,15,0,0,0,0,18596,7.2,18850,188,55,3378,3168,18.8,1859.6,15,3,1,4,12,6,1,1,0,0,15218,6.4,15682,207,43,-3378,-3168,20.7,1521.8
4520827057,0,16,3,1,2,5,3,0,0,0,0,15053,6.8,17983,248,53,-3526,-1273,24.8,1505.3,37,3,0,5,2,9,0,0,0,0,18579,7.2,19256,234,53,3526,1273,23.4,1857.9
4516146115,0,37,2,0,6,8,4,0,0,0,0,16051,6.8,17315,199,58,-485,-353,19.9,1605.1,18,1,1,8,6,8,1,1,0,0,16536,6.8,17668,199,44,485,353,19.9,1653.6
4474136526,1,17,5,0,7,1,8,0,0,0,0,16506,7.2,18669,226,36,2037,1291,22.6,1650.6,35,3,1,1,7,0,1,1,0,0,14469,6.6,17378,217,80,-2037,-1291,21.7,1446.9
4500155782,1,16,4,0,7,7,7,0,0,0,0,17250,7.2,18870,255,55,160,999,25.5,1725.0,15,2,1,7,7,5,0,0,0,0,17090,6.8,17871,231,52,-160,-999,23.1,1709.0
4513377157,1,16,8,0,4,7,7,1,0,1,0,15726,7.2,17885,222,60,-1614,-418,22.2,1572.6,20,5,1,7,4,9,1,1,0,0,17340,7.0,18303,239,56,1614,418,23.9,1734.0
4500650669,0,16,3,0,5,6,3,0,0,0,0,16032,7.0,18159,229,58,-478,-389,22.9,1603.2,23,3,1,6,5,6,1,1,0,0,16510,7.0,18548,221,48,478,389,22.1,1651.0
4527258307,1,17,4,1,6,0,9,0,0,0,0,17774,6.8,18689,226,65,4232,1501,22.6,1777.4,43,4,0,0,6,0,0,0,0,0,13542,7.0,17188,218,62,-4232,-1501,21.8,1354.2
4467567796,0,18,1,1,9,8,10,2,1,1,0,17431,6.8,18061,178,60,253,-121,17.8,1743.1,13,2,0,8,9,6,0,0,0,0,17178,7.0,18182,224,56,-253,121,22.4,1717.8
4499995940,1,16,3,0,5,6,3,0,0,0,0,16177,7.0,18401,216,60,-126,463,21.6,1617.7,17,3,1,6,5,6,2,1,1,0,16303,6.6,17938,215,58,126,-463,21.5,1630.3
4512089912,1,22,2,1,5,6,4,0,0,0,0,15218,6.4,16539,211,48,-828,421,21.1,1521.8,14,4,0,6,5,10,0,0,0,0,16046,6.6,16118,206,34,828,-421,20.6,1604.6
4511899232,1,22,6,0,6,7,6,0,0,0,0,17170,7.0,18110,243,60,959,2183,24.3,1717.0,17,6,1,7,6,10,0,0,0,0,16211,6.4,15927,194,36,-959,-2183,19.4,1621.1
4500293065,1,17,5,0,6,1,12,1,1,0,0,16009,6.8,17605,194,51,685,333,19.4,1600.9,17,1,1,1,6,0,0,0,0,0,15324,6.6,17272,252,72,-685,-333,25.2,1532.4
4526716205,1,16,3,0,2,4,2,1,0,1,1,16417,6.8,18414,249,63,1086,1804,24.9,1641.7,21,2,1,4,2,8,1,1,0,0,15331,6.6,16610,219,52,-1086,-1804,21.9,1533.1
4510577994,1,10,3,0,5,7,2,0,0,0,0,16256,6.8,17771,247,48,-862,-406,24.7,1625.6,17,2,1,7,5,10,1,1,0,0,17118,7.0,18177,200,60,862,406,20.0,1711.8
4526662681,0,15,5,0,12,10,22,0,0,0,0,19390,7.2,18011,200,40,993,425,20.0,1939.0,20,4,1,10,12,12,0,0,0,0,18397,7.0,17586,190,36,-993,-425,19.0,1839.7
4464829363,0,163,1,0,4,4,4,1,1,0,0,15639,7.0,18956,230,60,-1233,270,23.0,1563.9,17,5,1,4,4,5,0,0,0,0,16872,7.2,18686,243,56,1233,-270,24.3,1687.2
4527527464,1,17,3,1,9,5,7,1,0,1,0,17554,7.0,18464,240,44,2402,2330,24.0,1755.4,18,4,0,5,9,3,0,0,0,0,15152,6.4,16134,172,54,-2402,-2330,17.2,1515.2
4514199075,1,18,2,1,4,6,4,0,0,0,0,16317,7.0,17928,228,50,-248,-1557,22.8,1631.7,20,3,0,6,4,4,2,1,1,0,16565,7.2,19485,225,59,248,1557,22.5,1656.5
4519910436,1,80,1,1,6,4,4,1,1,0,0,16360,6.8,17624,234,49,1447,-149,23.4,1636.0,23,2,0,4,6,2,0,0,0,0,14913,7.0,17773,214,48,-1447,149,21.4,1491.3
4497643645,0,14,4,0,4,8,5,1,1,0,0,15483,6.6,17110,213,47,-3045,-1634,21.3,1548.3,18,3,1,8,4,11,0,0,0,0,18528,7.2,18744,249,40,3045,1634,24.9,1852.8
4522611755,1,16,3,1,7,4,5,1,1,0,0,17773,7.0,18860,262,48,2521,2240,26.2,1777.3,19,3,0,4,7,4,0,0,0,0,15252,6.6,16620,197,51,-2521,-2240,19.7,1525.2
4500841248,0,39,0,0,7,6,7,1,1,0,0,16438,7.0,17815,214,37,-370,-1681,21.4,1643.8,14,1,1,6,7,7,1,0,1,0,16808,7.4,19496,234,51,370,1681,23.4,1680.8
4520730804,1,21,6,1,3,1,2,2,1,1,0,15530,6.8,17715,235,52,1219,232,23.5,1553.0,42,4,0,1,3,3,0,0,0,0,14311,6.8,17483,238,46,-1219,-232,23.8,1431.1
4499613300,0,14,0,0,3,7,1,0,0,0,0,14428,6.6,16819,215,52,-1217,-539,21.5,1442.8,62,3,1,7,3,11,1,1,0,0,15645,6.8,17358,216,32,1217,539,21.6,1564.5
4512915759,0,16,4,0,1,5,2,0,0,0,0,13286,6.2,15085,187,48,-4179,-3823,18.7,1328.6,20,4,1,5,1,4,1,1,0,0,17465,7.0,18908,236,67,4179,3823,23.6,1746.5
4489800281,1,9,2,0,6,8,7,0,0,0,0,16730,7.0,17780,208,49,-828,-1255,20.8,1673.0,14,1,1,8,6,7,0,0,0,0,17558,7.2,19035,233,60,828,1255,23.3,1755.8
4497696872,0,15,3,0,6,4,6,0,0,0,0,15807,6.8,17244,221,33,239,1281,22.1,1580.7,16,2,1,4,6,3,1,1,0,0,15568,6.6,15963,213,44,-239,-1281,21.3,1556.8
4504929560,1,15,4,0,10,5,7,0,0,0,0,17954,7.2,19474,201,62,2427,2365,20.1,1795.4,19,1,1,5,10,6,0,0,0,0,15527,6.8,17109,224,37,-2427,-2365,22.4,1552.7
4407738489,0,50,1,1,6,12,4,0,0,0,0,15809,6.8,17592,198,30,-3854,-1813,19.8,1580.9,14,1,0,12,6,15,0,0,0,0,19663,7.2,19405,238,39,3854,1813,23.8,1966.3
4523746056,1,84,3,1,10,5,12,0,0,0,1,19938,7.0,18437,222,44,4534,1707,22.2,1993.8,14,1,0,5,10,4,1,1,0,0,15404,6.6,16730,214,52,-4534,-1707,21.4,1540.4
4499840707,0,16,3,0,4,4,4,1,1,0,0,15977,6.8,17115,224,56,1033,1209,22.4,1597.7,81,4,1,4,4,3,0,0,0,0,14944,6.4,15906,185,52,-1033,-1209,18.5,1494.4
4522667273,0,13,3,0,5,10,4,0,0,0,0,16377,7.0,17958,228,45,-2167,-1447,22.8,1637.7,13,2,1,10,5,12,1,0,1,0,18544,7.2,19405,216,65,2167,1447,21.6,1854.4
4506788897,0,94,3,0,3,9,3,0,0,0,0,14033,6.2,15049,184,44,-3078,-3306,18.4,1403.3,22,2,1,9,3,10,1,1,0,0,17111,7.4,18355,204,52,3078,3306,20.4,1711.1
4510124287,1,17,3,0,6,6,5,0,0,0,0,17262,7.0,18939,222,64,1371,2221,22.2,1726.2,21,2,1,6,6,7,1,1,0,0,15891,6.6,16718,195,48,-1371,-2221,19.5,1589.1
4523101614,1,14,1,1,5,3,2,0,0,0,0,15800,7.0,18222,236,40,697,700,23.6,1580.0,13,1,0,3,5,6,1,0,1,0,15103,6.8,17522,209,78,-697,-700,20.9,1510.3
4518207092,0,22,1,0,5,11,6,0,0,0,0,16190,7.0,17466,215,59,-3531,-1781,21.5,1619.0,20,3,1,11,5,21,1,1,0,0,19721,7.2,19247,236,60,3531,1781,23.6,1972.1
4524986663,1,14,2,1,8,4,5,0,0,0,0,17198,6.8,17495,226,37,2973,1838,22.6,1719.8,32,4,0,4,8,5,1,1,0,0,14225,6.2,15657,141,56,-2973,-1838,14.1,1422.5
4526620747,1,22,1,1,6,4,10,1,1,0,0,16190,7.0,17477,233,36,1267,920,23.3,1619.0,13,2,0,4,6,4,0,0,0,0,14923,6.4,16557,190,59,-1267,-920,19.0,1492.3
4524879680,0,14,1,1,4,6,5,0,0,0,0,14868,6.6,16330,182,48,-2281,-1594,18.2,1486.8,14,0,0,6,4,9,1,1,0,0,17149,6.8,17924,209,72,2281,1594,20.9,1714.9
4462000850,1,24,0,1,5,2,5,1,1,0,0,17092,7.2,19011,242,63,2788,1325,24.2,1709.2,17,2,0,2,5,2,0,0,0,0,14304,6.8,17686,215,44,-2788,-1325,21.5,1430.4
4524808186,0,19,2,1,7,8,10,1,1,0,0,15719,6.4,16209,172,25,-833,-1553,17.2,1571.9,17,2,0,8,7,7,0,0,0,0,16552,6.8,17762,201,47,833,1553,20.1,1655.2
4524793745,1,16,2,0,11,10,17,1,1,0,0,18858,7.4,19797,214,62,878,2182,21.4,1885.8,15,2,1,10,11,11,0,0,0,0,17980,6.8,17615,204,28,-878,-2182,20.4,1798.0
4504871499,0,16,0,0,2,7,4,1,1,0,0,14206,7.0,17591,210,56,-2865,-1866,21.0,1420.6,13,3,1,7,2,7,0,0,0,0,17071,7.2,19457,248,60,2865,1866,24.8,1707.1
4525239809,0,16,1,0,4,7,3,0,0,0,0,15122,6.8,17880,216,53,-1740,-46,21.6,1512.2,15,2,1,7,4,7,0,0,0,0,16862,7.0,17926,195,53,1740,46,19.5,1686.2
4509176495,1,18,3,1,8,6,11,0,0,0,0,16870,6.6,16180,212,44,829,-929,21.2,1687.0,19,5,0,6,8,5,1,1,0,0,16041,6.6,17109,245,46,-829,929,24.5,1604.1
4491765762,0,15,3,1,5,3,7,1,1,0,0,16885,7.2,18326,229,52,2657,2468,22.9,1688.5,15,1,0,3,5,4,0,0,0,0,14228,6.4,15858,200,36,-2657,-2468,20.0,1422.8
4526251944,0,22,3,0,6,10,6,1,1,0,0,16972,7.0,18035,210,52,-1079,-2292,21.0,1697.2,16,2,1,10,6,6,0,0,0,0,18051,7.4,20327,209,68,1079,2292,20.9,1805.1
4426767631,1,18,1,1,7,1,8,0,0,0,0,17177,7.0,19119,223,40,3368,2352,22.3,1717.7,16,3,0,1,7,1,1,1,0,0,13809,6.6,16767,205,48,-3368,-2352,20.5,1380.9
4524971748,1,21,3,1,5,3,8,1,1,0,0,16751,6.8,17829,247,39,2197,1707,24.7,1675.1,11,1,0,3,5,1,0,0,0,0,14554,6.2,16122,193,60,-2197,-1707,19.3,1455.4
4526761574,1,79,2,0,3,3,2,0,0,0,0,15471,6.8,18349,219,51,-251,560,21.9,1547.1,14,2,1,3,3,7,0,0,0,0,15722,7.0,17789,255,52,251,-560,25.5,1572.2
4479666137,0,14,0,0,7,6,6,0,0,0,0,16482,7.0,17266,229,43,-1243,-604,22.9,1648.2,67,1,1,6,7,15,0,0,0,0,17725,7.0,17870,194,56,1243,604,19.4,1772.5
4450756044,1,17,5,1,9,1,12,1,1,0,1,19127,7.2,19350,253,56,5062,1996,25.3,1912.7,14,2,0,1,9,1,1,0,1,0,14065,6.6,17354,215,56,-5062,-1996,21.5,1406.5
4516320607,0,12,1,0,7,5,6,1,1,0,0,15900,7.0,18137,206,48,-435,-960,20.6,1590.0,34,2,1,5,7,4,0,0,0,0,16335,7.0,19097,218,77,435,960,21.8,1633.5
4509560405,1,15,0,0,19,4,22,1,1,0,0,22173,7.4,20408,234,45,7154,6032,23.4,2217.3,12,0,1,4,19,5,1,0,1,0,15019,6.0,14376,189,38,-7154,-6032,18.9,1501.9
4514023677,0,15,3,1,3,6,3,0,0,0,0,15165,6.8,17462,218,62,-1995,-1194,21.8,1516.5,19,4,0,6,3,13,0,0,0,0,17160,7.2,18656,251,55,1995,1194,25.1,1716.0
4478061108,0,16,4,0,4,9,5,0,0,0,0,15293,6.6,16350,226,46,-2004,-1407,22.6,1529.3,18,4,1,9,4,12,1,0,1,0,17297,6.8,17757,227,39,2004,1407,22.7,1729.7
4515642015,0,15,5,0,9,4,11,1,1,0,0,17341,7.0,18528,209,48,1513,1585,20.9,1734.1,21,4,1,4,9,8,0,0,0,0,15828,7.0,16943,222,40,-1513,-1585,22.2,1582.8
4521052403,1,15,1,1,8,3,6,0,0,0,0,17263,7.2,19913,234,65,3181,3298,23.4,1726.3,11,2,0,3,8,3,2,1,1,0,14082,6.8,16615,159,51,-3181,-3298,15.9,1408.2
4498697994,1,15,2,1,10,6,13,1,1,0,0,18436,6.8,18190,250,51,2312,1079,25.0,1843.6,16,1,0,6,10,8,0,0,0,0,16124,6.8,17111,181,48,-2312,-1079,18.1,1612.4
4525810853,1,17,1,1,6,1,7,0,0,0,0,16561,7.4,19634,226,63,1852,2435,22.6,1656.1,16,2,0,1,6,2,1,1,0,0,14709,7.0,17199,238,60,-1852,-2435,23.8,1470.9
4524806566,0,15,2,0,6,13,9,0,0,0,0,16291,6.6,16699,191,38,-3622,-2561,19.1,1629.1,146,2,1,13,6,12,0,0,0,0,19913,7.0,19260,223,39,3622,2561,22.3,1991.3
4489787025,0,16,4,1,3,2,2,0,0,0,0,15426,7.0,17927,202,64,566,-248,20.2,1542.6,132,5,0,2,3,0,0,0,0,0,14860,6.8,18175,249,52,-566,248,24.9,1486.0
4489906217,1,13,3,0,6,4,5,0,0,0,0,17047,7.2,19108,260,52,1604,1599,26.0,1704.7,14,0,1,4,6,5,1,1,0,0,15443,6.8,17509,209,44,-1604,-1599,20.9,1544.3
4492740165,1,19,2,0,8,7,8,0,0,0,0,17298,6.4,16912,233,43,326,1472,23.3,1729.8,13,5,1,7,8,11,1,1,0,0,16972,6.4,15440,210,32,-326,-1472,21.0,1697.2
4436033771,0,75,4,0,6,6,6,0,0,0,0,16400,7.0,18543,210,57,-1004,230,21.0,1640.0,17,2,1,6,6,7,1,1,0,0,17404,7.0,18313,225,67,1004,-230,22.5,1740.4
4525115790,0,22,2,0,2,4,3,0,0,0,0,15847,7.0,17815,241,48,647,-710,24.1,1584.7,12,5,1,4,2,5,1,1,0,0,15200,7.2,18525,221,46,-647,710,22.1,1520.0
4463402176,1,21,6,0,9,7,10,0,0,0,0,17329,6.8,17577,223,48,675,691,22.3,1732.9,28,6,1,7,9,6,2,1,1,0,16654,6.8,16886,227,30,-675,-691,22.7,1665.4
4499734031,0,36,1,0,3,4,5,1,1,0,0,15382,7.0,18298,239,59,39,238,23.9,1538.2,14,1,1,4,3,7,0,0,0,0,15343,7.0,18060,225,40,-39,-238,22.5,1534.3
4489597845,0,14,2,0,6,7,3,0,0,0,0,16621,7.0,19161,231,60,-249,1420,23.1,1662.1,16,4,1,7,6,6,1,1,0,0,16870,6.8,17741,203,60,249,-1420,20.3,1687.0
4447674252,0,11,2,0,2,9,2,0,0,0,0,13785,6.4,15847,195,44,-6199,-4997,19.5,1378.5,30,3,1,9,2,6,1,0,1,2,19984,7.6,20844,249,57,6199,4997,24.9,1998.4
4491586738,1,13,1,1,10,5,4,1,0,1,1,19634,7.2,19705,242,69,3966,2905,24.2,1963.4,12,0,0,5,10,8,1,1,0,0,15668,6.6,16800,203,48,-3966,-2905,20.3,1566.8
4495074532,1,33,2,0,8,3,6,0,0,0,0,16154,7.0,18075,192,52,1764,1515,19.2,1615.4,38,1,1,3,8,2,2,1,1,0,14390,6.4,16560,210,44,-1764,-1515,21.0,1439.0
4515778115,0,16,2,0,7,8,12,0,0,0,0,17737,7.0,18616,234,44,648,617,23.4,1773.7,15,4,1,8,7,10,1,1,0,0,17089,7.0,17999,202,51,-648,-617,20.2,1708.9
4526204172,0,15,2,0,6,6,5,0,0,0,0,16259,7.2,18818,232,43,-147,184,23.2,1625.9,17,2,1,6,6,6,1,1,0,0,16406,7.0,18634,237,51,147,-184,23.7,1640.6
4468449125,1,17,3,1,7,6,10,1,1,0,0,17097,7.2,18614,220,71,620,-328,22.0,1709.7,14,2,0,6,7,4,0,0,0,0,16477,7.2,18942,207,52,-620,328,20.7,1647.7
4464565821,0,20,5,0,4,9,3,1,1,0,0,15211,6.8,17951,225,56,-3848,-2091,22.5,1521.1,16,2,1,9,4,14,1,0,1,0,19059,7.2,20042,238,68,3848,2091,23.8,1905.9
4458560813,1,18,2,1,10,7,13,0,0,0,0,17674,7.0,18595,209,48,1269,788,20.9,1767.4,11,2,0,7,10,6,0,0,0,0,16405,7.0,17807,205,32,-1269,-788,20.5,1640.5
4473393506,1,16,1,1,11,4,13,1,1,0,0,19035,7.4,19600,207,52,4481,3872,20.7,1903.5,15,2,0,4,11,4,0,0,0,0,14554,6.4,15728,189,43,-4481,-3872,18.9,1455.4
4510216676,1,17,1,1,7,5,10,0,0,0,0,17168,7.0,17989,233,52,1089,196,23.3,1716.8,12,6,0,5,7,4,1,1,0,0,16079,6.8,17793,235,52,-1089,-196,23.5,1607.9
4524443617,1,17,3,0,4,1,5,1,1,0,0,16041,7.0,18214,233,44,1891,603,23.3,1604.1,39,2,1,1,4,1,0,0,0,0,14150,7.0,17611,214,47,-1891,-603,21.4,1415.0
4521318452,1,17,0,0,9,8,8,1,0,1,0,17657,7.2,19166,227,56,545,1033,22.7,1765.7,14,2,1,8,9,9,1,1,0,0,17112,7.0,18133,198,40,-545,-1033,19.8,1711.2
4511536801,1,14,2,1,3,4,4,0,0,0,0,16125,7.2,20079,246,68,-624,1141,24.6,1612.5,13,3,0,4,3,6,1,1,0,0,16749,7.0,18938,271,60,624,-1141,27.1,1674.9
4471439102,0,26,4,0,4,12,6,0,0,0,0,15358,6.6,16660,213,32,-3859,-2011,21.3,1535.8,20,3,1,12,4,10,1,1,0,0,19217,6.8,18671,216,56,3859,2011,21.6,1921.7
4524404362,1,58,3,0,9,7,12,1,1,0,0,17524,7.2,18949,185,57,1076,1282,18.5,1752.4,16,4,1,7,9,6,0,0,0,0,16448,6.6,17667,209,52,-1076,-1282,20.9,1644.8
4490249955,0,30,3,0,8,5,9,0,0,0,0,16984,7.2,18842,225,60,1229,1913,22.5,1698.4,15,2,1,5,8,3,0,0,0,0,15755,6.8,16929,214,36,-1229,-1913,21.4,1575.5
4526640104,0,38,0,1,4,14,2,0,0,0,0,14963,6.2,15662,170,48,-6047,-3060,17.0,1496.3,19,4,0,14,4,20,2,1,1,1,21010,7.0,18722,203,41,6047,3060,20.3,2101.0
4523694899,1,18,5,0,14,7,13,1,1,0,1,20488,6.8,17390,201,52,4535,1970,20.1,2048.8,18,6,1,7,14,5,0,0,0,0,15953,6.2,15420,191,40,-4535,-1970,19.1,1595.3
4516538758,1,12,9,0,2,5,3,2,1,1,0,14961,6.6,17746,210,56,-2377,-2713,21.0,1496.1,39,1,1,5,2,4,0,0,0,0,17338,7.6,20459,269,64,2377,2713,26.9,1733.8
4511859865,1,17,3,0,3,3,2,1,1,0,0,15584,6.8,17413,230,68,639,-470,23.0,1558.4,35,2,1,3,3,2,1,0,1,0,14945,7.0,17883,215,44,-639,470,21.5,1494.5
4520703229,1,59,2,0,5,5,4,0,0,0,0,16355,6.6,17606,221,52,-1874,-1002,22.1,1635.5,17,1,1,5,5,5,1,0,1,2,18229,7.2,18608,205,60,1874,1002,20.5,1822.9
4527581162,0,95,4,1,9,6,8,1,1,0,1,19585,7.2,19143,244,51,3781,1033,24.4,1958.5,17,1,0,6,9,7,0,0,0,0,15804,7.0,18110,201,64,-3781,-1033,20.1,1580.4
4469636302,0,13,1,1,5,7,5,0,0,0,0,15576,6.6,16352,221,35,-887,-1878,22.1,1557.6,14,2,0,7,5,7,1,0,1,0,16463,7.0,18230,197,68,887,1878,19.7,1646.3
4442489042,1,11,1,1,5,1,5,0,0,0,0,17467,7.4,20584,245,76,3407,3210,24.5,1746.7,85,0,0,1,5,3,0,0,0,0,14060,6.8,17374,214,59,-3407,-3210,21.4,1406.0
4509803482,0,16,2,1,8,7,11,0,0,0,0,16776,6.4,15799,196,39,357,-26,19.6,1677.6,16,3,0,7,8,7,0,0,0,0,16419,6.2,15825,186,36,-357,26,18.6,1641.9
4487524071,1,15,3,1,5,2,6,1,1,0,0,16513,6.8,18070,203,48,3537,2976,20.3,1651.3,18,1,0,2,5,2,0,0,0,0,12976,6.4,15094,186,36,-3537,-2976,18.6,1297.6
4466740420,1,24,3,0,4,4,7,1,1,0,0,15222,6.6,16755,207,51,7,-685,20.7,1522.2,19,2,1,4,4,4,0,0,0,0,15215,6.8,17440,212,52,-7,685,21.2,1521.5
4523721011,0,13,2,0,7,9,9,1,1,0,0,16675,7.0,17477,205,30,-938,-1180,20.5,1667.5,19,0,1,9,7,12,0,0,0,0,17613,7.2,18657,199,67,938,1180,19.9,1761.3
4471395182,1,17,2,0,13,12,13,0,0,0,0,19714,7.2,18151,186,40,1460,2108,18.6,1971.4,15,1,1,12,13,13,0,0,0,0,18254,6.6,16043,200,35,-1460,-2108,20.0,1825.4
4523336843,1,15,0,1,6,2,5,1,0,1,0,17338,7.4,19907,256,63,2533,1568,25.6,1733.8,16,5,0,2,6,3,0,0,0,0,14805,7.2,18339,242,53,-2533,-1568,24.2,1480.5
4521058340,1,18,1,0,7,4,8,1,1,0,0,17137,7.0,18628,240,45,2191,2220,24.0,1713.7,16,2,1,4,7,7,0,0,0,0,14946,6.4,16408,203,43,-2191,-2220,20.3,1494.6
4524013226,1,23,1,0,2,5,3,2,1,1,0,14974,7.0,18286,224,60,-726,-31,22.4,1497.4,15,5,1,5,2,5,0,0,0,0,15700,7.0,18317,216,61,726,31,21.6,1570.0
4517169650,0,26,3,0,2,5,5,0,0,0,0,14531,6.8,16999,222,56,-1711,-2183,22.2,1453.1,15,4,1,5,2,5,1,1,0,0,16242,7.2,19182,235,52,1711,2183,23.5,1624.2
4527040336,1,16,6,1,5,4,5,0,0,0,0,15452,6.6,16236,195,35,926,-849,19.5,1545.2,17,2,0,4,5,4,1,1,0,0,14526,6.8,17085,186,44,-926,849,18.6,1452.6
4510990676,1,19,2,1,10,2,12,1,0,1,0,19621,7.6,19733,209,56,6703,5604,20.9,1962.1,18,3,0,2,10,2,0,0,0,0,12918,5.8,14129,140,58,-6703,-5604,14.0,1291.8
4502759041,0,17,6,0,2,4,2,0,0,0,0,14747,6.8,18401,245,47,-1356,-501,24.5,1474.7,17,2,1,4,2,3,1,1,0,0,16103,7.0,18902,261,48,1356,501,26.1,1610.3
4470363141,1,16,4,1,6,7,6,0,0,0,0,17035,7.2,18588,235,60,501,-495,23.5,1703.5,14,3,0,7,6,4,0,0,0,0,16534,7.0,19083,207,60,-501,495,20.7,1653.4
4510908073,0,16,4,0,7,12,4,0,0,0,0,16115,7.0,17647,193,52,-3032,-1859,19.3,1611.5,14,4,1,12,7,7,0,0,0,0,19147,7.2,19506,243,47,3032,1859,24.3,1914.7
4521519484,0,18,3,0,3,5,5,0,0,0,0,14742,6.6,16162,241,38,-1620,-1442,24.1,1474.2,17,2,1,5,3,6,1,1,0,0,16362,7.0,17604,226,62,1620,1442,22.6,1636.2
4513491356,0,18,7,0,2,3,2,0,0,0,0,15143,7.0,18397,239,60,129,200,23.9,1514.3,19,2,1,3,2,4,1,1,0,0,15014,7.0,18197,224,56,-129,-200,22.4,1501.4
4520720657,1,16,5,0,3,3,3,1,0,1,0,16076,7.0,18079,238,52,1113,1392,23.8,1607.6,13,1,1,3,3,2,1,1,0,0,14963,6.6,16687,185,64,-1113,-1392,18.5,1496.3
4495119818,1,18,1,1,4,4,9,1,0,1,0,15405,6.8,17336,215,57,-601,-1965,21.5,1540.5,16,1,0,4,4,5,1,1,0,0,16006,7.2,19301,249,71,601,1965,24.9,1600.6
4521892508,0,16,4,1,4,8,4,1,1,0,0,15651,6.8,16945,201,48,-1990,-3002,20.1,1565.1,39,1,0,8,4,6,0,0,0,0,17641,7.4,19947,226,56,1990,3002,22.6,1764.1
4521879748,1,12,2,1,10,8,10,1,1,0,0,18787,7.0,18529,231,48,1876,1668,23.1,1878.7,56,3,0,8,10,10,0,0,0,0,16911,6.8,16861,203,28,-1876,-1668,20.3,1691.1
4522415316,0,15,1,1,6,3,6,0,0,0,0,15941,7.2,17560,228,33,1231,93,22.8,1594.1,84,1,0,3,6,3,0,0,0,0,14710,6.8,17467,212,43,-1231,-93,21.2,1471.0
4522204465,0,18,3,0,2,12,2,0,0,0,0,13844,6.6,15601,224,32,-5161,-4099,22.4,1384.4,17,3,1,12,2,10,1,1,0,0,19005,7.2,19700,200,58,5161,4099,20.0,1900.5
4476189386,0,16,3,1,7,7,8,0,0,0,0,17072,7.0,17587,228,52,166,-650,22.8,1707.2,14,2,0,7,7,8,2,1,1,0,16906,7.0,18237,223,50,-166,650,22.3,1690.6
4520554250,0,21,5,0,7,7,4,0,0,0,0,17319,7.0,18310,253,36,2209,1640,25.3,1731.9,14,6,1,7,7,6,2,1,1,0,15110,6.8,16670,159,49,-2209,-1640,15.9,1511.0
4513177731,1,17,2,1,11,3,8,1,1,0,0,18826,7.4,20300,225,48,3988,4246,22.5,1882.6,18,1,0,3,11,3,1,0,1,0,14838,6.4,16054,195,55,-3988,-4246,19.5,1483.8
4513002559,1,19,0,0,5,14,9,1,1,0,0,15423,6.8,16791,175,53,-6324,-3885,17.5,1542.3,14,1,1,14,5,14,1,0,1,1,21747,7.6,20676,233,44,6324,3885,23.3,2174.7
4491630754,1,17,6,0,7,8,8,0,0,0,0,15956,6.8,17011,191,51,-1206,-963,19.1,1595.6,19,5,1,8,7,7,1,1,0,0,17162,7.0,17974,243,44,1206,963,24.3,1716.2
4471147482,0,18,3,0,3,7,4,0,0,0,0,14459,6.6,16596,202,44,-2499,-1870,20.2,1445.9,19,1,1,7,3,13,1,1,0,0,16958,7.0,18466,238,40,2499,1870,23.8,1695.8
4508006237,1,10,3,0,4,8,5,0,0,0,0,14689,6.6,16546,174,55,-3860,-1719,17.4,1468.9,19,0,1,8,4,4,2,1,1,1,18549,7.2,18265,253,42,3860,1719,25.3,1854.9
4511153388,1,13,2,0,4,2,2,0,0,0,0,17005,7.2,19366,268,60,1973,1236,26.8,1700.5,15,3,1,2,4,0,1,1,0,0,15032,6.8,18130,241,72,-1973,-1236,24.1,1503.2
4432359708,1,12,6,0,2,5,1,0,0,0,0,13860,6.6,16835,193,52,-2807,-1537,19.3,1386.0,90,5,1,5,2,6,0,0,0,0,16667,6.8,18372,249,42,2807,1537,24.9,1666.7
4513734399,1,17,4,1,13,1,8,2,1,1,0,18595,7.6,21025,237,60,5236,5547,23.7,1859.5,12,2,0,1,13,1,0,0,0,0,13359,6.6,15478,199,52,-5236,-5547,19.9,1335.9
4524488615,0,64,4,1,12,6,18,1,0,1,1,19426,6.8,18749,218,37,4146,3141,21.8,1942.6,21,4,0,6,12,8,1,1,0,0,15280,6.4,15608,191,44,-4146,-3141,19.1,1528.0
4527584119,1,11,1,1,9,7,7,1,0,1,0,18026,7.2,18892,229,48,1805,941,22.9,1802.6,12,2,0,7,9,8,1,1,0,0,16221,7.0,17951,210,49,-1805,-941,21.0,1622.1
4511951461,0,15,3,1,2,8,1,1,0,1,0,14014,6.6,16219,205,48,-3443,-2284,20.5,1401.4,17,3,0,8,2,8,0,0,0,0,17457,7.2,18503,230,52,3443,2284,23.0,1745.7
4513125079,1,18,3,1,11,6,16,1,1,0,0,19364,7.4,19292,232,49,3356,2257,23.2,1936.4,18,3,0,6,11,9,0,0,0,0,16008,6.8,17035,198,41,-3356,-2257,19.8,1600.8
4494522299,0,14,1,1,3,13,2,0,0,0,0,13896,5.6,13354,197,20,-4882,-4505,19.7,1389.6,52,1,0,13,3,18,1,1,0,0,18778,6.8,17859,204,57,4882,4505,20.4,1877.8
4422211651,0,15,3,1,10,10,11,1,1,0,0,18172,7.2,18893,218,48,-347,393,21.8,1817.2,16,2,0,10,10,10,0,0,0,0,18519,7.0,18500,219,48,347,-393,21.9,1851.9
4525299931,0,19,5,1,6,7,8,1,0,1,0,16604,7.0,18077,235,40,-754,-157,23.5,1660.4,26,2,0,7,6,9,0,0,0,0,17358,6.8,18234,243,39,754,157,24.3,1735.8
4506029012,1,19,2,1,9,4,11,0,0,0,1,19477,7.2,18390,224,41,5099,2567,22.4,1947.7,17,0,0,4,9,3,1,1,0,0,14378,6.2,15823,176,49,-5099,-2567,17.6,1437.8
4499330396,1,15,0,1,3,4,1,0,0,0,0,14629,6.8,17474,184,57,-1623,-951,18.4,1462.9,14,3,0,4,3,7,2,1,1,0,16252,7.0,18425,243,65,1623,951,24.3,1625.2
4451815876,0,19,2,0,9,9,9,0,0,0,0,16896,7.0,17253,187,61,-1603,-2388,18.7,1689.6,20,6,1,9,9,12,1,1,0,0,18499,7.2,19641,250,48,1603,2388,25.0,1849.9
4509935762,0,39,4,0,7,11,6,0,0,0,0,16513,7.0,17530,197,44,-1696,-1187,19.7,1651.3,19,0,1,11,7,12,1,1,0,0,18209,7.2,18717,218,53,1696,1187,21.8,1820.9
