gameId,blueWins,blueWardsPlaced,blueWardsDestroyed,blueFirstBlood,blueKills,blueDeaths,blueAssists,blueEliteMonsters,blueDragons,blueHeralds,blueTowersDestroyed,blueTotalGold,blueAvgLevel,blueTotalExperience,blueTotalMinionsKilled,blueTotalJungleMinionsKilled,blueGoldDiff,blueExperienceDiff,blueCSPerMin,blueGoldPerMin,redWardsPlaced,redWardsDestroyed,redFirstBlood,redKills,redDeaths,redAssists,redEliteMonsters,redDragons,redHeralds,redTowersDestroyed,redTotalGold,redAvgLevel,redTotalExperience,redTotalMinionsKilled,redTotalJungleMinionsKilled,redGoldDiff,redExperienceDiff,redCSPerMin,redGoldPerMin
4468400169,1,18,0,0,3,4,4,1,1,0,0,14657,6.6,17306,204,52,-987,-555,20.4,1465.7,24,1,1,4,3,4,0,0,0,0,15644,7.0,17861,246,51,987,555,24.6,1564.4
4462377853,0,123,2,1,6,6,6,0,0,0,0,16378,6.8,17819,211,43,428,-558,21.1,1637.8,58,0,0,6,6,6,2,1,1,0,15950,7.0,18377,216,49,-428,558,21.6,1595.0
4461787791,1,89,3,1,7,5,7,1,1,0,0,17488,7.2,18635,220,51,1902,967,22.0,1748.8,54,6,0,5,7,6,0,0,0,0,15586,7.0,17668,193,60,-1902,-967,19.3,1558.6
4497751825,0,17,3,1,7,10,5,0,0,0,0,15351,6.0,13858,169,52,-2827,-2675,16.9,1535.1,17,5,0,10,7,11,1,1,0,0,18178,6.4,16533,181,52,2827,2675,18.1,1817.8
4521575223,1,146,1,0,11,7,9,0,0,0,0,18520,7.2,19054,220,48,564,633,22.0,1852.0,11,2,1,7,11,7,1,1,0,0,17956,6.8,18421,226,73,-564,-633,22.6,1795.6
4526463551,1,12,3,0,5,5,9,1,0,1,0,16730,7.0,17875,246,52,913,14,24.6,1673.0,13,1,1,5,5,6,0,0,0,0,15817,6.8,17861,205,55,-913,-14,20.5,1581.7
4517486439,1,19,3,1,8,2,12,0,0,0,0,17432,7.2,18495,209,44,2673,1388,20.9,1743.2,11,2,0,2,8,4,1,1,0,0,14759,6.6,17107,216,64,-2673,-1388,21.6,1475.9
4440086244,1,15,1,1,11,3,13,1,1,0,0,18208,7.4,19838,219,56,3199,2629,21.9,1820.8,37,2,0,3,11,2,0,0,0,0,15009,6.8,17209,209,41,-3199,-2629,20.9,1500.9
4450464581,0,17,7,1,6,9,7,0,0,0,0,16035,6.6,17041,196,52,-2257,-2894,19.6,1603.5,40,3,0,9,6,5,1,1,0,0,18292,7.4,19935,230,52,2257,2894,23.0,1829.2
4520757711,0,10,3,0,4,7,1,0,0,0,0,15038,6.8,17152,230,52,-1535,-716,23.0,1503.8,16,1,1,7,4,8,1,1,0,0,16573,6.8,17868,215,60,1535,716,21.5,1657.3
4378558412,0,16,3,0,8,11,9,0,0,0,0,16371,6.6,16354,201,40,-1867,-2002,20.1,1637.1,15,5,1,11,8,11,1,1,0,0,18238,7.2,18356,190,52,1867,2002,19.0,1823.8
4486514272,0,17,1,1,7,6,10,0,0,0,0,16360,6.4,16497,218,44,-75,144,21.8,1636.0,14,2,0,6,7,8,0,0,0,0,16435,6.8,16353,207,40,75,-144,20.7,1643.5
4443526032,0,35,4,0,4,7,6,0,0,0,0,15902,6.8,17995,241,48,-1190,-66,24.1,1590.2,27,6,1,7,4,14,1,1,0,0,17092,6.8,18061,241,57,1190,66,24.1,1709.2
4440493059,0,38,1,1,5,2,4,2,1,1,0,16517,7.2,19476,246,56,2123,2669,24.6,1651.7,146,14,0,2,5,4,0,0,0,0,14394,6.6,16807,220,45,-2123,-2669,22.0,1439.4
4525129730,0,12,2,0,1,9,2,0,0,0,0,13299,6.4,15911,189,48,-7285,-4379,18.9,1329.9,15,2,1,9,1,17,1,1,0,1,20584,7.6,20290,251,60,7285,4379,25.1,2058.4
4525377275,1,20,0,1,5,11,5,0,0,0,0,15453,6.6,16291,193,43,-2980,-2882,19.3,1545.3,16,7,0,11,5,15,0,0,0,0,18433,7.2,19173,233,45,2980,2882,23.3,1843.3
4496639377,1,19,3,0,10,4,9,0,0,0,0,17979,7.0,18648,214,55,2507,2680,21.4,1797.9,28,4,1,4,10,6,1,1,0,0,15472,6.4,15968,214,56,-2507,-2680,21.4,1547.2
4477432389,0,33,2,0,6,10,7,0,0,0,0,15820,7.0,18253,203,49,-2116,-1407,20.3,1582.0,14,3,1,10,6,11,1,1,0,0,17936,7.2,19660,223,44,2116,1407,22.3,1793.6
4520994521,0,37,5,0,2,7,3,0,0,0,0,14933,7.2,18353,213,52,-1957,-354,21.3,1493.3,20,2,1,7,2,4,2,1,1,0,16890,7.0,18707,220,60,1957,354,22.0,1689.0
4519008578,1,68,2,1,7,9,8,0,0,0,0,16274,6.8,17652,204,41,-1248,-843,20.4,1627.4,14,1,0,9,7,13,0,0,0,0,17522,7.2,18495,211,41,1248,843,21.1,1752.2
4527089557,1,17,1,1,9,2,8,1,0,1,0,18650,7.4,20053,234,55,4128,3128,23.4,1865.0,17,2,0,2,9,2,0,0,0,0,14522,6.6,16925,243,45,-4128,-3128,24.3,1452.2
4429977573,1,16,5,1,11,5,18,1,1,0,0,18612,7.2,19203,227,45,2728,1957,22.7,1861.2,14,1,0,5,11,6,0,0,0,0,15884,7.0,17246,225,48,-2728,-1957,22.5,1588.4
4461035209,0,18,1,1,7,9,7,0,0,0,0,15946,6.8,16836,170,36,-833,-932,17.0,1594.6,16,2,0,9,7,10,1,0,1,0,16779,7.0,17768,230,44,833,932,23.0,1677.9
4509889466,1,16,4,1,7,3,4,1,1,0,0,16956,7.0,19127,234,43,1712,1983,23.4,1695.6,17,3,0,3,7,5,1,0,1,0,15244,6.8,17144,236,51,-1712,-1983,23.6,1524.4
4485749610,1,12,6,0,4,5,5,2,1,1,0,16630,7.2,19373,251,70,-159,-206,25.1,1663.0,22,2,1,5,4,6,0,0,0,0,16789,7.2,19579,244,65,159,206,24.4,1678.9
4503249244,1,21,0,1,5,9,5,1,0,1,0,15881,6.4,16164,204,44,-1441,-938,20.4,1588.1,17,3,0,9,5,16,1,1,0,0,17322,6.8,17102,197,53,1441,938,19.7,1732.2
4527545380,1,14,3,1,10,8,17,1,0,1,0,17799,7.0,18078,190,40,-333,-359,19.0,1779.9,16,3,0,8,10,7,1,1,0,0,18132,7.2,18437,241,59,333,359,24.1,1813.2
4476670198,1,17,3,0,3,8,3,1,1,0,0,14591,6.8,16795,224,46,-3236,-2874,22.4,1459.1,16,3,1,8,3,8,1,0,1,0,17827,7.4,19669,252,50,3236,2874,25.2,1782.7
4478159300,1,16,5,0,5,1,5,1,1,0,0,16352,7.2,19028,250,52,1824,1204,25.0,1635.2,20,4,1,1,5,2,0,0,0,0,14528,7.0,17824,239,52,-1824,-1204,23.9,1452.8
4497909017,0,17,5,1,7,8,2,0,0,0,0,15684,6.6,17100,203,47,-1400,-644,20.3,1568.4,21,5,0,8,7,10,1,1,0,0,17084,7.0,17744,208,40,1400,644,20.8,1708.4
4515856568,0,12,5,1,5,9,3,1,1,0,0,15781,6.8,17614,203,60,-1980,-1595,20.3,1578.1,46,1,0,9,5,11,0,0,0,0,17761,7.2,19209,228,44,1980,1595,22.8,1776.1
4512351336,1,60,8,0,5,8,9,0,0,0,0,15966,7.0,18157,209,47,-847,-267,20.9,1596.6,55,3,1,8,5,8,1,1,0,0,16813,7.2,18424,203,60,847,267,20.3,1681.3
4515353757,1,15,3,0,1,2,1,1,1,0,0,14836,7.0,18769,261,60,-425,-316,26.1,1483.6,64,2,1,2,1,2,0,0,0,0,15261,7.2,19085,255,64,425,316,25.5,1526.1
4520353212,1,15,2,0,6,4,8,0,0,0,0,17201,7.2,19652,239,57,1820,1893,23.9,1720.1,12,2,1,4,6,5,1,1,0,0,15381,7.0,17759,219,58,-1820,-1893,21.9,1538.1
4522498340,1,14,2,1,11,6,10,1,1,0,1,19517,7.0,18337,216,50,3304,-85,21.6,1951.7,53,1,0,6,11,7,0,0,0,0,16213,7.0,18422,208,52,-3304,85,20.8,1621.3
4526435733,0,94,4,0,8,9,10,1,0,1,0,17431,7.0,17957,208,34,-96,277,20.8,1743.1,15,3,1,9,8,8,1,1,0,0,17527,6.6,17680,215,52,96,-277,21.5,1752.7
4526156399,1,11,2,1,5,8,4,0,0,0,0,15440,6.6,16608,209,39,-1404,443,20.9,1544.0,55,1,0,8,5,12,0,0,0,0,16844,6.6,16165,188,45,1404,-443,18.8,1684.4
4523353558,0,14,3,0,1,7,0,0,0,0,0,13633,6.4,16221,202,53,-5800,-3960,20.2,1363.3,12,1,1,7,1,15,1,1,0,1,19433,7.6,20181,245,74,5800,3960,24.5,1943.3
4511705430,0,15,2,1,4,4,3,1,1,0,0,15237,6.8,17162,224,56,-305,242,22.4,1523.7,26,4,0,4,4,5,0,0,0,0,15542,6.4,16920,201,57,305,-242,20.1,1554.2
4440119391,1,24,3,1,14,4,14,0,0,0,0,21095,7.6,21242,249,67,5802,5396,24.9,2109.5,13,5,0,4,14,5,1,1,0,0,15293,6.2,15846,186,44,-5802,-5396,18.6,1529.3
4510923222,0,16,0,1,4,8,6,1,1,0,0,14563,6.6,15835,196,39,-3004,-3860,19.6,1456.3,17,4,0,8,4,10,0,0,0,0,17567,7.2,19695,229,64,3004,3860,22.9,1756.7
4477952822,1,19,1,0,4,2,4,0,0,0,0,15205,6.8,17501,234,44,457,690,23.4,1520.5,18,2,1,2,4,2,1,1,0,0,14748,6.6,16811,250,45,-457,-690,25.0,1474.8
4452042195,1,17,2,1,2,3,4,0,0,0,0,16008,6.8,18674,237,83,1060,1708,23.7,1600.8,15,1,0,3,2,5,1,1,0,0,14948,6.8,16966,211,53,-1060,-1708,21.1,1494.8
4524881267,0,16,3,0,6,9,6,1,1,0,0,16654,7.0,18387,239,42,-959,-1002,23.9,1665.4,88,2,1,9,6,12,0,0,0,0,17613,7.0,19389,211,48,959,1002,21.1,1761.3
4469857979,0,13,2,0,3,7,5,0,0,0,0,15423,7.2,18610,241,52,-2523,-732,24.1,1542.3,13,4,1,7,3,7,1,1,0,0,17946,7.4,19342,248,48,2523,732,24.8,1794.6
4476840336,1,18,2,1,9,4,13,0,0,0,0,17234,6.6,17496,195,44,2477,1105,19.5,1723.4,16,0,0,4,9,3,0,0,0,0,14757,6.6,16391,194,39,-2477,-1105,19.4,1475.7
4470019364,0,16,1,1,3,8,1,0,0,0,0,14637,6.8,17706,193,48,-2433,-1687,19.3,1463.7,17,3,0,8,3,3,0,0,0,0,17070,7.2,19393,223,43,2433,1687,22.3,1707.0
4523961179,1,18,2,0,3,4,4,1,0,1,0,15829,7.0,17924,242,56,450,661,24.2,1582.9,12,3,1,4,3,5,1,1,0,0,15379,6.6,17263,239,48,-450,-661,23.9,1537.9
4516641337,0,16,5,1,11,8,14,0,0,0,0,18345,7.2,18508,218,52,1959,899,21.8,1834.5,15,2,0,8,11,10,2,1,1,0,16386,6.8,17609,198,44,-1959,-899,19.8,1638.6
4513996335,0,41,3,1,7,7,7,1,1,0,0,16491,6.6,16774,190,60,453,-1745,19.0,1649.1,16,6,0,7,7,0,0,0,0,0,16038,7.0,18519,238,51,-453,1745,23.8,1603.8
4476078832,1,17,2,1,9,5,7,0,0,0,0,18196,7.2,19070,230,59,2763,1667,23.0,1819.6,13,1,0,5,9,6,1,1,0,0,15433,6.8,17403,194,56,-2763,-1667,19.4,1543.3
4516578815,0,46,0,1,8,5,13,0,0,0,0,16384,6.8,16954,218,37,-232,-1633,21.8,1638.4,10,3,0,5,8,3,0,0,0,0,16616,7.2,18587,242,72,232,1633,24.2,1661.6
4462682935,0,25,1,1,5,5,8,0,0,0,0,14966,6.4,16483,177,45,-1470,-1837,17.7,1496.6,17,5,0,5,5,10,1,1,0,0,16436,7.0,18320,220,59,1470,1837,22.0,1643.6
4526746921,0,14,3,0,6,9,9,1,1,0,0,15738,6.6,16512,188,53,-2550,-1985,18.8,1573.8,15,1,1,9,6,6,0,0,0,0,18288,7.0,18497,224,57,2550,1985,22.4,1828.8
4488005635,0,15,1,0,2,5,2,1,1,0,0,15281,6.8,17495,248,52,-1201,-919,24.8,1528.1,21,3,1,5,2,11,0,0,0,0,16482,6.8,18414,247,42,1201,919,24.7,1648.2
4445519419,1,19,3,1,10,5,12,2,1,1,0,18418,7.0,18311,247,51,3750,2742,24.7,1841.8,14,5,0,5,10,6,0,0,0,0,14668,6.4,15569,194,24,-3750,-2742,19.4,1466.8
4473202955,1,17,1,1,12,9,8,0,0,0,0,18086,6.8,17120,190,42,1030,705,19.0,1808.6,12,2,0,9,12,9,0,0,0,0,17056,6.6,16415,174,48,-1030,-705,17.4,1705.6
4521321168,0,16,3,1,9,1,10,0,0,0,0,18179,7.2,19225,242,60,4869,3243,24.2,1817.9,15,2,0,1,9,0,1,1,0,0,13310,6.4,15982,210,44,-4869,-3243,21.0,1331.0
4489542966,1,17,2,1,6,3,6,0,0,0,0,16372,6.8,17187,191,52,2201,374,19.1,1637.2,13,1,0,3,6,2,0,0,0,0,14171,6.8,16813,187,43,-2201,-374,18.7,1417.1
4523979585,0,13,3,0,3,3,3,0,0,0,0,15006,7.0,18694,230,51,-1271,-366,23.0,1500.6,37,3,1,3,3,3,0,0,0,0,16277,7.2,19060,264,52,1271,366,26.4,1627.7
4520686446,0,15,4,0,6,4,10,1,1,0,0,16386,6.6,17424,216,45,742,-654,21.6,1638.6,19,2,1,4,6,3,0,0,0,0,15644,6.8,18078,255,37,-742,654,25.5,1564.4
4505104958,0,19,1,0,2,3,2,1,1,0,0,14273,6.8,17164,220,40,-814,-418,22.0,1427.3,11,2,1,3,2,2,1,0,1,0,15087,6.6,17582,224,44,814,418,22.4,1508.7
4479318487,1,14,4,0,6,3,6,0,0,0,0,16061,6.8,17186,158,60,1195,538,15.8,1606.1,37,6,1,3,6,1,1,1,0,0,14866,6.6,16648,210,56,-1195,-538,21.0,1486.6
4513212030,1,16,3,1,6,5,5,0,0,0,1,16529,6.8,16649,198,52,1085,775,19.8,1652.9,17,3,0,5,6,8,1,1,0,0,15444,6.4,15874,179,55,-1085,-775,17.9,1544.4
4470842371,0,15,1,0,2,9,2,1,0,1,0,14475,6.6,16283,205,64,-4666,-3086,20.5,1447.5,14,4,1,9,2,9,1,1,0,1,19141,7.2,19369,224,58,4666,3086,22.4,1914.1
4519226800,1,22,3,0,10,4,10,1,1,0,0,17354,7.0,18530,217,57,1743,2124,21.7,1735.4,16,2,1,4,10,4,0,0,0,0,15611,6.8,16406,236,56,-1743,-2124,23.6,1561.1
4459226162,1,12,1,0,6,6,5,0,0,0,0,16296,7.2,18903,216,52,301,872,21.6,1629.6,12,2,1,6,6,5,1,1,0,0,15995,6.8,18031,229,44,-301,-872,22.9,1599.5
4513116527,0,14,7,0,6,6,7,1,0,1,0,15928,6.8,17872,195,43,806,371,19.5,1592.8,15,3,1,6,6,7,1,1,0,0,15122,6.8,17501,200,44,-806,-371,20.0,1512.2
4492904211,1,15,2,1,3,3,3,2,1,1,0,15284,7.2,18267,245,51,-884,-471,24.5,1528.4,17,1,0,3,3,2,0,0,0,0,16168,7.2,18738,227,71,884,471,22.7,1616.8
4521899160,0,19,5,0,7,7,7,1,0,1,0,16956,6.8,18758,223,64,314,611,22.3,1695.6,16,8,1,7,7,7,1,1,0,0,16642,7.2,18147,235,57,-314,-611,23.5,1664.2
4525199033,1,40,2,1,13,6,14,0,0,0,0,18676,7.0,18018,196,44,3188,2289,19.6,1867.6,13,5,0,6,13,5,0,0,0,0,15488,6.4,15729,164,28,-3188,-2289,16.4,1548.8
4484419381,0,12,2,0,7,5,7,0,0,0,0,17235,7.4,19413,251,48,750,867,25.1,1723.5,12,0,1,5,7,8,0,0,0,0,16485,7.2,18546,230,60,-750,-867,23.0,1648.5
4436976598,1,13,2,1,13,6,11,0,0,0,0,18896,7.4,19340,198,55,2663,1537,19.8,1889.6,19,1,0,6,13,5,1,1,0,0,16233,6.8,17803,201,52,-2663,-1537,20.1,1623.3
4489712719,1,17,2,1,11,6,12,0,0,0,0,20012,7.2,19043,231,50,4093,1925,23.1,2001.2,19,1,0,6,11,6,1,1,0,0,15919,6.6,17118,215,42,-4093,-1925,21.5,1591.9
4477060044,0,18,0,0,3,6,2,0,0,0,0,14364,7.0,17602,190,56,-3333,-1389,19.0,1436.4,20,2,1,6,3,6,1,1,0,0,17697,7.2,18991,251,45,3333,1389,25.1,1769.7
4518190301,0,18,1,1,5,6,6,0,0,0,0,16126,7.0,18201,217,52,61,1120,21.7,1612.6,18,4,0,6,5,7,1,1,0,0,16065,6.8,17081,203,52,-61,-1120,20.3,1606.5
4509748129,0,17,4,0,2,5,1,1,1,0,0,14653,6.6,16215,218,52,-1387,-1802,21.8,1465.3,53,5,1,5,2,8,1,0,1,0,16040,6.8,18017,188,61,1387,1802,18.8,1604.0
4478456612,1,40,6,0,4,4,5,0,0,0,0,15894,7.0,18853,223,60,310,536,22.3,1589.4,19,5,1,4,4,4,1,1,0,0,15584,7.0,18317,223,54,-310,-536,22.3,1558.4
4525344847,0,157,5,1,10,10,10,1,1,0,0,16722,6.8,17229,163,47,-790,-1172,16.3,1672.2,17,1,0,10,10,8,1,0,1,0,17512,7.0,18401,207,44,790,1172,20.7,1751.2
4516124063,0,17,3,1,4,10,7,1,1,0,0,14719,6.6,16802,200,40,-2317,-1800,20.0,1471.9,16,2,0,10,4,10,1,0,1,0,17036,7.0,18602,194,45,2317,1800,19.4,1703.6
4524397696,0,14,2,0,3,10,1,0,0,0,0,15827,7.0,17607,245,56,-2683,-2383,24.5,1582.7,20,3,1,10,3,12,1,1,0,0,18510,7.2,19990,234,59,2683,2383,23.4,1851.0
4507115446,1,14,8,0,6,4,11,1,1,0,0,16538,7.2,18707,235,55,1585,1348,23.5,1653.8,14,3,1,4,6,4,0,0,0,0,14953,6.6,17359,189,44,-1585,-1348,18.9,1495.3
4522794083,0,23,5,1,6,7,7,0,0,0,0,16182,6.8,17791,221,49,-95,-1113,22.1,1618.2,18,4,0,7,6,11,1,1,0,0,16277,7.0,18904,216,60,95,1113,21.6,1627.7
4467280497,1,14,1,1,4,3,4,1,1,0,0,16114,7.0,18458,233,58,1694,1199,23.3,1611.4,18,0,0,3,4,3,1,0,1,0,14420,6.6,17259,210,48,-1694,-1199,21.0,1442.0
4518199999,1,14,1,1,6,4,3,1,1,0,0,16434,7.0,18641,228,47,1085,1048,22.8,1643.4,12,2,0,4,6,2,0,0,0,0,15349,6.6,17593,220,48,-1085,-1048,22.0,1534.9
4515393981,1,18,4,1,5,6,6,2,1,1,1,17843,7.0,17948,243,48,1895,-224,24.3,1784.3,14,3,0,6,5,6,0,0,0,0,15948,7.0,18172,207,47,-1895,224,20.7,1594.8
4520362775,0,18,2,0,11,9,16,0,0,0,0,18557,7.2,18792,192,44,524,478,19.2,1855.7,17,1,1,9,11,7,1,1,0,0,18033,7.0,18314,213,48,-524,-478,21.3,1803.3
4517491140,0,16,4,1,11,6,15,2,1,1,0,17816,7.4,18626,209,40,1488,1092,20.9,1781.6,58,1,0,6,11,9,0,0,0,0,16328,7.0,17534,225,48,-1488,-1092,22.5,1632.8
4515391813,0,16,1,0,6,5,9,0,0,0,0,16275,7.2,18687,209,46,-184,57,20.9,1627.5,10,6,1,5,6,3,1,1,0,0,16459,7.2,18630,250,60,184,-57,25.0,1645.9
4519278767,1,34,6,1,8,1,11,1,0,1,0,18237,7.4,19105,221,57,4824,2940,22.1,1823.7,19,1,0,1,8,2,0,0,0,0,13413,6.4,16165,179,55,-4824,-2940,17.9,1341.3
4507906686,0,12,3,0,3,9,0,0,0,0,0,14502,6.8,17558,213,40,-3041,-1317,21.3,1450.2,15,3,1,9,3,7,2,1,1,0,17543,7.0,18875,223,50,3041,1317,22.3,1754.3
4457344340,0,19,2,0,5,6,4,1,0,1,0,16416,6.8,18647,253,44,-205,-41,25.3,1641.6,12,4,1,6,5,7,1,1,0,0,16621,7.0,18688,239,40,205,41,23.9,1662.1
4518248873,0,11,2,0,6,9,8,0,0,0,0,16328,6.8,17459,221,40,-1325,-959,22.1,1632.8,14,1,1,9,6,8,1,1,0,0,17653,7.2,18418,234,60,1325,959,23.4,1765.3
4472589919,0,20,4,0,7,5,6,0,0,0,0,16549,7.2,18284,205,59,611,1342,20.5,1654.9,19,2,1,5,7,9,1,1,0,0,15938,6.8,16942,203,44,-611,-1342,20.3,1593.8
4472664560,1,17,1,1,6,6,8,1,1,0,0,16527,7.0,18240,225,59,-484,-1416,22.5,1652.7,13,1,0,6,6,5,0,0,0,0,17011,7.4,19656,221,67,484,1416,22.1,1701.1
4509440283,1,56,2,1,7,8,7,2,1,1,0,15843,6.8,17154,190,44,-1799,-1304,19.0,1584.3,17,3,0,8,7,15,0,0,0,0,17642,6.8,18458,196,48,1799,1304,19.6,1764.2
4472899697,0,13,2,1,5,6,2,0,0,0,0,15470,6.8,17451,211,44,-522,-577,21.1,1547.0,41,2,0,6,5,4,1,1,0,0,15992,7.0,18028,209,52,522,577,20.9,1599.2
4479961520,1,14,2,0,5,4,4,0,0,0,0,16656,7.2,18582,252,42,930,275,25.2,1665.6,13,3,1,4,5,6,0,0,0,0,15726,7.2,18307,205,48,-930,-275,20.5,1572.6
4449297701,0,17,3,0,3,13,1,0,0,0,0,13428,6.0,14121,167,46,-5668,-4786,16.7,1342.8,17,5,1,13,3,10,1,1,0,0,19096,7.0,18907,218,44,5668,4786,21.8,1909.6
4486617771,0,14,0,0,4,6,5,0,0,0,0,15908,7.0,18133,218,68,-1345,169,21.8,1590.8,48,1,1,6,4,9,1,1,0,0,17253,6.8,17964,220,68,1345,-169,22.0,1725.3
4523893279,0,15,2,0,5,10,8,1,1,0,0,15269,6.6,16739,194,37,-2793,-1055,19.4,1526.9,15,1,1,10,5,13,0,0,0,0,18062,6.8,17794,204,45,2793,1055,20.4,1806.2
4519483383,1,9,3,1,6,7,6,1,0,1,0,16317,7.0,18679,204,71,-713,103,20.4,1631.7,84,4,0,7,6,5,1,1,0,0,17030,6.8,18576,212,52,713,-103,21.2,1703.0
4489107680,0,17,3,1,8,7,9,0,0,0,0,17164,7.0,18932,222,55,525,902,22.2,1716.4,17,0,0,7,8,7,0,0,0,0,16639,6.8,18030,215,55,-525,-902,21.5,1663.9
4521259209,1,13,2,0,5,6,4,1,1,0,0,15596,7.0,17998,198,44,-305,-474,19.8,1559.6,25,2,1,6,5,7,0,0,0,0,15901,7.0,18472,199,40,305,474,19.9,1590.1
4517634748,1,14,5,1,9,2,13,1,1,0,0,18081,7.2,19648,214,57,4233,3106,21.4,1808.1,19,2,0,2,9,2,0,0,0,0,13848,6.6,16542,193,45,-4233,-3106,19.3,1384.8
4510696866,0,16,2,0,5,4,7,0,0,0,0,15577,6.8,17244,207,48,124,-46,20.7,1557.7,23,3,1,4,5,5,2,1,1,0,15453,6.8,17290,220,52,-124,46,22.0,1545.3
4526149892,1,19,5,1,12,3,6,1,1,0,0,19154,7.4,20112,258,63,5664,6002,25.8,1915.4,16,4,0,3,12,2,1,0,1,0,13490,6.0,14110,179,32,-5664,-6002,17.9,1349.0
4486987445,0,16,2,0,3,3,2,1,0,1,0,15416,6.8,17935,228,61,450,-9,22.8,1541.6,12,2,1,3,3,5,0,0,0,0,14966,6.8,17944,220,53,-450,9,22.0,1496.6
4513636712,0,18,2,0,3,11,1,0,0,0,0,13602,6.4,15564,170,44,-5088,-2609,17.0,1360.2,13,3,1,11,3,16,1,1,0,0,18690,7.2,18173,231,48,5088,2609,23.1,1869.0
4521789361,1,19,1,1,11,1,11,0,0,0,0,18622,7.2,19365,245,50,5269,3577,24.5,1862.2,36,1,0,1,11,1,0,0,0,0,13353,6.6,15788,189,45,-5269,-3577,18.9,1335.3
4522145954,0,10,4,0,1,6,0,1,1,0,0,13480,6.4,16396,215,52,-3137,-2097,21.5,1348.0,22,1,1,6,1,10,0,0,0,0,16617,7.0,18493,233,49,3137,2097,23.3,1661.7
4472752313,0,9,3,0,5,6,3,0,0,0,1,17670,7.0,19067,253,56,1191,1276,25.3,1767.0,11,1,1,6,5,5,1,1,0,0,16479,6.8,17791,166,67,-1191,-1276,16.6,1647.9
4502288347,1,102,2,1,6,7,3,1,1,0,0,17303,7.0,18417,224,52,572,417,22.4,1730.3,13,12,0,7,6,7,0,0,0,0,16731,7.0,18000,205,60,-572,-417,20.5,1673.1
4508386136,1,23,3,0,3,4,4,0,0,0,0,15031,6.8,16824,202,55,-330,-142,20.2,1503.1,17,1,1,4,3,5,1,0,1,0,15361,6.6,16966,215,46,330,142,21.5,1536.1
4525363393,0,12,4,0,4,8,5,1,0,1,0,15384,6.8,17460,211,44,-1817,-1035,21.1,1538.4,17,0,1,8,4,6,1,1,0,0,17201,7.0,18495,240,48,1817,1035,24.0,1720.1
4502088283,1,44,4,0,5,5,5,0,0,0,0,15810,7.2,18914,208,56,-866,388,20.8,1581.0,16,15,1,5,5,3,1,1,0,0,16676,6.8,18526,253,51,866,-388,25.3,1667.6
4488919662,1,15,3,1,4,6,4,1,1,0,0,15289,6.4,16346,193,52,-282,-740,19.3,1528.9,38,1,0,6,4,6,0,0,0,0,15571,6.8,17086,197,34,282,740,19.7,1557.1
4512943729,0,25,4,0,3,6,1,0,0,0,0,15101,7.0,18480,226,66,-1972,-717,22.6,1510.1,16,3,1,6,3,4,1,1,0,0,17073,7.2,19197,263,64,1972,717,26.3,1707.3
4521295161,1,18,3,1,8,8,11,1,1,0,0,18623,7.2,17867,229,60,914,34,22.9,1862.3,13,2,0,8,8,9,0,0,0,0,17709,7.0,17833,237,42,-914,-34,23.7,1770.9
4518043689,1,15,3,1,9,12,15,0,0,0,0,18458,7.0,18924,243,42,-913,-192,24.3,1845.8,18,3,0,12,9,20,0,0,0,0,19371,7.2,19116,231,52,913,192,23.1,1937.1
4467610572,0,15,4,1,5,4,6,1,0,1,0,16457,7.0,18669,229,60,1023,1754,22.9,1645.7,19,2,0,4,5,7,0,0,0,0,15434,6.6,16915,219,53,-1023,-1754,21.9,1543.4
4527280212,1,44,4,1,12,3,14,0,0,0,0,18631,7.4,19460,245,42,4089,3372,24.5,1863.1,15,6,0,3,12,4,1,1,0,0,14542,6.4,16088,193,60,-4089,-3372,19.3,1454.2
4516919746,1,122,3,1,9,1,10,2,1,1,0,18269,7.2,19659,229,68,3933,2922,22.9,1826.9,14,3,0,1,9,1,0,0,0,0,14336,6.4,16737,233,40,-3933,-2922,23.3,1433.6
4505863838,1,14,4,1,11,3,12,1,1,0,0,17317,7.0,18842,226,40,2022,970,22.6,1731.7,122,2,0,3,11,2,0,0,0,0,15295,6.8,17872,242,50,-2022,-970,24.2,1529.5
4451637903,1,17,5,1,3,1,2,0,0,0,0,15624,6.8,17633,233,56,1579,893,23.3,1562.4,17,3,0,1,3,1,2,1,1,0,14045,6.6,16740,222,64,-1579,-893,22.2,1404.5
4525766056,1,23,2,1,6,3,7,1,1,0,0,16600,7.2,18185,238,53,1825,996,23.8,1660.0,17,3,0,3,6,4,0,0,0,0,14775,6.8,17189,228,39,-1825,-996,22.8,1477.5
4524281918,0,104,2,0,9,8,8,0,0,0,0,17511,6.8,17230,216,39,225,787,21.6,1751.1,15,0,1,8,9,14,0,0,0,0,17286,6.6,16443,206,49,-225,-787,20.6,1728.6
4518368417,0,12,3,1,4,5,4,0,0,0,0,14705,6.6,16663,196,44,-2167,-2507,19.6,1470.5,17,1,0,5,4,6,1,1,0,0,16872,7.2,19170,240,65,2167,2507,24.0,1687.2
4502024151,0,12,1,0,2,11,3,0,0,0,0,13832,6.6,16157,203,47,-6240,-4315,20.3,1383.2,13,3,1,11,2,11,2,1,1,1,20072,7.6,20472,233,49,6240,4315,23.3,2007.2
4523130244,0,17,4,1,8,7,11,1,0,1,1,19114,7.0,18680,245,44,2544,-21,24.5,1911.4,22,2,0,7,8,10,1,1,0,0,16570,7.0,18701,209,60,-2544,21,20.9,1657.0
4524178545,0,19,2,0,2,6,4,1,1,0,0,15175,6.8,17282,214,52,-1409,-16,21.4,1517.5,18,2,1,6,2,5,0,0,0,0,16584,6.8,17298,234,50,1409,16,23.4,1658.4
4526727773,1,13,1,1,5,1,7,0,0,0,0,16786,7.4,19003,260,44,2264,1130,26.0,1678.6,14,3,0,1,5,1,2,1,1,0,14522,6.8,17873,247,61,-2264,-1130,24.7,1452.2
4463393094,0,12,2,0,5,7,3,0,0,0,0,16206,7.0,17906,229,53,-33,1233,22.9,1620.6,14,3,1,7,5,8,1,1,0,0,16239,6.6,16673,200,40,33,-1233,20.0,1623.9
4525324853,1,36,3,0,4,5,2,1,0,1,0,17008,7.2,19831,255,68,1903,4023,25.5,1700.8,13,12,1,5,4,12,1,1,0,0,15105,6.4,15808,182,52,-1903,-4023,18.2,1510.5
4502866090,1,18,2,1,7,1,9,1,0,1,1,18764,7.0,18764,268,51,5121,2946,26.8,1876.4,36,3,0,1,7,2,0,0,0,0,13643,6.4,15818,201,54,-5121,-2946,20.1,1364.3
4513811621,1,19,1,0,11,3,14,0,0,0,0,19373,7.2,19208,228,40,4898,3092,22.8,1937.3,14,2,1,3,11,2,1,1,0,0,14475,6.6,16116,190,60,-4898,-3092,19.0,1447.5
4499657757,1,16,1,1,7,6,8,0,0,0,0,17812,7.0,18372,244,56,1745,1180,24.4,1781.2,14,3,0,6,7,10,1,1,0,0,16067,6.8,17192,216,60,-1745,-1180,21.6,1606.7
4526378809,0,21,5,1,8,8,7,0,0,0,0,17161,6.8,17805,227,28,-262,-1246,22.7,1716.1,13,7,0,8,8,10,1,1,0,0,17423,7.0,19051,202,72,262,1246,20.2,1742.3
4523281045,0,15,7,0,8,12,14,0,0,0,0,16941,7.0,17520,203,41,-1833,-393,20.3,1694.1,19,2,1,12,8,17,2,1,1,0,18774,7.0,17913,210,52,1833,393,21.0,1877.4
4506261342,0,14,0,0,7,13,8,0,0,0,0,16658,6.6,17588,192,50,-2184,-2333,19.2,1665.8,69,4,1,13,7,8,1,1,0,0,18842,7.4,19921,202,52,2184,2333,20.2,1884.2
4509275227,1,15,4,0,6,8,5,1,1,0,0,16423,6.8,16900,204,59,-1900,-1052,20.4,1642.3,24,2,1,8,6,10,1,0,1,0,18323,7.0,17952,215,44,1900,1052,21.5,1832.3
4515824128,1,19,3,1,7,6,8,0,0,0,0,16124,6.8,17018,192,52,-467,-86,19.2,1612.4,17,5,0,6,7,8,2,1,1,0,16591,6.8,17104,211,49,467,86,21.1,1659.1
4508403894,1,23,3,1,4,7,5,0,0,0,0,16810,7.0,18437,224,76,-146,-399,22.4,1681.0,19,5,0,7,4,8,2,1,1,0,16956,7.0,18836,235,49,146,399,23.5,1695.6
4481779258,0,40,1,1,5,6,4,0,0,0,0,15815,6.8,17429,224,40,-721,-1118,22.4,1581.5,12,2,0,6,5,7,1,1,0,0,16536,7.0,18547,241,50,721,1118,24.1,1653.6
4525941408,1,16,1,0,9,7,12,1,1,0,0,17908,7.0,17505,220,55,1717,775,22.0,1790.8,10,0,1,7,9,9,1,0,1,0,16191,6.6,16730,212,35,-1717,-775,21.2,1619.1
4521606449,1,12,4,1,10,6,11,0,0,0,0,18156,7.4,19293,238,48,2052,1084,23.8,1815.6,20,3,0,6,10,4,0,0,0,0,16104,6.8,18209,240,40,-2052,-1084,24.0,1610.4
4518176859,0,18,7,0,6,9,6,0,0,0,0,16598,6.8,17279,196,64,-1814,-946,19.6,1659.8,20,5,1,9,6,13,1,1,0,0,18412,6.8,18225,231,40,1814,946,23.1,1841.2
4511740529,1,13,6,0,10,7,13,0,0,0,0,18281,6.8,17603,224,36,2064,2124,22.4,1828.1,15,1,1,7,10,9,0,0,0,0,16217,6.4,15479,191,43,-2064,-2124,19.1,1621.7
4479120786,1,13,2,1,9,6,8,1,1,0,0,17029,6.8,17944,201,43,569,-1349,20.1,1702.9,17,1,0,6,9,3,0,0,0,0,16460,7.0,19293,204,60,-569,1349,20.4,1646.0
4476455937,0,15,5,0,6,10,7,0,0,0,0,15530,7.0,18389,222,40,-1932,-930,22.2,1553.0,17,6,1,10,6,6,1,1,0,0,17462,7.4,19319,232,39,1932,930,23.2,1746.2
4391260446,1,43,5,0,10,7,11,2,1,1,0,17748,7.0,19116,206,43,1212,2099,20.6,1774.8,17,5,1,7,10,10,0,0,0,0,16536,7.0,17017,191,40,-1212,-2099,19.1,1653.6
4473506921,0,14,3,1,12,8,13,1,1,0,1,20086,7.0,18345,232,44,3059,1408,23.2,2008.6,20,1,0,8,12,8,1,0,1,0,17027,6.4,16937,207,56,-3059,-1408,20.7,1702.7
4523590647,1,21,2,1,6,2,3,0,0,0,0,16818,7.2,19595,250,56,2274,2694,25.0,1681.8,12,1,0,2,6,2,0,0,0,0,14544,6.8,16901,202,50,-2274,-2694,20.2,1454.4
4517667629,0,12,6,0,3,4,2,0,0,0,0,14867,6.8,18057,222,47,-822,-592,22.2,1486.7,39,1,1,4,3,4,0,0,0,0,15689,7.0,18649,209,57,822,592,20.9,1568.9
4523478431,0,17,4,0,5,7,5,0,0,0,0,15420,6.6,16502,210,44,-692,-604,21.0,1542.0,16,3,1,7,5,7,2,1,1,0,16112,6.8,17106,193,48,692,604,19.3,1611.2
4522629457,0,35,1,0,3,9,0,0,0,0,0,14149,6.6,17085,189,49,-3960,-2533,18.9,1414.9,12,1,1,9,3,9,0,0,0,0,18109,7.2,19618,220,52,3960,2533,22.0,1810.9
4513458480,1,14,3,1,10,2,14,1,1,0,0,18888,7.2,18447,242,43,4780,2748,24.2,1888.8,15,1,0,2,10,2,0,0,0,0,14108,6.4,15699,203,46,-4780,-2748,20.3,1410.8
4507030336,0,20,2,1,6,9,7,0,0,0,0,17430,6.8,18068,212,63,-367,187,21.2,1743.0,15,3,0,9,6,9,0,0,0,0,17797,7.2,17881,205,60,367,-187,20.5,1779.7
4517907336,0,16,2,1,3,4,4,0,0,0,0,15732,7.0,18040,241,50,-185,45,24.1,1573.2,14,3,0,4,3,4,1,1,0,0,15917,7.0,17995,238,61,185,-45,23.8,1591.7
4525786511,1,18,4,0,8,2,10,1,0,1,1,18656,7.2,19071,229,45,3761,1269,22.9,1865.6,37,3,1,2,8,2,0,0,0,0,14895,6.6,17802,241,52,-3761,-1269,24.1,1489.5
4519380029,0,13,3,0,3,5,3,0,0,0,0,15478,7.0,18118,214,60,-697,-1133,21.4,1547.8,15,2,1,5,3,4,2,1,1,0,16175,7.2,19251,244,62,697,1133,24.4,1617.5
4452228031,1,126,5,1,9,5,4,1,1,0,0,17693,7.2,19209,226,60,2120,2142,22.6,1769.3,45,1,0,5,9,6,0,0,0,0,15573,6.8,17067,178,52,-2120,-2142,17.8,1557.3
4522519363,1,16,4,0,5,3,4,1,1,0,0,16338,7.2,19137,234,60,1106,1309,23.4,1633.8,18,1,1,3,5,1,0,0,0,0,15232,6.8,17828,228,60,-1106,-1309,22.8,1523.2
4512191521,0,14,1,0,3,6,4,0,0,0,0,15057,6.8,17267,218,64,-3443,-1347,21.8,1505.7,16,3,1,6,3,10,1,1,0,1,18500,7.2,18614,219,68,3443,1347,21.9,1850.0
4508690422,1,18,2,0,11,5,11,0,0,0,0,18403,7.4,19486,239,48,2239,1539,23.9,1840.3,22,4,1,5,11,4,1,1,0,0,16164,6.6,17947,231,63,-2239,-1539,23.1,1616.4
4520326314,1,16,1,1,6,3,5,0,0,0,0,16298,7.0,19052,229,56,823,1225,22.9,1629.8,13,4,0,3,6,3,1,1,0,0,15475,6.8,17827,235,52,-823,-1225,23.5,1547.5
4505362087,1,11,2,0,10,6,7,0,0,0,0,18129,7.2,19644,230,60,2428,2186,23.0,1812.9,37,2,1,6,10,9,1,1,0,0,15701,6.8,17458,212,55,-2428,-2186,21.2,1570.1
4462356432,1,21,2,0,5,3,4,1,1,0,0,15716,7.0,18832,221,40,12,161,22.1,1571.6,15,2,1,3,5,3,0,0,0,0,15704,6.8,18671,244,60,-12,-161,24.4,1570.4
4512466061,1,17,2,1,5,5,4,0,0,0,0,16092,6.8,18020,222,47,262,611,22.2,1609.2,15,0,0,5,5,7,1,1,0,0,15830,6.8,17409,191,62,-262,-611,19.1,1583.0
4526010280,1,36,3,0,9,7,6,2,1,1,0,17195,7.2,18590,178,75,827,1271,17.8,1719.5,17,1,1,7,9,7,0,0,0,0,16368,6.8,17319,201,46,-827,-1271,20.1,1636.8
4525388286,0,16,3,0,4,10,2,0,0,0,0,14471,6.6,16470,169,48,-4204,-2138,16.9,1447.1,17,2,1,10,4,11,2,1,1,0,18675,7.2,18608,227,33,4204,2138,22.7,1867.5
4464398381,0,18,1,0,7,10,8,0,0,0,0,15543,6.4,15357,193,44,-3333,-2568,19.3,1554.3,13,5,1,10,7,12,0,0,0,0,18876,7.0,17925,234,40,3333,2568,23.4,1887.6
4505469911,0,16,7,0,7,7,7,1,1,0,0,16352,6.8,18216,224,56,-435,-1431,22.4,1635.2,18,4,1,7,7,7,0,0,0,0,16787,7.2,19647,233,47,435,1431,23.3,1678.7
4525980184,1,20,4,0,9,5,13,0,0,0,0,18402,7.4,19507,223,68,2582,2732,22.3,1840.2,16,2,1,5,9,5,2,1,1,0,15820,6.8,16775,202,40,-2582,-2732,20.2,1582.0
4525545485,1,14,1,1,9,7,9,0,0,0,0,18880,7.0,19278,235,54,2690,2514,23.5,1888.0,17,2,0,7,9,9,1,1,0,0,16190,6.6,16764,193,43,-2690,-2514,19.3,1619.0
4464257134,1,15,2,1,6,6,6,1,0,1,0,16866,6.8,17542,218,47,69,-552,21.8,1686.6,18,1,0,6,6,9,1,1,0,0,16797,6.8,18094,247,40,-69,552,24.7,1679.7
4433590023,1,17,6,1,13,0,14,1,1,0,1,20095,7.6,20229,219,48,6770,4384,21.9,2009.5,14,3,0,0,13,0,0,0,0,0,13325,6.6,15845,199,56,-6770,-4384,19.9,1332.5
4517015396,1,16,5,1,6,6,10,0,0,0,0,16992,6.8,17775,227,53,1182,420,22.7,1699.2,20,2,0,6,6,8,0,0,0,0,15810,6.6,17355,203,39,-1182,-420,20.3,1581.0
4526041586,1,18,2,0,9,5,11,0,0,0,0,17318,7.4,19732,221,52,1166,1899,22.1,1731.8,14,2,1,5,9,4,0,0,0,0,16152,7.0,17833,225,46,-1166,-1899,22.5,1615.2
4525230737,1,12,4,0,7,7,9,0,0,0,0,16696,6.8,17704,202,52,-422,-43,20.2,1669.6,28,1,1,7,7,10,2,1,1,0,17118,7.0,17747,189,53,422,43,18.9,1711.8
4502673310,0,28,2,0,3,7,3,0,0,0,0,14525,6.6,16786,201,56,-5011,-2444,20.1,1452.5,22,1,1,7,3,5,0,0,0,1,19536,7.2,19230,244,52,5011,2444,24.4,1953.6
4438388290,0,17,2,0,6,7,4,1,0,1,0,16331,7.2,17920,231,49,-226,-221,23.1,1633.1,37,3,1,7,6,7,0,0,0,0,16557,7.0,18141,226,54,226,221,22.6,1655.7
4522600992,0,18,4,0,5,5,3,1,0,1,0,17048,7.2,18886,249,51,1337,885,24.9,1704.8,15,1,1,5,5,4,0,0,0,0,15711,7.0,18001,199,64,-1337,-885,19.9,1571.1
4465596531,0,12,3,1,10,6,4,0,0,0,0,18000,7.4,19946,236,48,2504,2361,23.6,1800.0,16,1,0,6,10,7,0,0,0,0,15496,7.0,17585,191,43,-2504,-2361,19.1,1549.6
4522686444,0,16,1,1,6,5,4,0,0,0,0,16682,7.0,18272,236,52,598,374,23.6,1668.2,14,4,0,5,6,5,1,1,0,0,16084,6.8,17898,235,60,-598,-374,23.5,1608.4
4498185770,1,18,3,1,7,3,6,2,1,1,0,17224,7.2,18597,237,56,2053,1371,23.7,1722.4,16,4,0,3,7,4,0,0,0,0,15171,6.6,17226,237,43,-2053,-1371,23.7,1517.1
4467340855,0,18,3,0,3,6,3,0,0,0,0,14715,7.0,17406,198,58,-2290,-1334,19.8,1471.5,37,7,1,6,3,8,1,1,0,0,17005,7.0,18740,229,56,2290,1334,22.9,1700.5
4518666053,0,38,2,1,6,8,6,1,1,0,0,15295,6.4,15416,157,40,-2783,-2017,15.7,1529.5,18,5,0,8,6,5,1,0,1,2,18078,6.6,17433,213,40,2783,2017,21.3,1807.8
4469528522,0,14,1,1,2,2,1,1,0,1,0,14421,7.0,18228,234,40,-837,-451,23.4,1442.1,90,0,0,2,2,1,1,1,0,0,15258,7.0,18679,229,72,837,451,22.9,1525.8
4508846278,0,28,2,0,12,14,14,1,0,1,0,18331,7.0,18445,181,52,-1572,-208,18.1,1833.1,14,3,1,14,12,17,1,1,0,0,19903,7.0,18653,228,40,1572,208,22.8,1990.3
4518281398,1,22,2,1,4,5,3,0,0,0,0,15392,7.0,17929,222,52,-982,-1613,22.2,1539.2,15,2,0,5,4,3,1,1,0,0,16374,7.4,19542,234,64,982,1613,23.4,1637.4
4508068609,1,41,3,1,9,4,10,2,1,1,0,18062,7.4,19711,223,51,2449,1146,22.3,1806.2,18,14,0,4,9,2,0,0,0,0,15613,7.2,18565,233,52,-2449,-1146,23.3,1561.3
4525305174,1,17,3,1,5,8,6,0,0,0,0,15754,6.8,16911,196,44,-1157,-573,19.6,1575.4,20,7,0,8,5,12,1,1,0,0,16911,6.6,17484,228,48,1157,573,22.8,1691.1
4475427845,0,15,1,0,4,9,4,0,0,0,0,15890,7.0,17797,229,49,-2782,-1742,22.9,1589.0,15,1,1,9,4,10,1,1,0,0,18672,7.0,19539,235,62,2782,1742,23.5,1867.2
4519530388,0,11,0,1,3,11,3,0,0,0,0,14852,6.6,16246,194,66,-4835,-3655,19.4,1485.2,9,1,0,11,3,11,1,1,0,1,19687,7.2,19901,195,57,4835,3655,19.5,1968.7
4524224668,1,21,2,1,13,3,14,0,0,0,1,21278,7.4,20007,253,38,6968,4379,25.3,2127.8,12,2,0,3,13,2,1,1,0,0,14310,6.6,15628,185,55,-6968,-4379,18.5,1431.0
4523089267,0,16,2,1,10,11,9,0,0,0,0,19029,7.4,19459,234,49,340,1086,23.4,1902.9,11,3,0,11,10,14,0,0,0,0,18689,7.2,18373,182,40,-340,-1086,18.2,1868.9
4525066184,1,56,3,1,11,4,10,1,1,0,0,17131,7.2,18732,215,44,2036,1891,21.5,1713.1,16,2,0,4,11,3,0,0,0,0,15095,6.8,16841,188,56,-2036,-1891,18.8,1509.5
4520880058,1,20,3,1,7,3,6,0,0,0,0,16863,6.6,17496,232,45,1310,-95,23.2,1686.3,14,3,0,3,7,3,1,1,0,0,15553,6.8,17591,227,55,-1310,95,22.7,1555.3
4442406122,1,14,2,1,13,6,14,0,0,0,0,19324,7.0,19019,226,55,3110,1541,22.6,1932.4,17,1,0,6,13,8,1,1,0,0,16214,7.0,17478,206,56,-3110,-1541,20.6,1621.4
4517535335,1,27,9,0,6,5,6,1,1,0,0,16893,7.0,18950,238,64,568,1096,23.8,1689.3,43,8,1,5,6,6,0,0,0,0,16325,7.0,17854,231,48,-568,-1096,23.1,1632.5
4513896209,0,13,1,1,8,9,8,1,0,1,0,17424,6.8,17446,220,51,-836,-1109,22.0,1742.4,14,1,0,9,8,14,0,0,0,0,18260,7.2,18555,211,43,836,1109,21.1,1826.0
4470087448,0,18,2,1,3,8,4,0,0,0,0,14663,6.6,15749,201,41,-2454,-3816,20.1,1466.3,16,1,0,8,3,8,1,0,1,0,17117,7.4,19565,213,50,2454,3816,21.3,1711.7
4516001794,0,17,1,0,6,6,4,0,0,0,0,17328,7.2,20229,245,72,1336,1171,24.5,1732.8,19,4,1,6,6,5,2,1,1,0,15992,7.2,19058,224,52,-1336,-1171,22.4,1599.2
4483736284,0,93,4,0,8,8,8,1,0,1,0,18683,7.2,19031,218,52,1874,1408,21.8,1868.3,16,4,1,8,8,8,1,1,0,0,16809,6.8,17623,215,44,-1874,-1408,21.5,1680.9
4524160541,1,115,3,1,11,4,8,1,0,1,1,20176,7.6,19773,260,55,5830,1979,26.0,2017.6,25,1,0,4,11,0,0,0,0,0,14346,6.8,17794,194,52,-5830,-1979,19.4,1434.6
4513337706,0,14,1,1,4,7,6,1,1,0,0,14604,6.6,16297,190,50,-4058,-3454,19.0,1460.4,13,3,0,7,4,5,1,0,1,1,18662,7.4,19751,257,52,4058,3454,25.7,1866.2
4521683040,1,40,8,1,6,6,14,1,1,0,0,16805,7.0,18793,230,63,11,64,23.0,1680.5,29,4,0,6,6,7,0,0,0,0,16794,7.2,18729,223,56,-11,-64,22.3,1679.4
4523340688,0,15,0,0,0,5,0,0,0,0,0,14091,6.4,16184,233,60,-2216,-2730,23.3,1409.1,56,2,1,5,0,8,1,1,0,0,16307,7.0,18914,229,60,2216,2730,22.9,1630.7
4524571135,0,19,4,0,3,11,4,0,0,0,0,14414,6.4,16744,173,39,-4743,-2650,17.3,1441.4,16,1,1,11,3,10,2,1,1,0,19157,7.4,19394,245,52,4743,2650,24.5,1915.7
4439683972,1,20,1,1,5,3,7,1,0,1,0,16610,7.4,19266,246,56,1875,2074,24.6,1661.0,14,1,0,3,5,3,1,1,0,0,14735,6.8,17192,207,52,-1875,-2074,20.7,1473.5
4419533623,0,15,6,1,6,5,9,0,0,0,0,16022,6.8,17931,227,48,318,370,22.7,1602.2,188,3,0,5,6,4,1,1,0,0,15704,6.8,17561,210,56,-318,-370,21.0,1570.4
4502793197,1,22,4,0,10,5,10,0,0,0,0,17987,7.4,19698,232,52,1810,2115,23.2,1798.7,72,2,1,5,10,4,1,0,1,0,16177,6.8,17583,222,56,-1810,-2115,22.2,1617.7
4503251133,1,16,4,0,8,7,7,0,0,0,0,16966,7.4,19266,228,55,705,2576,22.8,1696.6,16,4,1,7,8,5,1,1,0,0,16261,6.6,16690,198,47,-705,-2576,19.8,1626.1
4492023139,0,16,3,1,4,8,1,0,0,0,0,15135,6.6,17280,240,54,-1634,-1916,24.0,1513.5,14,5,0,8,4,7,0,0,0,0,16769,7.4,19196,220,54,1634,1916,22.0,1676.9
4517859003,1,17,2,0,6,7,6,0,0,0,0,15615,7.0,17928,201,49,-1193,-819,20.1,1561.5,17,3,1,7,6,10,0,0,0,0,16808,7.0,18747,229,36,1193,819,22.9,1680.8
4461378771,1,16,2,1,11,10,8,1,0,1,0,18762,7.0,18724,202,40,1378,1187,20.2,1876.2,15,2,0,10,11,6,0,0,0,0,17384,7.0,17537,212,52,-1378,-1187,21.2,1738.4
4519735486,0,14,3,0,2,8,2,1,1,0,0,14630,6.6,17694,211,60,-4005,-2248,21.1,1463.0,14,5,1,8,2,7,0,0,0,0,18635,7.4,19942,271,47,4005,2248,27.1,1863.5
4453464076,0,32,3,1,8,8,6,1,1,0,0,17761,7.2,19090,220,64,642,-3,22.0,1776.1,17,3,0,8,8,6,0,0,0,0,17119,7.2,19093,218,44,-642,3,21.8,1711.9
4525783295,1,14,0,0,9,5,6,1,1,0,0,18912,7.4,20086,244,70,3970,2818,24.4,1891.2,10,0,1,5,9,5,0,0,0,0,14942,6.6,17268,210,29,-3970,-2818,21.0,1494.2
4459707188,1,16,3,1,7,8,10,1,1,0,0,17201,7.0,17805,221,44,317,944,22.1,1720.1,15,1,0,8,7,9,0,0,0,0,16884,6.8,16861,174,56,-317,-944,17.4,1688.4
4525919614,1,16,7,0,6,6,8,1,1,0,0,16474,6.8,17494,209,36,-912,-739,20.9,1647.4,19,6,1,6,6,12,1,0,1,0,17386,7.0,18233,244,60,912,739,24.4,1738.6
4500284767,0,16,1,1,6,7,9,1,1,0,0,16269,7.0,17222,222,44,-2132,-2887,22.2,1626.9,15,4,0,7,6,5,1,0,1,0,18401,7.4,20109,255,55,2132,2887,25.5,1840.1
4520931258,1,15,6,0,10,2,11,0,0,0,0,18858,7.2,19691,218,70,4219,3379,21.8,1885.8,83,3,1,2,10,1,1,1,0,0,14639,6.6,16312,219,56,-4219,-3379,21.9,1463.9
4445240846,0,16,2,0,7,5,6,1,1,0,0,16304,6.8,17968,230,43,0,845,23.0,1630.4,15,3,1,5,7,8,0,0,0,0,16304,6.6,17123,234,44,0,-845,23.4,1630.4
4516011875,1,26,4,1,15,4,16,0,0,0,1,22433,7.4,20086,230,56,7621,4647,23.0,2243.3,16,1,0,4,15,9,1,1,0,0,14812,6.4,15439,192,56,-7621,-4647,19.2,1481.2
4487951010,0,16,2,0,7,12,10,1,0,1,0,16222,6.6,16170,184,48,-3561,-1911,18.4,1622.2,16,1,1,12,7,17,1,1,0,0,19783,6.8,18081,237,36,3561,1911,23.7,1978.3
4296036692,0,15,5,1,9,7,10,1,1,0,0,17102,7.2,18327,207,46,339,261,20.7,1710.2,18,4,0,7,9,10,1,0,1,0,16763,6.8,18066,252,45,-339,-261,25.2,1676.3
4524847047,1,24,1,1,11,4,14,2,1,1,0,17938,6.6,16164,199,48,3413,396,19.9,1793.8,11,2,0,4,11,3,0,0,0,0,14525,6.6,15768,195,34,-3413,-396,19.5,1452.5
4494027613,0,17,0,0,4,7,3,1,0,1,0,15874,7.0,18205,223,68,-1024,940,22.3,1587.4,13,3,1,7,4,10,1,1,0,0,16898,6.8,17265,217,47,1024,-940,21.7,1689.8
4509961574,0,16,2,1,6,10,8,1,1,0,0,17088,6.8,18472,206,82,-2595,-574,20.6,1708.8,13,2,0,10,6,9,0,0,0,1,19683,7.4,19046,233,50,2595,574,23.3,1968.3
4524850374,0,26,3,0,8,8,8,0,0,0,0,16357,6.6,16464,193,37,-232,97,19.3,1635.7,16,2,1,8,8,8,1,1,0,0,16589,6.6,16367,196,56,232,-97,19.6,1658.9
4462053838,0,17,3,0,7,6,8,0,0,0,0,16441,6.4,16272,218,42,132,-2613,21.8,1644.1,39,5,1,6,7,6,1,1,0,0,16309,7.0,18885,203,69,-132,2613,20.3,1630.9
4513317903,0,18,4,0,6,10,3,1,1,0,0,15602,6.4,16415,206,45,-3060,-2937,20.6,1560.2,18,8,1,10,6,7,0,0,0,0,18662,7.4,19352,238,48,3060,2937,23.8,1866.2
4524656302,1,18,1,0,6,4,8,1,1,0,0,16869,7.2,19165,232,63,840,2240,23.2,1686.9,16,0,1,4,6,5,1,0,1,0,16029,6.8,16925,210,52,-840,-2240,21.0,1602.9
4419869178,1,16,2,1,6,7,3,1,0,1,0,15907,7.2,17910,206,55,-112,727,20.6,1590.7,17,3,0,7,6,9,0,0,0,0,16019,6.8,17183,211,44,112,-727,21.1,1601.9
4457422227,0,16,2,0,7,8,10,0,0,0,0,16808,6.8,17371,189,60,-400,-539,18.9,1680.8,16,2,1,8,7,5,1,1,0,0,17208,7.2,17910,194,61,400,539,19.4,1720.8
4513004661,1,14,7,1,7,6,7,0,0,0,0,16445,7.0,18995,224,40,214,1568,22.4,1644.5,20,2,0,6,7,5,0,0,0,0,16231,6.8,17427,215,53,-214,-1568,21.5,1623.1
4452036224,0,16,1,1,7,9,8,1,1,0,0,16497,6.6,16957,207,44,-1736,-2692,20.7,1649.7,14,1,0,9,7,7,0,0,0,0,18233,7.2,19649,246,48,1736,2692,24.6,1823.3
4424593685,0,15,2,0,3,3,4,0,0,0,0,14462,6.6,15785,197,47,-360,-1748,19.7,1446.2,23,1,1,3,3,2,1,0,1,0,14822,6.8,17533,209,56,360,1748,20.9,1482.2
4497742597,0,60,3,0,7,4,10,1,1,0,0,16641,7.0,18150,221,51,1459,970,22.1,1664.1,14,2,1,4,7,2,0,0,0,0,15182,6.8,17180,210,52,-1459,-970,21.0,1518.2
4477827801,1,23,1,1,6,4,5,0,0,0,0,15983,7.2,19092,218,48,515,1403,21.8,1598.3,36,4,0,4,6,5,1,1,0,0,15468,6.8,17689,194,60,-515,-1403,19.4,1546.8
4503114747,0,144,2,0,9,5,7,1,1,0,0,18227,7.4,19733,248,56,3036,3251,24.8,1822.7,15,2,1,5,9,3,0,0,0,0,15191,6.6,16482,173,44,-3036,-3251,17.3,1519.1
4510691546,1,14,2,1,10,8,17,1,1,0,0,17723,6.8,17913,201,54,557,-1383,20.1,1772.3,13,2,0,8,10,9,0,0,0,0,17166,7.4,19296,204,68,-557,1383,20.4,1716.6
4518930107,1,14,0,1,5,7,4,0,0,0,0,15637,6.6,16107,201,50,-460,-842,20.1,1563.7,19,1,0,7,5,9,0,0,0,0,16097,6.8,16949,218,31,460,842,21.8,1609.7
4526702861,0,16,0,1,2,2,0,0,0,0,0,14828,7.2,18414,237,68,-507,343,23.7,1482.8,14,3,0,2,2,3,1,1,0,0,15335,7.0,18071,260,40,507,-343,26.0,1533.5
4480078875,1,24,4,0,7,5,8,2,1,1,0,17477,6.8,18070,186,62,1049,811,18.6,1747.7,15,4,1,5,7,4,0,0,0,0,16428,6.6,17259,228,41,-1049,-811,22.8,1642.8
4516872097,1,14,1,0,3,6,6,0,0,0,0,14339,6.0,15064,197,32,-3074,-2611,19.7,1433.9,14,4,1,6,3,10,0,0,0,0,17413,6.8,17675,233,49,3074,2611,23.3,1741.3
4464794186,0,16,3,1,2,5,2,1,1,0,0,14485,6.8,17287,220,63,-1866,-1885,22.0,1448.5,13,1,0,5,2,4,0,0,0,0,16351,7.4,19172,253,56,1866,1885,25.3,1635.1
4519376490,0,14,0,1,7,8,7,1,0,1,0,17140,7.2,18192,207,52,-389,226,20.7,1714.0,15,2,0,8,7,9,1,1,0,0,17529,7.0,17966,208,48,389,-226,20.8,1752.9
4472461570,0,45,4,0,2,5,2,0,0,0,0,14758,6.8,16974,237,50,-1369,-1808,23.7,1475.8,16,3,1,5,2,2,1,0,1,0,16127,7.2,18782,242,57,1369,1808,24.2,1612.7
4518551820,1,18,1,0,10,8,17,1,1,0,0,17513,6.6,16367,174,48,332,-200,17.4,1751.3,24,4,1,8,10,13,0,0,0,0,17181,6.4,16567,209,46,-332,200,20.9,1718.1
4516594207,1,16,6,0,7,6,4,0,0,0,0,17641,7.2,19312,237,50,1496,1352,23.7,1764.1,18,2,1,6,7,4,1,1,0,0,16145,7.0,17960,214,43,-1496,-1352,21.4,1614.5
4469393783,0,29,3,0,5,9,7,0,0,0,0,15831,6.6,17389,208,59,-2241,-1888,20.8,1583.1,15,2,1,9,5,13,2,1,1,0,18072,7.2,19277,218,52,2241,1888,21.8,1807.2
4466130719,0,15,2,0,6,2,9,2,1,1,0,16260,6.8,17559,224,49,1481,528,22.4,1626.0,15,3,1,2,6,5,0,0,0,0,14779,6.6,17031,195,64,-1481,-528,19.5,1477.9
4525240556,1,15,1,1,10,7,5,1,1,0,0,17214,7.2,18566,200,62,1690,1316,20.0,1721.4,38,2,0,7,10,9,0,0,0,0,15524,6.8,17250,162,42,-1690,-1316,16.2,1552.4
4502665532,1,14,2,1,9,11,12,0,0,0,0,17140,6.6,16531,167,30,-791,-961,16.7,1714.0,16,2,0,11,9,11,0,0,0,0,17931,7.0,17492,214,40,791,961,21.4,1793.1
4522503290,0,16,3,1,7,13,9,0,0,0,0,17372,6.8,17530,202,56,-2817,-1700,20.2,1737.2,21,1,0,13,7,17,1,1,0,0,20189,7.2,19230,218,58,2817,1700,21.8,2018.9
4467944823,0,17,3,1,2,10,0,0,0,0,0,14704,7.0,17930,227,60,-3517,-1818,22.7,1470.4,11,1,0,10,2,7,1,1,0,0,18221,7.6,19748,235,56,3517,1818,23.5,1822.1
4479273649,0,10,0,0,3,5,8,0,0,0,0,14759,6.8,17310,194,56,-1394,-589,19.4,1475.9,13,1,1,5,3,7,1,1,0,0,16153,6.8,17899,246,44,1394,589,24.6,1615.3
4516273622,0,16,3,0,4,12,3,0,0,0,0,15111,6.6,16978,218,41,-4189,-3388,21.8,1511.1,15,1,1,12,4,10,2,1,1,0,19300,7.4,20366,249,46,4189,3388,24.9,1930.0
4521025681,0,19,3,0,2,10,0,0,0,0,0,14143,6.6,16647,183,55,-5891,-3716,18.3,1414.3,12,2,1,10,2,7,2,1,1,1,20034,7.4,20363,264,48,5891,3716,26.4,2003.4
4517000510,1,16,3,0,4,4,5,1,1,0,0,15561,6.8,17448,226,47,246,-549,22.6,1556.1,15,2,1,4,4,1,0,0,0,0,15315,7.0,17997,228,51,-246,549,22.8,1531.5
4526866944,0,17,3,1,7,4,12,1,1,0,0,17199,7.0,19299,229,59,1545,1417,22.9,1719.9,16,2,0,4,7,5,0,0,0,0,15654,7.2,17882,226,53,-1545,-1417,22.6,1565.4
4517859191,0,17,3,0,3,11,3,0,0,0,0,14595,6.4,15064,161,59,-3619,-4011,16.1,1459.5,47,2,1,11,3,9,1,1,0,0,18214,7.2,19075,222,54,3619,4011,22.2,1821.4
4510536402,0,48,4,0,1,6,2,0,0,0,0,13653,6.6,16539,220,52,-3728,-3076,22.0,1365.3,14,1,1,6,1,4,0,0,0,0,17381,7.4,19615,220,64,3728,3076,22.0,1738.1
4470775145,1,14,3,1,5,5,3,0,0,0,0,15723,6.8,17400,242,35,451,1157,24.2,1572.3,15,3,0,5,5,5,0,0,0,0,15272,6.8,16243,234,24,-451,-1157,23.4,1527.2
4475087620,1,17,4,1,6,6,6,1,1,0,0,16004,7.0,18381,216,38,-695,-683,21.6,1600.4,14,4,0,6,6,6,0,0,0,0,16699,7.0,19064,240,52,695,683,24.0,1669.9
4517953972,0,16,1,0,2,14,3,0,0,0,0,14584,6.4,16269,198,50,-4788,-2570,19.8,1458.4,49,4,1,14,2,20,1,1,0,0,19372,7.2,18839,214,44,4788,2570,21.4,1937.2
4517946996,0,23,2,0,1,9,2,0,0,0,0,12941,6.4,15085,178,43,-5519,-5521,17.8,1294.1,16,6,1,9,1,10,2,1,1,0,18460,7.6,20606,253,52,5519,5521,25.3,1846.0
4517684472,0,13,1,0,1,3,1,0,0,0,0,14692,7.0,18342,227,47,-2373,-1592,22.7,1469.2,17,1,1,3,1,5,1,1,0,0,17065,7.2,19934,250,76,2373,1592,25.0,1706.5
4525381910,0,15,2,0,7,10,2,1,1,0,0,17093,7.0,18200,217,60,-492,175,21.7,1709.3,12,1,1,10,7,10,0,0,0,0,17585,7.0,18025,214,39,492,-175,21.4,1758.5
4527087775,1,16,3,1,10,5,13,1,0,1,0,18868,7.2,19111,259,44,2461,956,25.9,1886.8,17,4,0,5,10,5,1,1,0,0,16407,6.8,18155,237,52,-2461,-956,23.7,1640.7
4447454606,0,14,5,1,6,2,4,0,0,0,0,16383,7.0,18625,258,33,1678,1155,25.8,1638.3,22,6,0,2,6,1,1,1,0,0,14705,7.0,17470,216,59,-1678,-1155,21.6,1470.5
4503636905,0,43,3,0,3,7,3,1,0,1,0,14852,6.8,16888,203,54,-1975,-1345,20.3,1485.2,17,14,1,7,3,6,0,0,0,0,16827,6.8,18233,218,53,1975,1345,21.8,1682.7
4520989053,0,85,2,1,5,9,2,1,0,1,0,16235,7.2,18790,213,67,-1126,-601,21.3,1623.5,20,2,0,9,5,6,1,1,0,0,17361,7.2,19391,230,44,1126,601,23.0,1736.1
4500905906,0,30,3,0,6,4,4,1,1,0,0,16017,7.2,17471,208,51,1598,2478,20.8,1601.7,17,2,1,4,6,6,0,0,0,0,14419,6.2,14993,194,34,-1598,-2478,19.4,1441.9
4458380035,1,14,3,1,12,4,13,1,1,0,0,18705,7.4,19808,210,50,3692,4028,21.0,1870.5,12,2,0,4,12,5,0,0,0,0,15013,6.4,15780,219,36,-3692,-4028,21.9,1501.3
4521846073,1,22,2,1,6,5,7,1,0,1,0,16937,7.0,18194,221,43,592,242,22.1,1693.7,14,3,0,5,6,4,1,1,0,0,16345,7.2,17952,215,67,-592,-242,21.5,1634.5
4484829237,1,18,2,1,5,4,4,1,1,0,0,15792,7.0,17609,228,56,683,246,22.8,1579.2,20,1,0,4,5,6,0,0,0,0,15109,6.6,17363,210,41,-683,-246,21.0,1510.9
4429865093,0,18,0,0,5,6,3,1,1,0,0,15288,6.8,18328,218,52,-1652,466,21.8,1528.8,9,7,1,6,5,9,0,0,0,0,16940,6.8,17862,224,47,1652,-466,22.4,1694.0
4527033024,1,13,0,0,11,2,15,1,1,0,0,19508,7.4,19814,233,60,4882,2658,23.3,1950.8,13,1,1,2,11,1,0,0,0,0,14626,6.8,17156,219,60,-4882,-2658,21.9,1462.6
4526397117,0,54,4,0,6,16,3,0,0,0,0,14731,6.2,15155,154,44,-6086,-3112,15.4,1473.1,21,5,1,16,6,20,0,0,0,0,20817,7.0,18267,237,32,6086,3112,23.7,2081.7
4507330276,0,17,5,0,7,6,12,0,0,0,0,17518,7.2,18342,242,46,1807,932,24.2,1751.8,52,4,1,6,7,9,2,1,1,0,15711,6.8,17410,198,60,-1807,-932,19.8,1571.1
4527584332,1,15,3,0,7,9,8,1,0,1,0,16066,6.8,18218,195,48,-1826,-3,19.5,1606.6,61,2,1,9,7,11,1,1,0,0,17892,7.0,18221,183,52,1826,3,18.3,1789.2
4505204849,0,14,2,0,3,10,3,0,0,0,0,15016,6.8,17172,216,38,-2188,-1753,21.6,1501.6,81,3,1,10,3,11,1,1,0,0,17204,7.0,18925,217,35,2188,1753,21.7,1720.4
4523731110,1,36,4,1,11,3,14,1,1,0,0,19276,7.4,19210,237,42,4275,2943,23.7,1927.6,16,1,0,3,11,6,0,0,0,0,15001,6.4,16267,205,43,-4275,-2943,20.5,1500.1
4465119054,1,25,2,0,7,7,8,0,0,0,0,17194,7.0,18161,233,39,633,-944,23.3,1719.4,19,1,1,7,7,5,0,0,0,0,16561,7.2,19105,202,54,-633,944,20.2,1656.1
4509931698,0,11,2,0,0,7,0,0,0,0,0,13068,6.4,15506,198,48,-5375,-4425,19.8,1306.8,124,1,1,7,0,5,2,1,1,0,18443,7.2,19931,235,63,5375,4425,23.5,1844.3
4467014828,0,120,2,1,4,9,3,0,0,0,0,15084,6.6,16366,211,44,-2904,-2819,21.1,1508.4,18,2,0,9,4,8,1,0,1,0,17988,7.2,19185,237,47,2904,2819,23.7,1798.8
4455236483,1,18,4,1,4,1,6,1,1,0,0,16448,7.2,18932,248,61,1306,431,24.8,1644.8,14,3,0,1,4,2,0,0,0,0,15142,7.0,18501,262,64,-1306,-431,26.2,1514.2
4508073234,0,11,1,0,1,5,3,0,0,0,0,13686,6.8,16575,213,48,-2755,-2255,21.3,1368.6,17,0,1,5,1,4,2,1,1,0,16441,7.2,18830,230,59,2755,2255,23.0,1644.1
4500531155,0,35,6,1,5,4,6,1,1,0,0,16516,7.2,19033,224,52,1115,1256,22.4,1651.6,39,2,0,4,5,3,0,0,0,0,15401,7.2,17777,209,60,-1115,-1256,20.9,1540.1
4467510669,1,19,4,1,9,7,10,0,0,0,0,17556,7.0,18073,220,41,1253,-235,22.0,1755.6,16,7,0,7,9,4,0,0,0,0,16303,7.0,18308,191,68,-1253,235,19.1,1630.3
4506659167,0,14,3,0,8,11,7,2,1,1,0,16936,6.6,16881,209,56,-865,-480,20.9,1693.6,16,2,1,11,8,12,0,0,0,0,17801,7.0,17361,188,43,865,480,18.8,1780.1
4500875626,1,18,4,0,8,7,8,0,0,0,0,17219,7.2,18432,212,60,-55,-298,21.2,1721.9,18,4,1,7,8,7,1,1,0,0,17274,7.0,18730,251,59,55,298,25.1,1727.4
4505558146,0,43,3,0,4,7,8,0,0,0,0,15462,6.6,17446,209,54,-2237,-885,20.9,1546.2,14,7,1,7,4,12,1,1,0,0,17699,6.8,18331,256,46,2237,885,25.6,1769.9
4525053035,0,16,0,0,4,8,6,1,1,0,0,15235,6.6,17625,195,49,-2839,18,19.5,1523.5,13,1,1,8,4,6,1,0,1,1,18074,7.0,17607,220,54,2839,-18,22.0,1807.4
4521327659,1,13,2,1,8,3,9,1,1,0,0,17428,7.2,19729,220,50,2087,2578,22.0,1742.8,17,4,0,3,8,2,0,0,0,0,15341,6.8,17151,229,65,-2087,-2578,22.9,1534.1
4515902763,1,19,3,0,6,9,3,0,0,0,0,14947,6.6,16859,165,63,-2922,-2165,16.5,1494.7,12,6,1,9,6,6,1,1,0,0,17869,7.2,19024,239,44,2922,2165,23.9,1786.9
4515451687,0,62,2,0,5,2,7,0,0,0,0,16238,7.0,18854,260,36,428,374,26.0,1623.8,82,2,1,2,5,1,1,0,1,0,15810,7.2,18480,232,80,-428,-374,23.2,1581.0
4519784011,1,33,2,0,11,7,12,1,1,0,1,19241,7.0,18942,198,50,1350,577,19.8,1924.1,12,1,1,7,11,11,0,0,0,0,17891,7.0,18365,247,44,-1350,-577,24.7,1789.1
4523722482,0,14,3,0,6,5,8,2,1,1,0,16302,7.2,18772,231,46,336,936,23.1,1630.2,16,0,1,5,6,5,0,0,0,0,15966,7.0,17836,223,44,-336,-936,22.3,1596.6
4472755349,1,40,4,0,4,5,4,0,0,0,0,15284,6.8,17975,221,53,-188,899,22.1,1528.4,15,4,1,5,4,6,0,0,0,0,15472,6.8,17076,226,44,188,-899,22.6,1547.2
4449732140,1,14,4,1,9,4,11,1,0,1,0,17611,7.2,18414,223,58,1706,1239,22.3,1761.1,13,3,0,4,9,6,1,1,0,0,15905,6.8,17175,233,41,-1706,-1239,23.3,1590.5
4483110650,1,16,2,0,6,6,5,0,0,0,0,16448,6.8,17691,207,59,442,541,20.7,1644.8,18,1,1,6,6,3,0,0,0,0,16006,6.8,17150,221,52,-442,-541,22.1,1600.6
4484624714,0,18,3,1,8,5,5,0,0,0,0,16208,6.4,16287,190,40,-315,-1874,19.0,1620.8,16,3,0,5,8,5,1,1,0,0,16523,7.0,18161,242,58,315,1874,24.2,1652.3
4522467789,0,15,2,0,2,8,1,0,0,0,0,13874,6.6,17105,203,52,-4231,-3158,20.3,1387.4,17,5,1,8,2,7,1,1,0,0,18105,7.6,20263,248,69,4231,3158,24.8,1810.5
4457541720,1,12,2,1,3,3,2,2,1,1,0,15550,7.2,18425,249,56,-424,-1075,24.9,1555.0,15,4,0,3,3,5,0,0,0,0,15974,7.2,19500,245,68,424,1075,24.5,1597.4
4504512866,0,11,3,1,6,7,7,0,0,0,0,17330,7.0,17971,237,52,-365,-1278,23.7,1733.0,15,3,0,7,6,8,1,1,0,0,17695,7.2,19249,227,63,365,1278,22.7,1769.5
4522272294,1,37,5,1,15,4,18,1,1,0,0,20186,7.2,19725,216,40,5491,5335,21.6,2018.6,15,2,0,4,15,2,0,0,0,0,14695,6.0,14390,159,48,-5491,-5335,15.9,1469.5
4500291945,1,16,0,1,7,3,10,1,1,0,0,17546,6.8,17209,228,47,1493,1167,22.8,1754.6,10,2,0,3,7,4,1,0,1,1,16053,6.4,16042,193,51,-1493,-1167,19.3,1605.3
4519004936,0,11,0,1,5,9,2,0,0,0,0,14681,6.8,17137,174,44,-2985,-3019,17.4,1468.1,9,0,0,9,5,8,1,1,0,0,17666,7.6,20156,213,55,2985,3019,21.3,1766.6
4472940975,0,17,5,1,5,1,6,1,1,0,0,15258,7.0,18398,223,44,993,872,22.3,1525.8,69,2,0,1,5,1,0,0,0,0,14265,6.8,17526,225,59,-993,-872,22.5,1426.5
4459757488,1,13,1,1,11,2,17,1,1,0,0,18553,7.0,18514,204,49,4260,1422,20.4,1855.3,14,1,0,2,11,1,0,0,0,0,14293,6.8,17092,210,60,-4260,-1422,21.0,1429.3
4504853489,1,21,2,1,4,7,1,1,1,0,0,14467,6.6,16468,222,33,-1663,-1174,22.2,1446.7,18,3,0,7,4,5,0,0,0,0,16130,6.8,17642,186,36,1663,1174,18.6,1613.0
4523100302,0,17,4,0,1,4,1,0,0,0,0,14305,6.8,17810,251,44,-2889,-2106,25.1,1430.5,19,6,1,4,1,5,1,1,0,0,17194,7.2,19916,282,56,2889,2106,28.2,1719.4
4519431177,0,9,0,0,7,10,7,0,0,0,0,17563,7.0,17585,199,41,-1360,-1561,19.9,1756.3,15,0,1,10,7,11,1,1,0,0,18923,7.2,19146,244,54,1360,1561,24.4,1892.3
4485701075,1,13,2,1,5,0,4,0,0,0,0,16637,7.0,18095,250,51,2712,1161,25.0,1663.7,39,2,0,0,5,0,1,1,0,0,13925,7.0,16934,215,62,-2712,-1161,21.5,1392.5
4477353285,1,14,1,1,5,2,1,0,0,0,0,15510,7.0,17649,203,48,1215,1170,20.3,1551.0,13,0,0,2,5,2,1,1,0,0,14295,6.6,16479,244,48,-1215,-1170,24.4,1429.5
4489954000,1,14,3,0,3,4,5,1,1,0,0,15565,6.8,17390,227,60,350,-664,22.7,1556.5,16,2,1,4,3,4,1,0,1,0,15215,7.0,18054,221,52,-350,664,22.1,1521.5
4522840009,0,18,1,0,6,3,8,0,0,0,0,17099,7.2,19019,222,69,1847,1663,22.2,1709.9,16,0,1,3,6,5,2,1,1,0,15252,6.8,17356,210,70,-1847,-1663,21.0,1525.2
4509730924,1,16,1,0,7,5,8,0,0,0,0,16294,6.8,18342,214,50,-18,252,21.4,1629.4,17,1,1,5,7,4,0,0,0,0,16312,7.0,18090,229,45,18,-252,22.9,1631.2
4526649785,1,14,1,0,7,6,7,1,1,0,0,16553,7.2,19304,205,56,1216,2889,20.5,1655.3,11,2,1,6,7,7,0,0,0,0,15337,6.6,16415,173,44,-1216,-2889,17.3,1533.7
4518453664,0,48,0,0,6,5,6,0,0,0,0,15904,6.8,17623,201,48,-73,217,20.1,1590.4,15,4,1,5,6,6,2,1,1,0,15977,6.6,17406,228,48,73,-217,22.8,1597.7
4522684962,0,22,2,0,10,5,10,1,0,1,0,17835,7.2,18036,205,50,1923,437,20.5,1783.5,18,2,1,5,10,5,0,0,0,0,15912,6.8,17599,216,43,-1923,-437,21.6,1591.2
4516724149,1,17,6,0,6,9,3,1,1,0,0,16301,7.2,18968,235,60,-1207,606,23.5,1630.1,25,6,1,9,6,10,0,0,0,0,17508,7.0,18362,230,45,1207,-606,23.0,1750.8
4503381304,0,34,2,0,6,7,5,1,0,1,0,17194,7.2,18397,234,62,985,2102,23.4,1719.4,16,1,1,7,6,7,0,0,0,0,16209,6.4,16295,215,51,-985,-2102,21.5,1620.9
4477006616,1,14,1,1,4,5,5,0,0,0,0,16193,7.0,18763,235,64,-405,-1523,23.5,1619.3,18,3,0,5,4,7,2,1,1,0,16598,7.4,20286,248,65,405,1523,24.8,1659.8
4471999593,0,15,4,0,6,3,3,0,0,0,0,15365,6.4,16848,186,44,-136,-385,18.6,1536.5,19,3,1,3,6,3,0,0,0,0,15501,6.6,17233,219,48,136,385,21.9,1550.1
4484529733,0,41,8,0,3,5,4,0,0,0,0,15273,7.0,17980,214,58,-764,-1142,21.4,1527.3,20,3,1,5,3,1,1,1,0,0,16037,7.0,19122,248,56,764,1142,24.8,1603.7
4522860957,1,15,4,0,7,4,9,0,0,0,0,16999,6.8,17880,228,40,1671,1072,22.8,1699.9,18,4,1,4,7,6,1,1,0,0,15328,6.4,16808,206,55,-1671,-1072,20.6,1532.8
4495304851,0,15,1,0,8,6,3,0,0,0,0,16678,7.0,18875,216,64,1079,1586,21.6,1667.8,15,5,1,6,8,3,1,1,0,0,15599,6.8,17289,220,32,-1079,-1586,22.0,1559.9
4520744316,0,40,4,0,9,10,12,0,0,0,0,17252,7.0,18777,205,48,-1287,-6,20.5,1725.2,30,3,1,10,9,9,0,0,0,0,18539,7.2,18783,217,47,1287,6,21.7,1853.9
4527171182,1,16,1,1,8,1,6,1,0,1,2,18618,7.2,19304,223,39,4343,2636,22.3,1861.8,29,4,0,1,8,1,0,0,0,0,14275,6.8,16668,190,75,-4343,-2636,19.0,1427.5
4511726716,1,84,3,0,8,6,8,0,0,0,0,16602,6.8,16879,163,49,-786,-808,16.3,1660.2,46,0,1,6,8,2,0,0,0,1,17388,6.8,17687,206,54,786,808,20.6,1738.8
4477115596,0,18,5,0,6,9,6,1,0,1,0,17245,7.2,18890,236,52,-862,1054,23.6,1724.5,18,2,1,9,6,13,1,1,0,0,18107,6.8,17836,219,40,862,-1054,21.9,1810.7
4523343583,1,20,4,0,8,4,8,1,1,0,0,17463,7.0,18601,229,50,2337,2150,22.9,1746.3,20,3,1,4,8,3,0,0,0,0,15126,6.8,16451,204,39,-2337,-2150,20.4,1512.6
4503318833,0,12,2,0,4,8,4,0,0,0,0,15715,6.8,17533,229,40,-2733,-2104,22.9,1571.5,16,3,1,8,4,9,2,1,1,0,18448,7.4,19637,237,56,2733,2104,23.7,1844.8
4506343146,0,18,3,1,5,6,7,1,1,0,0,15425,7.0,17540,208,51,-1611,-1931,20.8,1542.5,16,6,0,6,5,6,0,0,0,0,17036,7.4,19471,246,56,1611,1931,24.6,1703.6
4526158694,1,14,3,0,13,3,11,1,1,0,0,18000,7.0,18718,214,40,3330,3501,21.4,1800.0,16,1,1,3,13,3,0,0,0,0,14670,6.2,15217,209,42,-3330,-3501,20.9,1467.0
4519181878,1,16,3,1,10,9,6,0,0,0,0,17770,7.4,19036,239,47,995,2657,23.9,1777.0,18,1,0,9,10,8,0,0,0,0,16775,6.6,16379,155,52,-995,-2657,15.5,1677.5
4513955643,1,15,3,0,4,1,3,1,1,0,0,16435,7.4,19956,250,63,1527,1629,25.0,1643.5,13,2,1,1,4,0,0,0,0,0,14908,7.0,18327,228,56,-1527,-1629,22.8,1490.8
4454360834,1,17,1,0,9,4,4,1,0,1,0,18458,7.4,20320,270,51,3158,2594,27.0,1845.8,14,2,1,4,9,6,1,1,0,0,15300,6.8,17726,202,60,-3158,-2594,20.2,1530.0
4471975610,0,17,0,0,10,13,5,1,1,0,0,18656,7.2,19253,227,46,42,666,22.7,1865.6,13,3,1,13,10,14,0,0,0,0,18614,7.0,18587,211,36,-42,-666,21.1,1861.4
4527243776,1,17,6,1,7,1,11,1,1,0,0,17709,7.2,19221,242,52,3324,1398,24.2,1770.9,29,4,0,1,7,0,1,0,1,0,14385,6.6,17823,227,68,-3324,-1398,22.7,1438.5
4500087956,0,20,3,1,6,3,6,0,0,0,0,16993,7.4,19908,230,60,1886,1688,23.0,1699.3,15,5,0,3,6,4,0,0,0,0,15107,7.0,18220,230,48,-1886,-1688,23.0,1510.7
4524250123,1,21,2,1,7,2,4,0,0,0,0,16631,7.2,19270,234,53,2088,1774,23.4,1663.1,28,0,0,2,7,3,1,1,0,0,14543,6.8,17496,209,64,-2088,-1774,20.9,1454.3
4518963462,0,22,4,0,6,12,7,0,0,0,0,16851,6.8,17931,201,48,-2286,-976,20.1,1685.1,68,3,1,12,6,15,0,0,0,0,19137,7.0,18907,199,52,2286,976,19.9,1913.7
4502159358,0,15,2,1,13,9,19,1,1,0,0,19528,7.2,18855,211,42,1852,219,21.1,1952.8,16,2,0,9,13,5,0,0,0,0,17676,7.2,18636,217,72,-1852,-219,21.7,1767.6
4516933345,1,17,2,0,9,7,8,1,1,0,0,17661,6.6,17077,233,40,815,590,23.3,1766.1,17,3,1,7,9,10,0,0,0,0,16846,6.8,16487,191,38,-815,-590,19.1,1684.6
4484552645,1,14,4,1,8,8,6,0,0,0,1,18801,7.2,19438,215,74,1917,1322,21.5,1880.1,19,2,0,8,8,6,1,1,0,0,16884,7.0,18116,202,50,-1917,-1322,20.2,1688.4
4503760931,0,15,6,0,4,8,3,1,1,0,0,15102,6.6,16371,201,59,-3465,-897,20.1,1510.2,20,6,1,8,4,11,1,0,1,1,18567,6.6,17268,253,28,3465,897,25.3,1856.7
4479722727,1,16,3,1,9,3,8,2,1,1,1,18743,7.0,18381,209,49,4324,1705,20.9,1874.3,15,4,0,3,9,1,0,0,0,0,14419,6.6,16676,191,56,-4324,-1705,19.1,1441.9
4510540310,1,68,3,0,7,3,7,1,0,1,0,16498,7.2,18955,219,60,468,2091,21.9,1649.8,178,2,1,3,7,4,0,0,0,0,16030,6.6,16864,237,64,-468,-2091,23.7,1603.0
4526026089,1,41,0,1,7,5,5,1,1,0,0,15954,7.0,17461,191,54,305,-374,19.1,1595.4,14,1,0,5,7,9,0,0,0,0,15649,6.8,17835,234,41,-305,374,23.4,1564.9
4457518581,1,20,5,1,7,1,9,0,0,0,0,17562,7.2,19532,213,59,3512,2161,21.3,1756.2,15,3,0,1,7,2,1,1,0,0,14050,6.8,17371,215,62,-3512,-2161,21.5,1405.0
4526366514,1,16,2,1,7,6,7,0,0,0,0,18035,7.0,18668,250,48,1977,1635,25.0,1803.5,13,2,0,6,7,13,0,0,0,0,16058,6.8,17033,183,47,-1977,-1635,18.3,1605.8
4437927077,0,198,1,1,6,9,6,0,0,0,0,16585,7.0,18342,231,55,-991,-844,23.1,1658.5,12,1,0,9,6,7,0,0,0,0,17576,7.4,19186,223,40,991,844,22.3,1757.6
4502492792,1,18,3,1,3,4,3,1,1,0,0,15575,6.6,16473,220,48,737,-691,22.0,1557.5,18,4,0,4,3,4,0,0,0,0,14838,6.6,17164,201,43,-737,691,20.1,1483.8
4477706484,0,17,4,0,8,7,11,0,0,0,0,16343,6.8,16580,179,28,-1182,-1113,17.9,1634.3,19,5,1,7,8,3,1,0,1,1,17525,7.0,17693,204,55,1182,1113,20.4,1752.5
4524386145,0,11,2,0,4,12,1,0,0,0,0,14464,6.2,15227,164,58,-4820,-2651,16.4,1446.4,15,0,1,12,4,9,0,0,0,1,19284,7.0,17878,206,44,4820,2651,20.6,1928.4
4495602419,0,12,1,0,7,10,8,0,0,0,0,16575,7.0,18524,204,42,-2362,79,20.4,1657.5,230,1,1,10,7,9,0,0,0,0,18937,7.0,18445,247,44,2362,-79,24.7,1893.7
4522772172,0,15,1,1,6,14,6,0,0,0,0,16197,6.4,15405,203,40,-2941,-3143,20.3,1619.7,81,3,0,14,6,16,1,1,0,0,19138,7.0,18548,194,54,2941,3143,19.4,1913.8
4502931082,0,14,0,0,6,7,5,0,0,0,0,15903,7.0,18823,205,53,-623,1024,20.5,1590.3,14,1,1,7,6,5,1,1,0,0,16526,7.0,17799,205,48,623,-1024,20.5,1652.6
4502539772,0,14,2,1,3,8,6,0,0,0,0,15193,6.8,17054,232,57,-1810,-2661,23.2,1519.3,16,0,0,8,3,2,1,1,0,0,17003,7.0,19715,235,65,1810,2661,23.5,1700.3
4413135878,1,17,4,0,12,5,13,0,0,0,0,18628,7.0,18625,239,43,2863,2632,23.9,1862.8,18,5,1,5,12,7,0,0,0,0,15765,6.6,15993,207,45,-2863,-2632,20.7,1576.5
4521227315,1,14,0,0,3,5,3,0,0,0,0,16026,7.0,18490,233,57,-554,521,23.3,1602.6,11,1,1,5,3,6,1,1,0,0,16580,6.8,17969,234,44,554,-521,23.4,1658.0
4505404755,1,13,1,0,4,4,5,1,1,0,0,15398,6.8,17802,200,60,-893,771,20.0,1539.8,15,2,1,4,4,4,0,0,0,1,16291,6.8,17031,212,36,893,-771,21.2,1629.1
4429821639,0,11,2,1,11,2,9,2,1,1,0,17435,7.0,19432,236,52,1220,589,23.6,1743.5,14,2,0,2,11,2,0,0,0,0,16215,7.0,18843,241,68,-1220,-589,24.1,1621.5
4494829301,1,19,3,0,5,2,10,2,1,1,0,16256,7.0,17985,218,61,2050,1834,21.8,1625.6,22,4,1,2,5,3,0,0,0,0,14206,6.4,16151,217,45,-2050,-1834,21.7,1420.6
4526108051,0,18,1,0,9,7,9,0,0,0,0,17556,7.2,18967,214,59,805,1723,21.4,1755.6,12,3,1,7,9,12,1,1,0,0,16751,6.8,17244,230,36,-805,-1723,23.0,1675.1
4477165590,0,15,0,0,3,5,3,0,0,0,0,15767,7.2,18720,233,56,-943,140,23.3,1576.7,14,4,1,5,3,5,1,1,0,0,16710,7.2,18580,249,48,943,-140,24.9,1671.0
4464723011,1,12,2,1,10,6,5,0,0,0,0,17142,7.0,18615,221,45,2121,1813,22.1,1714.2,16,0,0,6,10,3,0,0,0,0,15021,6.4,16802,200,31,-2121,-1813,20.0,1502.1
4500848108,0,14,4,0,2,5,1,1,1,0,0,13980,6.8,16415,221,52,-1860,-1622,22.1,1398.0,16,5,1,5,2,7,0,0,0,0,15840,7.2,18037,210,40,1860,1622,21.0,1584.0
4514309689,1,12,1,0,5,9,5,0,0,0,0,15400,7.0,17541,215,40,-4112,-2493,21.5,1540.0,16,1,1,9,5,9,0,0,0,0,19512,7.4,20034,219,72,4112,2493,21.9,1951.2
4523404428,1,18,2,0,8,2,8,1,1,0,0,17351,7.2,19306,235,55,3251,2936,23.5,1735.1,14,3,1,2,8,1,1,0,1,0,14100,6.6,16370,213,44,-3251,-2936,21.3,1410.0
4484057160,1,19,2,0,7,5,12,2,1,1,0,18328,7.0,18180,223,57,3048,2219,22.3,1832.8,17,1,1,5,7,5,0,0,0,0,15280,6.6,15961,195,49,-3048,-2219,19.5,1528.0
4515178661,0,18,4,1,5,4,5,1,0,1,0,16313,6.8,17999,234,45,-220,67,23.4,1631.3,35,4,0,4,5,5,1,1,0,0,16533,7.2,17932,232,48,220,-67,23.2,1653.3
4510298547,1,17,1,1,12,4,19,1,1,0,0,18377,6.8,17762,193,50,2963,141,19.3,1837.7,15,2,0,4,12,1,0,0,0,0,15414,7.0,17621,221,47,-2963,-141,22.1,1541.4
4510761424,1,20,2,1,7,8,8,2,1,1,0,17606,6.8,17803,227,58,290,477,22.7,1760.6,18,5,0,8,7,13,0,0,0,0,17316,6.6,17326,232,37,-290,-477,23.2,1731.6
4522648784,0,18,3,0,4,7,2,0,0,0,0,15046,6.6,17140,208,48,-1208,-614,20.8,1504.6,37,4,1,7,4,5,1,1,0,0,16254,7.0,17754,227,44,1208,614,22.7,1625.4
4523315311,1,16,1,1,8,5,7,2,1,1,1,17973,7.0,17436,223,44,2038,1029,22.3,1797.3,11,2,0,5,8,6,0,0,0,0,15935,6.4,16407,207,44,-2038,-1029,20.7,1593.5
4464899636,0,21,2,0,12,8,10,0,0,0,0,19432,7.4,19488,232,38,2939,1636,23.2,1943.2,15,3,1,8,12,8,0,0,0,0,16493,6.8,17852,203,36,-2939,-1636,20.3,1649.3
4484797457,0,18,8,0,6,11,9,0,0,0,0,16124,7.0,17595,232,37,-2494,-1188,23.2,1612.4,20,5,1,11,6,18,1,1,0,0,18618,7.0,18783,230,50,2494,1188,23.0,1861.8
4520495529,1,15,5,1,6,3,5,2,1,1,0,16929,7.4,19425,263,54,1101,1147,26.3,1692.9,80,4,0,3,6,3,0,0,0,0,15828,7.2,18278,242,49,-1101,-1147,24.2,1582.8
4526199603,0,15,3,0,5,15,6,0,0,0,0,15147,6.4,15110,201,33,-4470,-3848,20.1,1514.7,19,0,1,15,5,20,1,1,0,0,19617,7.4,18958,193,50,4470,3848,19.3,1961.7
4524090743,0,14,4,0,4,8,3,1,0,1,0,15484,7.2,18316,226,50,-2528,-882,22.6,1548.4,42,1,1,8,4,11,1,1,0,0,18012,7.2,19198,236,56,2528,882,23.6,1801.2
4449152051,1,20,2,0,14,3,16,1,0,1,0,19483,7.2,19290,227,34,5019,3765,22.7,1948.3,16,2,1,3,14,1,0,0,0,0,14464,6.4,15525,203,52,-5019,-3765,20.3,1446.4
4522844464,0,17,2,0,3,12,4,0,0,0,0,14035,6.2,14801,185,32,-5142,-3023,18.5,1403.5,19,4,1,12,3,14,1,1,0,0,19177,7.0,17824,210,55,5142,3023,21.0,1917.7
4526734113,1,17,3,1,8,5,12,0,0,0,0,17469,7.0,18265,242,44,1625,121,24.2,1746.9,14,2,0,5,8,4,0,0,0,0,15844,6.8,18144,236,51,-1625,-121,23.6,1584.4
4471530570,0,20,3,0,8,9,7,2,1,1,0,17299,7.0,18331,218,48,-1143,-1447,21.8,1729.9,16,7,1,9,8,6,0,0,0,0,18442,7.2,19778,233,60,1143,1447,23.3,1844.2
4470122147,1,16,6,0,10,6,17,1,0,1,0,17859,7.0,17682,221,32,1711,264,22.1,1785.9,32,1,1,6,10,6,0,0,0,0,16148,6.8,17418,209,44,-1711,-264,20.9,1614.8
4522531124,1,22,4,1,9,3,9,0,0,0,0,17270,6.6,17435,213,43,2318,1656,21.3,1727.0,17,6,0,3,9,3,0,0,0,0,14952,6.6,15779,220,44,-2318,-1656,22.0,1495.2
4521244850,1,13,0,1,11,5,11,2,1,1,0,19181,7.4,19634,247,50,3153,3196,24.7,1918.1,12,2,0,5,11,10,0,0,0,0,16028,6.6,16438,185,61,-3153,-3196,18.5,1602.8
4466299891,1,19,3,0,2,5,2,0,0,0,0,15292,6.8,17578,252,52,-1774,-2576,25.2,1529.2,38,5,1,5,2,4,1,1,0,0,17066,7.6,20154,267,72,1774,2576,26.7,1706.6
4490512919,0,41,7,1,5,13,7,0,0,0,0,14776,6.2,15469,161,40,-5760,-4168,16.1,1477.6,51,3,0,13,5,12,1,0,1,1,20536,7.4,19637,235,49,5760,4168,23.5,2053.6
4508832149,0,18,4,1,9,7,8,1,0,1,0,16616,7.0,17642,182,39,350,689,18.2,1661.6,19,5,0,7,9,5,1,1,0,0,16266,6.8,16953,206,52,-350,-689,20.6,1626.6
4452390949,1,11,3,1,9,4,11,1,1,0,0,17003,6.8,17799,188,58,2247,1668,18.8,1700.3,14,0,0,4,9,3,0,0,0,0,14756,6.4,16131,189,48,-2247,-1668,18.9,1475.6
4472343262,0,13,2,1,3,2,5,1,0,1,0,15649,7.2,18818,227,67,-334,-1054,22.7,1564.9,54,3,0,2,3,1,1,1,0,0,15983,7.4,19872,238,84,334,1054,23.8,1598.3
4522561203,0,35,3,1,5,4,4,1,0,1,0,16384,7.4,18938,244,50,-183,254,24.4,1638.4,16,5,0,4,5,3,1,1,0,0,16567,7.0,18684,243,60,183,-254,24.3,1656.7
4522664876,0,16,3,1,7,5,7,0,0,0,0,17406,7.0,18922,240,48,1104,183,24.0,1740.6,15,4,0,5,7,8,1,1,0,0,16302,7.2,18739,207,48,-1104,-183,20.7,1630.2
4518120338,1,11,2,0,4,2,3,0,0,0,0,16796,7.2,19731,276,56,1789,2100,27.6,1679.6,14,5,1,2,4,4,0,0,0,0,15007,6.8,17631,232,59,-1789,-2100,23.2,1500.7
4420924071,0,18,5,0,2,12,2,0,0,0,0,14834,7.0,17374,198,67,-4063,-2598,19.8,1483.4,21,7,1,12,2,12,0,0,0,0,18897,7.4,19972,243,49,4063,2598,24.3,1889.7
4449777649,0,19,2,1,9,6,9,0,0,0,0,17162,7.0,18004,193,38,778,548,19.3,1716.2,20,1,0,6,9,14,1,1,0,0,16384,7.0,17456,200,53,-778,-548,20.0,1638.4
4515468468,1,17,2,1,4,3,5,0,0,0,0,16668,7.2,18572,261,51,1401,85,26.1,1666.8,37,2,0,3,4,4,0,0,0,0,15267,7.2,18487,203,70,-1401,-85,20.3,1526.7
4462420747,0,12,3,0,3,11,3,0,0,0,0,14179,6.4,16052,205,36,-4927,-3950,20.5,1417.9,17,4,1,11,3,11,1,1,0,0,19106,7.6,20002,230,64,4927,3950,23.0,1910.6
4467884728,1,18,4,0,6,7,6,0,0,0,0,16690,7.2,18319,235,47,-516,-3,23.5,1669.0,17,2,1,7,6,9,1,1,0,0,17206,7.0,18322,235,54,516,3,23.5,1720.6
4512990467,0,18,3,1,7,11,9,1,0,1,0,17132,6.6,16777,198,56,-2250,-1591,19.8,1713.2,17,5,0,11,7,17,1,1,0,0,19382,7.0,18368,196,52,2250,1591,19.6,1938.2
4521277262,1,19,3,1,10,6,11,1,1,0,0,17777,7.2,18131,213,42,1201,316,21.3,1777.7,18,4,0,6,10,5,0,0,0,0,16576,6.8,17815,234,44,-1201,-316,23.4,1657.6
4453038156,0,33,2,1,11,11,7,1,0,1,0,16695,7.0,18507,157,40,-1505,-635,15.7,1669.5,17,1,0,11,11,9,0,0,0,0,18200,7.0,19142,188,52,1505,635,18.8,1820.0
4524531081,0,16,3,0,2,6,2,0,0,0,0,14710,6.8,17302,231,44,-3673,-2499,23.1,1471.0,56,3,1,6,2,7,2,1,1,1,18383,7.4,19801,225,71,3673,2499,22.5,1838.3
4519023406,0,15,14,0,9,6,10,0,0,0,0,17666,6.4,17054,195,50,846,-28,19.5,1766.6,37,2,1,6,9,8,0,0,0,0,16820,6.8,17082,247,40,-846,28,24.7,1682.0
4522815979,1,41,2,0,4,4,5,1,1,0,0,14990,6.8,17315,187,50,-1395,-711,18.7,1499.0,59,5,1,4,4,3,0,0,0,0,16385,7.0,18026,248,44,1395,711,24.8,1638.5
4516228247,0,20,2,0,6,8,5,0,0,0,0,16918,7.0,18911,233,51,-403,-575,23.3,1691.8,19,1,1,8,6,5,1,1,0,0,17321,7.2,19486,225,61,403,575,22.5,1732.1
4518553982,1,13,3,0,11,9,17,0,0,0,0,17774,6.6,17519,193,42,74,-513,19.3,1777.4,15,2,1,9,11,10,0,0,0,0,17700,6.8,18032,221,52,-74,513,22.1,1770.0
4518120419,1,11,2,1,8,3,13,1,1,0,0,18291,7.0,18572,235,52,3222,1012,23.5,1829.1,34,0,0,3,8,2,0,0,0,0,15069,7.2,17560,232,48,-3222,-1012,23.2,1506.9
4450596988,1,156,3,1,9,6,10,1,1,0,0,17419,7.0,18137,209,45,2196,1245,20.9,1741.9,15,2,0,6,9,5,0,0,0,0,15223,6.6,16892,192,34,-2196,-1245,19.2,1522.3
4515507171,1,14,3,0,5,5,4,1,1,0,0,16313,7.0,18652,242,47,-152,-537,24.2,1631.3,18,4,1,5,5,5,0,0,0,0,16465,7.2,19189,213,64,152,537,21.3,1646.5
4518834172,1,20,3,1,4,4,2,0,0,0,0,14926,7.0,19450,203,59,-842,2032,20.3,1492.6,15,4,0,4,4,7,1,0,1,0,15768,7.0,17418,243,47,842,-2032,24.3,1576.8
4513209170,0,22,3,0,6,5,7,0,0,0,0,16818,7.4,18786,232,57,936,704,23.2,1681.8,17,2,1,5,6,2,2,1,1,0,15882,7.2,18082,221,54,-936,-704,22.1,1588.2
4457833160,0,20,2,1,9,6,10,1,1,0,0,16836,6.6,17688,186,48,312,-613,18.6,1683.6,18,3,0,6,9,4,0,0,0,0,16524,6.8,18301,215,54,-312,613,21.5,1652.4
4510664685,0,13,5,1,5,6,5,0,0,0,0,16312,7.0,18684,239,41,-77,260,23.9,1631.2,97,2,0,6,5,11,1,1,0,0,16389,7.0,18424,230,42,77,-260,23.0,1638.9
4513514552,1,15,1,0,5,15,7,0,0,0,0,16203,6.6,17059,187,56,-5057,-3732,18.7,1620.3,19,3,1,15,5,16,1,1,0,0,21260,7.4,20791,255,56,5057,3732,25.5,2126.0
4523978853,0,17,1,0,4,8,4,0,0,0,0,15415,6.2,16047,204,44,-2472,-1067,20.4,1541.5,19,2,1,8,4,13,1,1,0,0,17887,7.0,17114,221,36,2472,1067,22.1,1788.7
4437730015,0,17,3,1,6,5,7,0,0,0,0,16762,7.0,18180,242,44,482,166,24.2,1676.2,18,2,0,5,6,8,0,0,0,0,16280,6.8,18014,231,48,-482,-166,23.1,1628.0
4521033474,1,17,5,0,3,6,4,1,1,0,0,14513,6.8,16872,202,52,-1494,-368,20.2,1451.3,18,3,1,6,3,5,0,0,0,0,16007,6.8,17240,232,51,1494,368,23.2,1600.7
4525016329,0,38,2,0,5,10,6,0,0,0,0,15141,6.8,17635,176,48,-3274,-1385,17.6,1514.1,12,15,1,10,5,8,1,1,0,0,18415,7.2,19020,238,36,3274,1385,23.8,1841.5
4481584807,1,17,1,0,5,8,4,1,1,0,0,16142,7.0,18926,218,58,-812,-202,21.8,1614.2,15,2,1,8,5,2,0,0,0,0,16954,7.2,19128,233,48,812,202,23.3,1695.4
4448119077,1,56,3,1,9,4,16,1,1,0,0,17326,6.8,18168,188,58,1209,574,18.8,1732.6,18,3,0,4,9,5,0,0,0,0,16117,6.8,17594,231,33,-1209,-574,23.1,1611.7
4516564229,0,12,1,0,5,9,3,0,0,0,0,16163,6.8,18244,218,60,-1828,-1410,21.8,1616.3,15,0,1,9,5,17,1,0,1,0,17991,7.2,19654,235,54,1828,1410,23.5,1799.1
4524838137,1,16,0,0,10,8,9,0,0,0,0,18033,7.2,18634,201,52,1324,1692,20.1,1803.3,13,3,1,8,10,8,1,0,1,0,16709,6.8,16942,185,56,-1324,-1692,18.5,1670.9
4519211105,0,123,2,0,1,7,1,0,0,0,0,14415,6.8,17028,238,47,-2534,-3031,23.8,1441.5,23,3,1,7,1,7,0,0,0,0,16949,7.4,20059,233,60,2534,3031,23.3,1694.9
4522449120,1,40,3,0,7,6,7,0,0,0,0,16359,7.0,17998,198,41,540,867,19.8,1635.9,16,2,1,6,7,7,0,0,0,0,15819,6.6,17131,187,52,-540,-867,18.7,1581.9
4493407357,1,78,4,1,9,3,10,0,0,0,0,17983,7.0,18340,230,52,4009,1935,23.0,1798.3,18,0,0,3,9,1,1,0,1,0,13974,6.6,16405,183,49,-4009,-1935,18.3,1397.4
4516779664,1,16,1,0,7,2,10,0,0,0,0,17198,7.4,19868,233,62,1926,2119,23.3,1719.8,51,1,1,2,7,2,0,0,0,0,15272,6.8,17749,219,73,-1926,-2119,21.9,1527.2
4524898336,1,10,2,1,9,4,10,1,0,1,0,17791,7.2,19229,219,48,2095,1876,21.9,1779.1,13,0,0,4,9,8,1,1,0,0,15696,7.0,17353,214,62,-2095,-1876,21.4,1569.6
4502917237,0,13,2,1,12,5,11,0,0,0,0,18982,7.0,18664,234,48,2741,2415,23.4,1898.2,14,1,0,5,12,5,0,0,0,0,16241,6.6,16249,205,48,-2741,-2415,20.5,1624.1
4482404724,1,18,1,0,7,4,6,0,0,0,0,17049,6.8,17357,221,36,799,440,22.1,1704.9,20,2,1,4,7,3,1,0,1,0,16250,6.6,16917,215,48,-799,-440,21.5,1625.0
4523898357,1,16,3,1,4,3,5,1,1,0,0,15391,7.0,17937,191,64,46,970,19.1,1539.1,17,4,0,3,4,2,0,0,0,0,15345,6.8,16967,236,52,-46,-970,23.6,1534.5
4434566709,1,15,5,1,7,1,10,0,0,0,0,17558,7.2,19554,251,51,2704,1740,25.1,1755.8,16,2,0,1,7,1,1,1,0,0,14854,6.6,17814,224,72,-2704,-1740,22.4,1485.4
4502814468,0,13,1,1,5,6,6,0,0,0,0,16157,7.0,17878,221,51,142,1215,22.1,1615.7,115,2,0,6,5,6,1,1,0,0,16015,6.8,16663,199,41,-142,-1215,19.9,1601.5
4525226714,1,15,5,1,10,5,10,1,1,0,0,18650,7.2,18563,236,44,3028,1818,23.6,1865.0,17,2,0,5,10,4,0,0,0,0,15622,6.8,16745,216,36,-3028,-1818,21.6,1562.2
4524708254,1,16,5,1,8,5,16,2,1,1,0,16693,6.4,16725,187,32,2123,1219,18.7,1669.3,14,3,0,5,8,1,0,0,0,0,14570,6.2,15506,172,51,-2123,-1219,17.2,1457.0
4476153650,0,52,7,0,6,5,11,1,1,0,0,15975,6.6,16937,197,46,-166,-337,19.7,1597.5,19,4,1,5,6,4,0,0,0,0,16141,6.8,17274,231,39,166,337,23.1,1614.1
4526108162,1,18,6,0,6,4,7,0,0,0,0,16827,7.0,18478,252,44,2091,2537,25.2,1682.7,19,3,1,4,6,5,1,1,0,0,14736,6.4,15941,201,37,-2091,-2537,20.1,1473.6
4522510473,0,138,4,0,6,4,8,0,0,0,0,15096,6.2,15415,199,32,-120,-1620,19.9,1509.6,15,3,1,4,6,2,1,1,0,0,15216,6.4,17035,193,67,120,1620,19.3,1521.6
4471738335,0,18,4,1,11,5,12,1,0,1,0,18658,7.0,19117,203,44,1603,1389,20.3,1865.8,14,1,0,5,11,6,0,0,0,0,17055,6.8,17728,229,51,-1603,-1389,22.9,1705.5
4489783029,1,14,4,1,8,9,9,0,0,0,0,17273,7.0,18297,208,56,381,1571,20.8,1727.3,15,2,0,9,8,9,0,0,0,0,16892,6.8,16726,181,40,-381,-1571,18.1,1689.2
4507977385,0,10,1,0,1,8,1,0,0,0,0,13305,6.2,15657,196,50,-4849,-4463,19.6,1330.5,13,2,1,8,1,9,2,1,1,0,18154,7.4,20120,276,65,4849,4463,27.6,1815.4
4508126209,1,10,4,0,7,4,4,1,0,1,1,17440,7.0,18208,197,55,2367,1946,19.7,1744.0,17,3,1,4,7,3,1,1,0,0,15073,6.6,16262,178,63,-2367,-1946,17.8,1507.3
4522111374,0,17,5,1,5,12,6,0,0,0,0,14656,6.4,15475,186,36,-4201,-4782,18.6,1465.6,20,5,0,12,5,11,1,1,0,0,18857,7.4,20257,216,44,4201,4782,21.6,1885.7
4517787854,1,15,4,0,5,5,6,0,0,0,0,15988,6.8,17843,215,43,-779,-1837,21.5,1598.8,29,3,1,5,5,3,0,0,0,0,16767,7.4,19680,235,71,779,1837,23.5,1676.7
4492253992,0,15,3,0,4,11,5,0,0,0,0,14606,6.4,16104,173,59,-4405,-3304,17.3,1460.6,57,3,1,11,4,16,1,1,0,0,19011,7.2,19408,193,63,4405,3304,19.3,1901.1
4458767529,1,21,0,0,8,8,6,2,1,1,0,17889,7.2,19337,235,60,1792,1300,23.5,1788.9,11,4,1,8,8,7,0,0,0,0,16097,7.0,18037,180,48,-1792,-1300,18.0,1609.7
4527797466,1,54,0,0,6,4,8,1,1,0,0,16238,7.2,19255,233,48,782,888,23.3,1623.8,12,21,1,4,6,3,0,0,0,0,15456,7.0,18367,206,56,-782,-888,20.6,1545.6
4515426111,1,15,3,1,12,1,11,2,1,1,0,18574,7.2,19415,227,56,5586,4058,22.7,1857.4,17,3,0,1,12,1,0,0,0,0,12988,6.4,15357,187,32,-5586,-4058,18.7,1298.8
4444096628,0,32,2,0,10,12,9,0,0,0,0,16174,6.6,16725,149,39,-2452,-1634,14.9,1617.4,14,0,1,12,10,8,0,0,0,0,18626,7.0,18359,210,35,2452,1634,21.0,1862.6
4499863965,1,11,2,0,8,10,8,0,0,0,0,16748,6.8,16907,178,44,-1579,-1715,17.8,1674.8,17,3,1,10,8,8,1,1,0,0,18327,7.2,18622,215,66,1579,1715,21.5,1832.7
4477885741,0,14,2,1,9,9,11,1,1,0,0,16848,6.6,16664,200,35,-973,-2691,20.0,1684.8,17,2,0,9,9,12,0,0,0,0,17821,7.0,19355,214,54,973,2691,21.4,1782.1
4515730845,0,18,2,1,6,4,5,0,0,0,0,15895,6.8,17705,225,48,-1018,-1531,22.5,1589.5,15,3,0,4,6,6,1,1,0,0,16913,7.4,19236,232,80,1018,1531,23.2,1691.3
4454798967,0,15,0,0,3,11,4,1,1,0,0,14434,6.6,16488,181,60,-6972,-3956,18.1,1443.4,12,2,1,11,3,10,1,0,1,1,21406,7.6,20444,240,51,6972,3956,24.0,2140.6
4502105412,1,23,1,0,9,4,9,2,1,1,0,18264,7.4,20134,234,75,2188,2716,23.4,1826.4,10,1,1,4,9,5,0,0,0,0,16076,6.8,17418,227,60,-2188,-2716,22.7,1607.6
4505214335,0,12,3,1,4,7,4,0,0,0,0,15580,6.8,17701,205,52,-731,-118,20.5,1558.0,14,0,0,7,4,6,2,1,1,0,16311,6.8,17819,229,54,731,118,22.9,1631.1
4524026578,0,14,1,0,4,5,4,0,0,0,0,15482,7.2,18715,237,47,-1335,-172,23.7,1548.2,39,2,1,5,4,5,2,1,1,0,16817,7.2,18887,228,55,1335,172,22.8,1681.7
4523838498,1,14,1,0,4,8,4,2,1,1,0,14312,6.6,16196,144,57,-2861,-2348,14.4,1431.2,55,3,1,8,4,12,0,0,0,0,17173,7.2,18544,217,56,2861,2348,21.7,1717.3
4419877547,0,49,4,1,6,7,10,1,1,0,1,17035,6.6,16379,187,40,1385,-827,18.7,1703.5,191,4,0,7,6,6,1,0,1,0,15650,6.6,17206,179,59,-1385,827,17.9,1565.0
4520985239,0,53,3,1,5,12,6,1,1,0,0,15555,6.6,17008,222,41,-3638,-3337,22.2,1555.5,15,4,0,12,5,13,0,0,0,0,19193,7.6,20345,227,56,3638,3337,22.7,1919.3
4518870205,1,16,1,1,12,6,12,0,0,0,0,18688,7.0,18316,199,40,2936,1143,19.9,1868.8,16,0,0,6,12,7,2,1,1,0,15752,6.8,17173,207,64,-2936,-1143,20.7,1575.2
4527420354,1,18,1,1,8,5,8,1,0,1,1,19558,7.6,20155,223,64,3438,2418,22.3,1955.8,50,4,0,5,8,4,1,1,0,0,16120,6.8,17737,197,60,-3438,-2418,19.7,1612.0
4501004124,1,18,2,1,8,2,9,1,0,1,1,18188,7.0,18675,208,49,3263,1440,20.8,1818.8,16,3,0,2,8,2,1,1,0,0,14925,6.8,17235,200,68,-3263,-1440,20.0,1492.5
4462810763,0,15,6,0,8,5,12,2,1,1,0,17839,7.0,18405,217,52,1339,1176,21.7,1783.9,41,0,1,5,8,5,0,0,0,0,16500,6.6,17229,212,44,-1339,-1176,21.2,1650.0
4522617067,0,39,1,0,7,14,5,0,0,0,0,16190,6.6,16496,207,34,-2302,-997,20.7,1619.0,17,5,1,14,7,16,0,0,0,0,18492,6.6,17493,173,52,2302,997,17.3,1849.2
4497670644,1,38,2,0,7,8,8,0,0,0,0,16308,7.2,17911,199,48,-1464,-1575,19.9,1630.8,15,3,1,8,7,3,0,0,0,0,17772,7.4,19486,250,48,1464,1575,25.0,1777.2
4422002181,0,28,1,1,10,4,13,0,0,0,0,18858,7.0,18627,195,77,2674,1630,19.5,1885.8,13,2,0,4,10,4,0,0,0,0,16184,6.4,16997,240,52,-2674,-1630,24.0,1618.4
4512964599,0,17,3,1,7,7,8,1,0,1,0,16288,6.8,17321,193,68,-1222,-2334,19.3,1628.8,14,2,0,7,7,9,1,1,0,0,17510,7.2,19655,221,56,1222,2334,22.1,1751.0
4523850579,0,18,2,1,3,2,1,0,0,0,0,15097,7.2,18396,218,65,-429,55,21.8,1509.7,12,1,0,2,3,1,2,1,1,0,15526,7.2,18341,244,64,429,-55,24.4,1552.6
4519124601,0,17,3,1,4,4,3,1,1,0,0,15842,7.0,18640,240,60,71,409,24.0,1584.2,17,5,0,4,4,6,0,0,0,0,15771,7.0,18231,227,48,-71,-409,22.7,1577.1
4525110987,1,14,5,1,10,7,8,1,1,0,0,18302,7.2,19223,237,47,851,709,23.7,1830.2,16,3,0,7,10,8,0,0,0,0,17451,7.0,18514,251,51,-851,-709,25.1,1745.1
4476138095,1,51,3,0,4,6,7,0,0,0,0,15766,6.8,16923,213,47,-856,-642,21.3,1576.6,16,3,1,6,4,6,1,1,0,0,16622,6.6,17565,239,58,856,642,23.9,1662.2
4526047825,1,68,4,1,8,6,10,1,1,0,0,16912,6.8,17195,205,52,1051,797,20.5,1691.2,17,0,0,6,8,8,0,0,0,0,15861,6.6,16398,212,36,-1051,-797,21.2,1586.1
4508363234,0,14,3,1,4,8,4,1,1,0,0,16250,6.8,17320,236,49,-1497,-1252,23.6,1625.0,17,3,0,8,4,13,0,0,0,0,17747,7.2,18572,225,64,1497,1252,22.5,1774.7
4456581816,1,12,2,1,6,5,3,0,0,0,0,16059,7.2,18356,212,59,584,1023,21.2,1605.9,19,2,0,5,6,8,0,0,0,0,15475,6.8,17333,207,36,-584,-1023,20.7,1547.5
4518135056,0,16,5,0,4,11,2,2,1,1,0,14285,6.6,16387,182,52,-4177,-1640,18.2,1428.5,17,4,1,11,4,21,0,0,0,0,18462,7.0,18027,209,45,4177,1640,20.9,1846.2
4526851644,1,56,1,0,12,4,13,0,0,0,0,18119,7.0,18951,198,48,4108,2927,19.8,1811.9,10,1,1,4,12,1,1,1,0,0,14011,6.4,16024,179,51,-4108,-2927,17.9,1401.1
4477398725,1,16,3,1,9,8,12,0,0,0,0,17121,6.6,16462,212,36,217,434,21.2,1712.1,16,1,0,8,9,9,1,0,1,0,16904,6.4,16028,173,35,-217,-434,17.3,1690.4
4526067873,1,18,1,0,4,9,3,0,0,0,0,15162,6.8,17438,220,44,-3051,-2198,22.0,1516.2,48,2,1,9,4,8,2,1,1,0,18213,7.4,19636,250,53,3051,2198,25.0,1821.3
4516772132,0,16,2,1,2,5,1,1,0,1,1,15951,7.0,18136,236,42,-675,-1212,23.6,1595.1,17,3,0,5,2,6,0,0,0,0,16626,7.2,19348,234,60,675,1212,23.4,1662.6
4435256740,0,14,5,1,7,4,5,1,1,0,0,17030,7.2,19832,250,49,1207,1638,25.0,1703.0,39,3,0,4,7,8,0,0,0,0,15823,7.0,18194,234,46,-1207,-1638,23.4,1582.3
4526158709,0,16,1,0,7,3,6,1,1,0,0,16981,7.2,19169,232,50,1621,1793,23.2,1698.1,13,1,1,3,7,4,0,0,0,0,15360,6.8,17376,236,47,-1621,-1793,23.6,1536.0
4447452177,0,14,4,1,3,3,1,0,0,0,0,14486,7.0,18218,200,63,-648,728,20.0,1448.6,19,3,0,3,3,3,1,1,0,0,15134,7.0,17490,208,56,648,-728,20.8,1513.4
4519595865,0,16,5,0,3,8,4,1,0,1,0,14506,6.8,16989,206,52,-2520,-1932,20.6,1450.6,16,1,1,8,3,7,1,1,0,0,17026,7.2,18921,221,56,2520,1932,22.1,1702.6
4512225381,1,15,3,1,6,7,4,2,1,1,0,15977,6.8,17653,198,60,-1397,-1549,19.8,1597.7,18,5,0,7,6,6,0,0,0,0,17374,7.2,19202,230,62,1397,1549,23.0,1737.4
4496882538,0,13,1,0,2,11,2,0,0,0,0,14910,6.8,16907,227,56,-2917,-2806,22.7,1491.0,17,0,1,11,2,4,2,1,1,0,17827,7.0,19713,216,53,2917,2806,21.6,1782.7
4451011365,1,17,1,0,8,4,7,1,1,0,0,17127,6.8,18148,201,48,2294,1383,20.1,1712.7,15,2,1,4,8,2,0,0,0,0,14833,6.4,16765,183,67,-2294,-1383,18.3,1483.3
4525245077,1,24,4,1,10,7,11,2,1,1,0,18256,7.0,18201,186,58,1489,-192,18.6,1825.6,17,3,0,7,10,7,0,0,0,0,16767,7.0,18393,247,28,-1489,192,24.7,1676.7
4502562701,1,16,2,1,8,7,6,2,1,1,0,17867,7.2,19316,226,76,764,2490,22.6,1786.7,16,3,0,7,8,6,0,0,0,0,17103,6.6,16826,178,59,-764,-2490,17.8,1710.3
4502224154,0,16,1,0,4,3,5,1,0,1,0,15804,7.2,18509,228,68,606,820,22.8,1580.4,11,0,1,3,4,5,1,1,0,0,15198,6.8,17689,210,60,-606,-820,21.0,1519.8
4520700256,0,17,1,0,4,7,3,0,0,0,0,15504,7.0,17911,222,47,-1471,-1204,22.2,1550.4,15,6,1,7,4,10,1,1,0,0,16975,7.0,19115,214,50,1471,1204,21.4,1697.5
4524735926,0,16,1,0,2,6,0,0,0,0,0,13744,6.8,16719,207,47,-2438,-1929,20.7,1374.4,38,0,1,6,2,5,0,0,0,0,16182,6.8,18648,241,32,2438,1929,24.1,1618.2
4513351199,0,16,4,0,5,8,3,1,1,0,0,15307,6.8,17610,227,56,-2576,-2182,22.7,1530.7,16,3,1,8,5,5,0,0,0,0,17883,7.4,19792,249,56,2576,2182,24.9,1788.3
4519801172,0,16,2,1,3,16,5,0,0,0,0,14316,6.2,14965,195,44,-5219,-4005,19.5,1431.6,14,4,0,16,3,23,1,1,0,0,19535,7.2,18970,183,48,5219,4005,18.3,1953.5
4525231930,0,16,3,1,2,4,2,0,0,0,0,14584,6.6,16647,235,47,-542,-927,23.5,1458.4,14,1,0,4,2,5,0,0,0,0,15126,6.8,17574,211,52,542,927,21.1,1512.6
4508113644,0,39,2,1,7,15,13,0,0,0,0,17181,7.0,18481,184,47,-2692,-1609,18.4,1718.1,55,3,0,15,7,20,1,1,0,0,19873,7.4,20090,191,34,2692,1609,19.1,1987.3
4518113467,0,8,1,0,6,8,5,0,0,0,0,16373,7.2,18479,221,40,-2027,-114,22.1,1637.3,15,1,1,8,6,9,2,1,1,0,18400,7.0,18593,235,36,2027,114,23.5,1840.0
4523908586,1,14,0,0,11,5,9,1,1,0,0,18604,7.4,20075,214,53,2998,3108,21.4,1860.4,14,3,1,5,11,4,0,0,0,0,15606,7.0,16967,203,42,-2998,-3108,20.3,1560.6
4523885762,1,15,0,1,7,5,5,0,0,0,0,16801,7.4,18747,203,64,575,706,20.3,1680.1,15,3,0,5,7,7,1,1,0,0,16226,7.0,18041,214,48,-575,-706,21.4,1622.6
4513532582,1,17,5,1,7,6,8,1,1,0,0,16846,6.8,17698,246,39,-1705,-1679,24.6,1684.6,12,3,0,6,7,5,1,0,1,2,18551,7.2,19377,240,59,1705,1679,24.0,1855.1
4517834101,0,15,2,1,4,12,1,0,0,0,0,15089,6.6,17098,235,53,-5292,-4004,23.5,1508.9,14,4,0,12,4,14,1,1,0,1,20381,7.6,21102,234,63,5292,4004,23.4,2038.1
4508197919,1,11,1,1,7,7,5,0,0,0,0,17024,7.2,19375,222,68,197,1883,22.2,1702.4,91,2,0,7,7,7,2,1,1,0,16827,7.0,17492,198,63,-197,-1883,19.8,1682.7
4521657785,0,21,4,1,10,6,8,1,1,0,0,17561,6.8,18172,203,56,287,568,20.3,1756.1,17,4,0,6,10,4,0,0,0,0,17274,6.6,17604,228,41,-287,-568,22.8,1727.4
4524419928,1,14,1,1,3,4,4,2,1,1,0,15612,7.0,18702,214,72,-1011,-309,21.4,1561.2,18,2,0,4,3,6,0,0,0,0,16623,7.2,19011,239,65,1011,309,23.9,1662.3
4520601060,0,77,2,0,7,15,6,0,0,0,0,16523,7.0,17836,219,38,-2692,-2753,21.9,1652.3,15,2,1,15,7,12,1,1,0,0,19215,7.6,20589,176,61,2692,2753,17.6,1921.5
4525989643,1,17,5,0,7,5,7,0,0,0,0,16622,7.4,18996,206,60,753,2050,20.6,1662.2,17,2,1,5,7,6,1,1,0,0,15869,6.6,16946,213,49,-753,-2050,21.3,1586.9
4484657293,1,21,4,1,8,4,11,1,1,0,0,18382,7.0,19220,224,68,2498,1487,22.4,1838.2,15,5,0,4,8,5,0,0,0,0,15884,7.0,17733,217,52,-2498,-1487,21.7,1588.4
4518028905,0,16,2,1,8,9,5,0,0,0,0,16560,6.8,17640,200,47,-1611,-1380,20.0,1656.0,19,4,0,9,8,9,1,1,0,0,18171,7.2,19020,209,56,1611,1380,20.9,1817.1
4488755815,0,14,5,1,9,8,11,1,1,0,0,16940,7.0,18041,191,40,-896,-393,19.1,1694.0,19,3,0,8,9,8,0,0,0,0,17836,7.0,18434,235,45,896,393,23.5,1783.6
4523723534,1,18,11,1,7,6,8,0,0,0,1,18053,6.6,16741,207,46,3464,994,20.7,1805.3,41,1,0,6,7,6,0,0,0,0,14589,6.4,15747,178,22,-3464,-994,17.8,1458.9
4523651481,1,20,4,0,9,10,9,1,1,0,0,17421,6.6,17407,203,40,-120,-394,20.3,1742.1,16,4,1,10,9,11,0,0,0,0,17541,6.8,17801,225,32,120,394,22.5,1754.1
4511873331,1,41,1,1,7,4,7,1,1,0,0,17070,7.2,18583,223,47,1451,1441,22.3,1707.0,12,1,0,4,7,4,0,0,0,0,15619,6.8,17142,199,56,-1451,-1441,19.9,1561.9
4514796338,0,16,1,0,2,6,3,0,0,0,0,15509,7.0,18064,235,58,-1098,-966,23.5,1550.9,138,3,1,6,2,4,2,1,1,0,16607,7.2,19030,204,68,1098,966,20.4,1660.7
4527808251,0,38,2,0,3,2,4,0,0,0,0,15249,7.2,19121,240,45,-162,1520,24.0,1524.9,17,4,1,2,3,3,2,1,1,0,15411,6.8,17601,248,40,162,-1520,24.8,1541.1
4485983759,1,39,2,1,11,8,16,0,0,0,0,17860,6.8,17606,172,48,1240,-349,17.2,1786.0,14,2,0,8,11,6,1,0,1,0,16620,6.8,17955,202,51,-1240,349,20.2,1662.0
4519643155,0,14,1,0,7,11,6,0,0,0,0,16548,6.8,17735,224,51,-2133,-256,22.4,1654.8,16,1,1,11,7,19,1,1,0,0,18681,7.0,17991,215,63,2133,256,21.5,1868.1
4510137231,0,15,1,1,1,0,0,1,0,1,0,14712,7.0,17631,253,62,-132,-1473,25.3,1471.2,12,2,0,0,1,0,1,1,0,0,14844,7.0,19104,264,68,132,1473,26.4,1484.4
4450387625,1,14,2,0,5,8,4,0,0,0,0,15710,7.0,17847,223,45,-2320,-2276,22.3,1571.0,14,4,1,8,5,7,1,1,0,0,18030,7.6,20123,237,68,2320,2276,23.7,1803.0
4525232628,1,16,5,1,4,2,4,1,0,1,0,16470,7.2,19232,232,59,1718,2947,23.2,1647.0,14,2,0,2,4,3,1,1,0,0,14752,6.6,16285,218,48,-1718,-2947,21.8,1475.2
4504056822,1,18,0,1,9,7,11,1,1,0,0,17622,7.2,17879,192,52,173,41,19.2,1762.2,17,2,0,7,9,7,0,0,0,0,17449,6.8,17838,227,44,-173,-41,22.7,1744.9
4521675950,1,14,2,0,10,4,9,1,1,0,0,18779,7.2,19556,252,47,3679,2110,25.2,1877.9,60,0,1,4,10,3,0,0,0,0,15100,6.6,17446,203,56,-3679,-2110,20.3,1510.0
4498640810,0,18,2,0,3,5,4,0,0,0,0,14827,7.0,17341,201,41,-1838,-1584,20.1,1482.7,37,2,1,5,3,4,1,1,0,0,16665,7.0,18925,230,67,1838,1584,23.0,1666.5
4480448606,1,15,3,0,10,7,8,1,0,1,0,19289,7.6,19633,240,63,2330,2319,24.0,1928.9,52,2,1,7,10,9,0,0,0,0,16959,7.0,17314,200,39,-2330,-2319,20.0,1695.9
4509478131,0,16,6,0,5,5,8,0,0,0,0,16930,7.2,18587,237,52,928,-633,23.7,1693.0,20,4,1,5,5,3,1,1,0,0,16002,7.2,19220,241,56,-928,633,24.1,1600.2
4484453587,1,15,1,0,4,5,4,0,0,0,0,15161,7.0,17998,194,72,-786,-837,19.4,1516.1,16,2,1,5,4,3,1,1,0,0,15947,7.2,18835,231,55,786,837,23.1,1594.7
4522611565,1,41,4,1,14,3,15,0,0,0,1,20030,7.2,18878,205,58,5872,4455,20.5,2003.0,37,4,0,3,14,5,0,0,0,0,14158,6.0,14423,171,34,-5872,-4455,17.1,1415.8
4526878026,0,19,3,1,5,8,2,0,0,0,0,15429,6.6,16825,227,48,-1480,-1366,22.7,1542.9,53,1,0,8,5,10,0,0,0,0,16909,6.8,18191,218,42,1480,1366,21.8,1690.9
4521447846,0,12,3,0,3,6,5,0,0,0,0,14455,6.6,16461,199,48,-2471,-2179,19.9,1445.5,16,0,1,6,3,4,1,1,0,0,16926,6.8,18640,249,48,2471,2179,24.9,1692.6
4475009487,1,13,7,1,8,1,12,0,0,0,0,18810,7.0,19127,261,42,5189,2522,26.1,1881.0,22,1,0,1,8,1,1,1,0,0,13621,6.6,16605,194,53,-5189,-2522,19.4,1362.1
4507871318,1,18,5,0,11,7,14,0,0,0,0,18793,7.0,18395,217,37,3026,3357,21.7,1879.3,20,2,1,7,11,8,1,1,0,0,15767,6.4,15038,174,37,-3026,-3357,17.4,1576.7
4524787748,0,18,1,0,5,7,9,0,0,0,0,16566,7.2,18441,216,44,-418,-611,21.6,1656.6,14,3,1,7,5,4,1,1,0,0,16984,7.2,19052,208,58,418,611,20.8,1698.4
4448433475,0,10,4,0,10,5,12,1,0,1,0,18545,7.2,19051,200,64,2621,2001,20.0,1854.5,12,3,1,5,10,5,1,1,0,0,15924,6.8,17050,206,35,-2621,-2001,20.6,1592.4
4469155463,0,83,3,0,4,11,3,1,1,0,0,15564,6.8,17844,236,55,-4523,-3174,23.6,1556.4,16,5,1,11,4,9,1,0,1,1,20087,7.6,21018,231,52,4523,3174,23.1,2008.7
4499865404,0,14,4,1,3,9,2,0,0,0,0,13893,6.4,15277,171,40,-4054,-3806,17.1,1389.3,18,3,0,9,3,11,2,1,1,0,17947,7.0,19083,218,80,4054,3806,21.8,1794.7
4456427042,0,14,1,0,1,10,0,0,0,0,0,14401,6.8,17502,212,75,-3441,-1825,21.2,1440.1,13,4,1,10,1,10,1,1,0,0,17842,7.2,19327,229,54,3441,1825,22.9,1784.2
4434774244,1,34,2,1,10,10,7,0,0,0,0,17838,7.0,18262,230,39,-482,668,23.0,1783.8,21,4,0,10,10,16,1,0,1,0,18320,6.8,17594,202,40,482,-668,20.2,1832.0
4491563778,1,68,19,1,9,3,9,1,1,0,0,17913,7.0,19123,249,56,2185,1440,24.9,1791.3,36,2,0,3,9,5,0,0,0,0,15728,6.6,17683,231,48,-2185,-1440,23.1,1572.8
4495155088,1,16,2,1,11,7,6,1,0,1,0,18504,7.2,19037,212,61,2842,1125,21.2,1850.4,17,1,0,7,11,3,1,1,0,0,15662,7.0,17912,192,40,-2842,-1125,19.2,1566.2
4524784360,0,14,2,1,7,6,2,1,0,1,0,16756,7.0,18790,239,52,773,1285,23.9,1675.6,18,0,0,6,7,6,1,1,0,0,15983,6.8,17505,190,44,-773,-1285,19.0,1598.3
4463063111,1,38,7,0,2,2,1,0,0,0,0,15782,6.8,18460,253,66,1344,1195,25.3,1578.2,62,2,1,2,2,1,0,0,0,0,14438,6.8,17265,236,52,-1344,-1195,23.6,1443.8
4524469798,1,46,3,0,8,6,14,0,0,0,0,16898,7.2,18746,213,48,734,1966,21.3,1689.8,13,1,1,6,8,9,0,0,0,0,16164,6.4,16780,209,44,-734,-1966,20.9,1616.4
4490286186,0,17,1,1,10,7,13,1,1,0,0,17545,6.8,17316,179,55,-280,-752,17.9,1754.5,39,3,0,7,10,9,0,0,0,0,17825,6.8,18068,217,61,280,752,21.7,1782.5
4520913464,1,15,1,0,6,3,10,2,1,1,0,17377,7.2,19245,247,68,2101,1596,24.7,1737.7,75,2,1,3,6,5,0,0,0,0,15276,6.8,17649,193,59,-2101,-1596,19.3,1527.6
4450075643,1,18,3,0,2,8,2,0,0,0,0,14868,6.6,17584,224,53,-1146,-441,22.4,1486.8,20,2,1,8,2,4,0,0,0,0,16014,6.8,18025,162,44,1146,441,16.2,1601.4
4526530551,0,14,3,0,3,7,2,1,1,0,0,14344,6.6,16049,193,63,-4269,-3208,19.3,1434.4,17,4,1,7,3,5,0,0,0,1,18613,7.2,19257,232,63,4269,3208,23.2,1861.3
4521632653,1,10,4,0,9,5,12,1,1,0,0,17881,7.2,19236,238,43,1867,1838,23.8,1788.1,15,1,1,5,9,4,0,0,0,0,16014,6.6,17398,205,72,-1867,-1838,20.5,1601.4
4512610035,0,14,3,0,4,9,3,1,1,0,0,15533,7.0,18431,214,56,-3728,-2079,21.4,1553.3,16,4,1,9,4,8,0,0,0,0,19261,7.4,20510,259,65,3728,2079,25.9,1926.1
4522413426,1,15,0,1,4,2,5,0,0,0,0,16729,7.0,18725,227,48,1970,804,22.7,1672.9,16,1,0,2,4,2,0,0,0,0,14759,6.8,17921,228,73,-1970,-804,22.8,1475.9
4526627727,0,15,3,1,7,4,5,0,0,0,0,16477,7.2,18750,198,56,435,564,19.8,1647.7,14,3,0,4,7,2,1,1,0,0,16042,7.0,18186,258,64,-435,-564,25.8,1604.2
4527509662,1,17,2,1,7,2,8,1,1,0,0,17359,7.0,18203,219,65,3098,1882,21.9,1735.9,14,2,0,2,7,1,1,0,1,0,14261,6.4,16321,213,36,-3098,-1882,21.3,1426.1
4511665743,0,17,2,1,3,1,4,0,0,0,0,15615,6.8,18309,237,51,1471,187,23.7,1561.5,17,4,0,1,3,1,0,0,0,0,14144,6.8,18122,187,56,-1471,-187,18.7,1414.4
4518298214,0,16,2,1,12,13,14,0,0,0,0,18002,6.8,17743,178,43,-2340,-2351,17.8,1800.2,15,3,0,13,12,16,1,1,0,0,20342,7.6,20094,220,65,2340,2351,22.0,2034.2
4513296264,1,18,6,1,9,6,12,2,1,1,0,17320,6.8,17894,215,52,689,-913,21.5,1732.0,21,5,0,6,9,6,0,0,0,0,16631,7.2,18807,226,53,-689,913,22.6,1663.1
4513554113,0,16,2,0,0,7,0,0,0,0,0,12774,6.6,15643,199,44,-4538,-2876,19.9,1277.4,23,3,1,7,0,13,1,1,0,0,17312,6.8,18519,250,57,4538,2876,25.0,1731.2
4500167662,0,17,0,0,6,7,7,2,1,1,0,15924,6.8,16695,184,64,-903,-729,18.4,1592.4,12,1,1,7,6,8,0,0,0,0,16827,7.0,17424,215,29,903,729,21.5,1682.7
4524179867,0,11,5,0,6,12,8,0,0,0,0,15211,6.4,16421,187,47,-3746,-3014,18.7,1521.1,20,3,1,12,6,18,1,1,0,0,18957,7.2,19435,230,56,3746,3014,23.0,1895.7
4522178683,0,33,0,0,2,10,2,0,0,0,0,13555,6.0,13939,150,48,-6373,-5156,15.0,1355.5,20,1,1,10,2,9,2,1,1,1,19928,7.2,19095,242,56,6373,5156,24.2,1992.8
4527434998,0,16,3,0,7,5,9,0,0,0,0,16388,6.8,16720,212,24,-1182,-2730,21.2,1638.8,31,4,1,5,7,5,1,1,0,0,17570,7.0,19450,229,74,1182,2730,22.9,1757.0
4489642674,1,38,4,1,6,5,6,1,1,0,0,16098,6.8,18103,209,50,-282,-192,20.9,1609.8,16,4,0,5,6,5,1,0,1,0,16380,7.0,18295,224,62,282,192,22.4,1638.0
4523347414,1,14,4,0,8,7,17,0,0,0,0,16860,6.2,15585,183,44,-91,-2362,18.3,1686.0,18,2,1,7,8,7,0,0,0,0,16951,6.8,17947,204,48,91,2362,20.4,1695.1
4489477420,1,29,2,1,11,2,12,2,1,1,1,20124,7.4,19495,230,65,6450,5057,23.0,2012.4,13,4,0,2,11,2,0,0,0,0,13674,6.0,14438,205,24,-6450,-5057,20.5,1367.4
4507950009,0,17,3,0,4,7,4,1,0,1,0,15293,6.8,17145,192,64,-1809,-1431,19.2,1529.3,41,2,1,7,4,11,1,1,0,0,17102,7.0,18576,215,52,1809,1431,21.5,1710.2
4522456399,0,17,4,1,10,8,17,1,0,1,0,18432,7.0,17701,203,53,1517,-69,20.3,1843.2,13,2,0,8,10,16,1,1,0,0,16915,6.8,17770,193,52,-1517,69,19.3,1691.5
4525383403,0,12,1,1,2,13,1,0,0,0,0,14218,6.2,15368,200,49,-4511,-4211,20.0,1421.8,17,3,0,13,2,18,1,1,0,0,18729,7.4,19579,213,44,4511,4211,21.3,1872.9
4492408398,1,38,0,1,2,3,2,0,0,0,0,15414,7.2,18476,232,68,-304,-1063,23.2,1541.4,11,1,0,3,2,1,1,1,0,0,15718,7.4,19539,237,67,304,1063,23.7,1571.8
4448198434,1,14,2,0,6,1,7,0,0,0,0,17666,7.2,20014,264,63,3749,3555,26.4,1766.6,16,4,1,1,6,1,0,0,0,0,13917,6.4,16459,214,47,-3749,-3555,21.4,1391.7
4487676643,1,15,2,1,6,4,4,0,0,0,0,16792,7.2,18901,238,52,1852,2113,23.8,1679.2,20,1,0,4,6,5,0,0,0,0,14940,6.6,16788,218,40,-1852,-2113,21.8,1494.0
4525105080,1,19,4,1,16,4,21,0,0,0,0,19885,7.0,18684,177,33,5422,3259,17.7,1988.5,15,3,0,4,16,4,1,1,0,0,14463,6.4,15425,182,32,-5422,-3259,18.2,1446.3
4519161912,0,17,1,0,6,11,9,0,0,0,0,15536,6.4,15213,179,31,-4562,-3519,17.9,1553.6,20,5,1,11,6,14,2,1,1,1,20098,7.2,18732,226,51,4562,3519,22.6,2009.8
4520400316,1,18,2,0,5,4,6,1,1,0,0,16610,7.0,17963,263,40,828,-804,26.3,1661.0,101,4,1,4,5,3,0,0,0,0,15782,7.2,18767,243,64,-828,804,24.3,1578.2
4524969283,0,15,1,1,6,6,10,0,0,0,0,16260,6.8,17516,205,59,-402,-520,20.5,1626.0,18,2,0,6,6,7,1,0,1,0,16662,7.0,18036,219,51,402,520,21.9,1666.2
4520617571,0,15,3,1,8,7,8,2,1,1,0,16412,7.0,18381,212,44,151,840,21.2,1641.2,12,3,0,7,8,5,0,0,0,0,16261,7.0,17541,212,52,-151,-840,21.2,1626.1
4522642789,0,15,4,1,2,1,3,0,0,0,0,14969,6.8,16983,246,51,816,-457,24.6,1496.9,40,2,0,1,2,2,2,1,1,0,14153,6.8,17440,213,52,-816,457,21.3,1415.3
4492568558,1,17,1,1,10,4,11,0,0,0,0,17464,7.0,18187,217,35,1579,-171,21.7,1746.4,11,3,0,4,10,5,1,1,0,0,15885,6.8,18358,205,68,-1579,171,20.5,1588.5
4473936532,0,16,2,0,5,10,3,2,1,1,0,15526,6.8,17629,232,44,-2896,-2081,23.2,1552.6,15,2,1,10,5,6,0,0,0,0,18422,7.4,19710,236,76,2896,2081,23.6,1842.2
4449313153,0,14,0,0,2,10,2,0,0,0,0,13773,6.6,16568,192,50,-3660,-3282,19.2,1377.3,16,4,1,10,2,8,1,1,0,0,17433,7.6,19850,239,49,3660,3282,23.9,1743.3
4441609133,1,18,0,0,9,8,5,1,1,0,0,17232,7.0,17777,212,52,725,626,21.2,1723.2,73,4,1,8,9,7,0,0,0,0,16507,7.0,17151,191,47,-725,-626,19.1,1650.7
4488593539,1,13,7,0,8,5,7,1,1,0,0,17677,7.2,19493,233,66,1715,1973,23.3,1767.7,16,1,1,5,8,8,0,0,0,0,15962,7.2,17520,198,57,-1715,-1973,19.8,1596.2
4524583586,1,13,1,0,4,6,2,0,0,0,0,14687,6.6,16647,216,32,-2142,-1742,21.6,1468.7,17,1,1,6,4,5,1,1,0,0,16829,6.8,18389,223,75,2142,1742,22.3,1682.9
4512191595,0,37,3,1,6,8,4,2,1,1,0,16168,6.8,17184,204,36,-1003,-491,20.4,1616.8,21,1,0,8,6,7,0,0,0,0,17171,6.8,17675,220,59,1003,491,22.0,1717.1
4512324600,1,15,2,0,9,4,12,1,1,0,0,17233,6.8,17651,202,48,2034,884,20.2,1723.3,14,1,1,4,9,4,0,0,0,0,15199,6.6,16767,200,48,-2034,-884,20.0,1519.9
4527260532,1,18,5,0,10,6,17,0,0,0,0,16982,6.8,17597,187,46,1093,770,18.7,1698.2,18,1,1,6,10,4,0,0,0,0,15889,6.6,16827,222,44,-1093,-770,22.2,1588.9
4526377831,1,19,2,0,5,3,9,1,1,0,0,15634,6.8,16928,223,40,1149,1056,22.3,1563.4,15,3,1,3,5,5,0,0,0,0,14485,6.4,15872,208,48,-1149,-1056,20.8,1448.5
4527454309,0,60,2,1,10,7,7,2,1,1,0,18226,7.2,18871,211,53,1063,1153,21.1,1822.6,16,9,0,7,10,8,0,0,0,0,17163,7.0,17718,229,52,-1063,-1153,22.9,1716.3
4510837678,1,81,1,0,5,6,6,0,0,0,0,15719,6.8,17801,202,39,-1121,4,20.2,1571.9,16,4,1,6,5,5,0,0,0,0,16840,7.0,17797,236,48,1121,-4,23.6,1684.0
4522449879,0,16,3,1,6,7,8,0,0,0,0,16086,7.0,17888,199,48,-756,-831,19.9,1608.6,37,4,0,7,6,8,1,1,0,0,16842,7.2,18719,235,60,756,831,23.5,1684.2
4527526766,0,18,3,1,7,8,6,0,0,0,0,16132,7.0,17360,207,48,-1211,-2257,20.7,1613.2,35,2,0,8,7,9,1,0,1,0,17343,7.2,19617,244,52,1211,2257,24.4,1734.3
4470048867,1,15,2,1,7,0,4,2,1,1,0,17788,7.2,19185,256,67,4961,3591,25.6,1778.8,18,1,0,0,7,0,0,0,0,0,12827,6.2,15594,202,40,-4961,-3591,20.2,1282.7
4491660542,0,12,5,1,8,6,7,1,0,1,1,18211,7.2,19027,204,52,1479,-198,20.4,1821.1,11,1,0,6,8,6,1,1,0,0,16732,7.4,19225,217,56,-1479,198,21.7,1673.2
4448333307,0,14,3,1,3,10,4,0,0,0,0,14674,6.4,15727,184,48,-5092,-4196,18.4,1467.4,38,3,0,10,3,5,0,0,0,1,19766,7.4,19923,240,48,5092,4196,24.0,1976.6
4526856265,0,14,7,1,8,5,7,0,0,0,0,17113,7.4,18861,245,47,1176,1300,24.5,1711.3,18,4,0,5,8,6,1,1,0,0,15937,7.0,17561,225,52,-1176,-1300,22.5,1593.7
4443355005,1,39,3,1,5,5,4,2,1,1,0,14527,6.8,17128,195,45,-1063,63,19.5,1452.7,18,0,0,5,5,4,0,0,0,0,15590,6.8,17065,217,48,1063,-63,21.7,1559.0
4524768986,1,16,2,1,12,10,13,1,1,0,0,19622,7.0,18338,216,54,1997,-800,21.6,1962.2,16,2,0,10,12,8,0,0,0,0,17625,7.0,19138,211,56,-1997,800,21.1,1762.5
4517062497,0,17,0,0,5,8,2,0,0,0,0,15334,7.0,18085,204,63,-2564,-35,20.4,1533.4,101,3,1,8,5,12,0,0,0,0,17898,7.0,18120,227,44,2564,35,22.7,1789.8
4495054674,0,53,5,0,5,9,5,1,1,0,0,15535,6.8,17403,207,53,-4205,-1540,20.7,1553.5,20,4,1,9,5,10,0,0,0,1,19740,7.4,18943,251,44,4205,1540,25.1,1974.0
4523066845,0,40,1,0,8,4,10,0,0,0,0,16411,6.6,17513,176,43,590,1002,17.6,1641.1,16,5,1,4,8,4,0,0,0,0,15821,6.6,16511,208,47,-590,-1002,20.8,1582.1
4509810925,0,16,1,0,6,6,7,1,1,0,0,15703,6.8,16893,191,40,-951,-1116,19.1,1570.3,12,3,1,6,6,8,0,0,0,0,16654,7.2,18009,221,51,951,1116,22.1,1665.4
4456481303,1,31,2,0,11,13,11,0,0,0,0,18596,7.6,20017,198,68,520,941,19.8,1859.6,18,1,1,13,11,9,0,0,0,0,18076,7.2,19076,207,40,-520,-941,20.7,1807.6
4519543034,1,50,2,1,8,6,7,0,0,0,0,17628,7.0,18881,233,69,1458,1753,23.3,1762.8,17,0,0,6,8,5,1,1,0,0,16170,7.0,17128,196,66,-1458,-1753,19.6,1617.0
4509926355,0,16,1,0,5,9,4,1,0,1,0,15539,6.4,16163,163,50,-1337,-1246,16.3,1553.9,18,2,1,9,5,9,0,0,0,0,16876,7.0,17409,190,42,1337,1246,19.0,1687.6
4463020828,1,22,3,0,12,6,17,0,0,0,0,17875,6.8,17882,205,31,1880,1473,20.5,1787.5,15,1,1,6,12,3,0,0,0,0,15995,6.4,16409,190,57,-1880,-1473,19.0,1599.5
4484030443,0,13,0,0,5,13,3,0,0,0,0,14910,6.4,16295,198,40,-4644,-3580,19.8,1491.0,13,2,1,13,5,13,0,0,0,0,19554,7.4,19875,247,46,4644,3580,24.7,1955.4
4499297783,1,41,8,1,4,4,3,1,0,1,0,15868,6.8,18299,222,47,946,594,22.2,1586.8,19,5,0,4,4,4,1,1,0,0,14922,6.8,17705,213,44,-946,-594,21.3,1492.2
4497493695,0,18,4,0,8,5,8,1,0,1,0,17550,7.2,19690,218,68,1055,1659,21.8,1755.0,11,1,1,5,8,7,1,1,0,0,16495,7.2,18031,248,47,-1055,-1659,24.8,1649.5
4496489619,0,38,4,0,0,3,0,1,0,1,0,13793,6.8,17022,223,58,-2240,-1623,22.3,1379.3,14,2,1,3,0,1,1,1,0,0,16033,7.0,18645,247,59,2240,1623,24.7,1603.3
4464174645,0,17,2,0,8,10,2,0,0,0,0,16163,6.8,16956,201,32,-1825,-1174,20.1,1616.3,19,2,1,10,8,13,1,1,0,0,17988,7.2,18130,196,40,1825,1174,19.6,1798.8
4506183108,0,15,2,0,4,8,4,1,1,0,0,15290,6.6,17203,219,55,-2387,-2353,21.9,1529.0,17,3,1,8,4,6,0,0,0,0,17677,7.4,19556,242,48,2387,2353,24.2,1767.7
4500853153,0,18,0,0,5,11,4,0,0,0,0,15534,6.2,15681,209,43,-2840,-1360,20.9,1553.4,17,2,1,11,5,11,0,0,0,0,18374,7.0,17041,198,57,2840,1360,19.8,1837.4
4520775356,1,14,3,1,11,2,8,2,1,1,0,19354,7.2,20036,251,48,5462,3677,25.1,1935.4,15,0,0,2,11,2,0,0,0,0,13892,6.8,16359,192,51,-5462,-3677,19.2,1389.2
4518792896,0,13,1,1,7,8,6,0,0,0,0,15312,6.4,15636,167,45,-1352,-1180,16.7,1531.2,19,6,0,8,7,7,1,1,0,0,16664,6.4,16816,220,41,1352,1180,22.0,1666.4
4441657789,0,18,1,0,5,8,5,0,0,0,0,15770,6.4,16913,241,36,-2580,-3307,24.1,1577.0,16,1,1,8,5,6,1,0,1,0,18350,7.2,20220,224,79,2580,3307,22.4,1835.0
4505476136,1,16,2,0,11,4,13,0,0,0,0,19582,7.4,19381,228,44,4267,2764,22.8,1958.2,16,2,1,4,11,2,0,0,0,0,15315,6.6,16617,200,50,-4267,-2764,20.0,1531.5
4498209224,0,17,4,1,7,7,15,0,0,0,0,17045,7.0,17969,214,48,-883,-1495,21.4,1704.5,20,3,0,7,7,7,0,0,0,0,17928,7.2,19464,250,52,883,1495,25.0,1792.8
4526133153,0,13,14,0,6,9,4,1,0,1,0,15928,6.8,17865,206,45,-1938,-1993,20.6,1592.8,41,0,1,9,6,8,1,1,0,0,17866,7.2,19858,244,45,1938,1993,24.4,1786.6
4496874191,1,12,3,0,6,7,8,1,1,0,0,15900,6.8,17169,203,52,-689,-1431,20.3,1590.0,18,2,1,7,6,8,0,0,0,0,16589,7.2,18600,218,56,689,1431,21.8,1658.9
4462322651,1,12,6,0,2,6,2,2,1,1,0,15386,7.2,18832,246,60,-1402,-1003,24.6,1538.6,15,0,1,6,2,4,0,0,0,0,16788,7.6,19835,264,51,1402,1003,26.4,1678.8
4517636448,1,12,2,0,2,9,1,0,0,0,0,14259,6.4,16277,216,41,-4814,-3701,21.6,1425.9,18,1,1,9,2,14,2,1,1,1,19073,7.4,19978,240,52,4814,3701,24.0,1907.3
4522781547,0,15,14,0,1,2,1,1,1,0,0,14471,6.8,17810,241,55,-355,-400,24.1,1447.1,39,4,1,2,1,2,0,0,0,0,14826,7.2,18210,232,56,355,400,23.2,1482.6
4523305725,0,12,0,0,1,8,0,0,0,0,0,12791,6.6,16317,173,46,-4684,-3216,17.3,1279.1,13,1,1,8,1,3,1,1,0,0,17475,7.2,19533,239,44,4684,3216,23.9,1747.5
4523527699,1,108,5,1,6,5,8,0,0,0,0,16620,7.0,17711,238,37,361,-672,23.8,1662.0,17,0,0,5,6,5,0,0,0,0,16259,7.0,18383,223,54,-361,672,22.3,1625.9
4448379921,0,17,8,1,7,8,10,2,1,1,0,17903,7.0,18746,239,63,651,748,23.9,1790.3,17,6,0,8,7,12,0,0,0,0,17252,7.0,17998,217,48,-651,-748,21.7,1725.2
4525553823,1,14,0,0,10,4,13,1,1,0,0,19359,7.2,19182,243,53,4424,2663,24.3,1935.9,53,4,1,4,10,5,0,0,0,0,14935,6.8,16519,189,62,-4424,-2663,18.9,1493.5
4465424033,0,13,4,1,4,12,3,1,0,1,0,15140,6.6,15933,198,48,-4199,-3415,19.8,1514.0,23,2,0,12,4,11,0,0,0,1,19339,7.2,19348,221,40,4199,3415,22.1,1933.9
4453449535,1,17,2,1,7,3,13,1,1,0,0,17782,7.2,19382,225,72,2506,1793,22.5,1778.2,16,5,0,3,7,3,0,0,0,0,15276,6.8,17589,220,57,-2506,-1793,22.0,1527.6
4494295244,1,17,5,0,7,7,8,0,0,0,0,16310,6.8,17712,219,44,464,426,21.9,1631.0,16,2,1,7,7,4,1,1,0,0,15846,6.8,17286,212,48,-464,-426,21.2,1584.6
4503659177,1,17,3,0,9,7,11,0,0,0,0,17814,7.0,18465,206,51,1692,1775,20.6,1781.4,16,0,1,7,9,11,0,0,0,0,16122,6.8,16690,196,42,-1692,-1775,19.6,1612.2
4516719935,1,13,2,0,2,4,2,1,1,0,0,15312,7.0,18210,250,61,-961,-725,25.0,1531.2,16,4,1,4,2,3,0,0,0,0,16273,7.2,18935,250,56,961,725,25.0,1627.3
4490111763,1,18,4,1,7,4,5,2,1,1,0,16801,7.2,18563,211,60,1574,1834,21.1,1680.1,12,1,0,4,7,3,0,0,0,0,15227,6.8,16729,200,43,-1574,-1834,20.0,1522.7
4474827626,1,16,3,0,3,10,4,1,1,0,0,14686,7.0,17582,206,60,-3593,-3240,20.6,1468.6,24,3,1,10,3,5,0,0,0,0,18279,7.6,20822,226,68,3593,3240,22.6,1827.9
4497709596,0,17,2,1,5,10,5,2,1,1,0,16486,7.0,18609,244,56,-2249,-1547,24.4,1648.6,17,2,0,10,5,12,0,0,0,0,18735,7.4,20156,214,72,2249,1547,21.4,1873.5
4447860294,1,9,1,0,12,10,5,1,0,1,1,19785,7.4,20587,221,63,2510,2517,22.1,1978.5,14,1,1,10,12,10,1,1,0,0,17275,7.0,18070,213,48,-2510,-2517,21.3,1727.5
4525021838,1,11,0,0,3,6,2,1,0,1,0,14106,6.2,15716,200,48,-2393,-1004,20.0,1410.6,14,3,1,6,3,6,1,1,0,0,16499,6.4,16720,186,40,2393,1004,18.6,1649.9
4526069179,0,15,2,1,6,6,7,1,1,0,0,16148,6.8,15943,200,45,-1106,-1434,20.0,1614.8,15,2,0,6,6,9,1,0,1,0,17254,6.6,17377,216,70,1106,1434,21.6,1725.4
4522320216,0,21,0,0,4,7,4,0,0,0,0,15259,7.0,17666,214,63,-1396,-92,21.4,1525.9,14,6,1,7,4,7,1,1,0,0,16655,6.6,17758,250,48,1396,92,25.0,1665.5
4480574928,1,16,1,1,5,3,6,0,0,0,0,15782,7.0,18450,219,40,279,392,21.9,1578.2,14,4,0,3,5,4,1,1,0,0,15503,7.0,18058,246,63,-279,-392,24.6,1550.3
4512832249,1,20,3,1,7,3,8,1,1,0,0,16945,6.8,17981,223,44,2136,-50,22.3,1694.5,37,4,0,3,7,3,0,0,0,0,14809,7.0,18031,238,41,-2136,50,23.8,1480.9
4524528416,1,14,3,0,4,3,1,1,1,0,0,15195,7.0,18358,217,70,324,1794,21.7,1519.5,16,1,1,3,4,2,0,0,0,0,14871,6.4,16564,228,35,-324,-1794,22.8,1487.1
4510608090,1,14,2,1,3,9,2,1,1,0,0,14765,6.4,16630,200,47,-2462,-558,20.0,1476.5,17,2,0,9,3,15,0,0,0,0,17227,6.8,17188,205,47,2462,558,20.5,1722.7
4515518787,0,11,0,0,3,7,3,0,0,0,0,14381,6.6,16919,202,41,-2528,-993,20.2,1438.1,14,0,1,7,3,10,1,1,0,0,16909,6.8,17912,196,51,2528,993,19.6,1690.9
4521828781,1,10,1,1,6,8,7,1,1,0,0,15108,6.4,16485,191,36,-2302,-2232,19.1,1510.8,16,1,0,8,6,7,0,0,0,0,17410,7.0,18717,246,39,2302,2232,24.6,1741.0
4448470981,1,19,4,1,9,4,9,0,0,0,0,18738,7.0,18081,246,48,3660,577,24.6,1873.8,17,1,0,4,9,5,1,1,0,0,15078,6.8,17504,196,68,-3660,-577,19.6,1507.8
4519564214,1,14,1,1,11,8,12,0,0,0,0,18156,7.2,18548,208,52,957,469,20.8,1815.6,34,4,0,8,11,5,2,1,1,0,17199,6.8,18079,218,52,-957,-469,21.8,1719.9
4520567149,0,20,3,1,9,8,11,1,1,0,0,17429,6.8,17309,211,48,720,-183,21.1,1742.9,16,4,0,8,9,10,0,0,0,0,16709,6.8,17492,210,50,-720,183,21.0,1670.9
4451625868,0,19,1,0,3,8,1,0,0,0,0,14294,7.0,17770,206,51,-3738,-1260,20.6,1429.4,14,2,1,8,3,8,2,1,1,0,18032,7.2,19030,229,55,3738,1260,22.9,1803.2
4526793849,1,11,2,0,8,4,2,2,1,1,1,17696,7.2,18812,224,56,1786,2804,22.4,1769.6,18,3,1,4,8,7,0,0,0,0,15910,6.4,16008,200,52,-1786,-2804,20.0,1591.0
4515306616,0,19,2,0,5,9,4,0,0,0,0,15342,6.8,17286,194,50,-1630,-130,19.4,1534.2,13,6,1,9,5,12,1,1,0,0,16972,7.0,17416,216,40,1630,130,21.6,1697.2
4513340432,0,13,4,1,11,6,17,1,1,0,1,19900,7.0,17323,200,41,4027,701,20.0,1990.0,19,3,0,6,11,9,0,0,0,0,15873,6.6,16622,197,58,-4027,-701,19.7,1587.3
4476854395,1,27,3,0,3,8,1,0,0,0,0,14418,6.4,16672,206,52,-2778,-2174,20.6,1441.8,16,5,1,8,3,7,2,1,1,0,17196,7.0,18846,205,52,2778,2174,20.5,1719.6
4484850888,1,23,3,1,7,1,7,1,1,0,0,16850,7.2,19499,228,64,1994,1541,22.8,1685.0,44,1,0,1,7,2,1,0,1,0,14856,7.0,17958,224,58,-1994,-1541,22.4,1485.6
4520999253,1,11,5,1,13,6,25,0,0,0,0,20047,7.2,19339,226,56,3897,2558,22.6,2004.7,16,1,0,6,13,7,1,1,0,0,16150,6.6,16781,199,35,-3897,-2558,19.9,1615.0
4477066537,0,21,4,1,3,4,3,0,0,0,0,14509,6.8,17194,201,50,-1110,-1148,20.1,1450.9,17,5,0,4,3,4,0,0,0,0,15619,6.8,18342,241,44,1110,1148,24.1,1561.9
4519052446,1,36,7,1,10,6,11,2,1,1,0,18132,7.6,19522,232,47,1722,1514,23.2,1813.2,20,5,0,6,10,8,0,0,0,0,16410,7.2,18008,211,44,-1722,-1514,21.1,1641.0
4524352640,1,19,0,1,7,6,8,0,0,0,0,16877,6.8,17631,216,37,338,-272,21.6,1687.7,32,1,0,6,7,9,1,1,0,0,16539,7.0,17903,230,38,-338,272,23.0,1653.9
4477769511,1,86,3,0,4,5,4,0,0,0,0,15176,6.6,17215,227,46,-676,359,22.7,1517.6,17,0,1,5,4,6,2,1,1,0,15852,6.8,16856,225,56,676,-359,22.5,1585.2
4453080532,1,35,2,0,5,5,3,0,0,0,0,16195,7.0,19145,244,60,-75,655,24.4,1619.5,17,4,1,5,5,5,1,1,0,0,16270,7.0,18490,217,52,75,-655,21.7,1627.0
4481146678,1,11,3,1,9,1,13,0,0,0,0,18297,7.2,19315,251,52,4796,3112,25.1,1829.7,12,1,0,1,9,0,0,0,0,0,13501,6.4,16203,203,53,-4796,-3112,20.3,1350.1
4517937172,0,15,2,0,5,9,3,1,1,0,0,15875,7.0,18236,224,49,-1663,164,22.4,1587.5,40,1,1,9,5,14,0,0,0,0,17538,7.0,18072,173,54,1663,-164,17.3,1753.8
4520645604,1,156,0,1,10,6,15,2,1,1,1,20183,7.6,20663,216,73,3663,2748,21.6,2018.3,14,1,0,6,10,6,0,0,0,0,16520,6.8,17915,192,47,-3663,-2748,19.2,1652.0
4442576553,0,14,2,0,6,8,7,0,0,0,0,15953,6.6,17372,221,29,-1095,-249,22.1,1595.3,16,3,1,8,6,8,1,1,0,0,17048,6.8,17621,218,52,1095,249,21.8,1704.8
4465455214,0,16,4,1,7,8,8,1,1,0,0,17112,7.0,18050,215,52,-975,-678,21.5,1711.2,15,5,0,8,7,10,1,0,1,0,18087,7.0,18728,225,68,975,678,22.5,1808.7
4462339976,1,61,6,1,6,4,11,0,0,0,0,16375,7.2,18060,226,44,1389,1615,22.6,1637.5,13,1,0,4,6,3,2,1,1,0,14986,6.6,16445,198,50,-1389,-1615,19.8,1498.6
4498652179,1,18,1,1,8,2,13,1,0,1,0,17563,7.2,18032,203,64,3410,2058,20.3,1756.3,19,2,0,2,8,2,1,1,0,0,14153,6.4,15974,213,48,-3410,-2058,21.3,1415.3
4454573791,0,20,7,1,4,8,7,1,0,1,0,15228,6.8,16963,198,52,-2236,-2070,19.8,1522.8,20,5,0,8,4,8,1,1,0,0,17464,7.2,19033,227,48,2236,2070,22.7,1746.4
4482132906,1,17,5,1,9,3,7,0,0,0,0,16646,7.0,18209,236,32,2522,2156,23.6,1664.6,21,5,0,3,9,3,1,1,0,0,14124,6.6,16053,210,43,-2522,-2156,21.0,1412.4
4515527717,1,16,3,1,7,8,7,1,1,0,0,17442,6.8,17426,236,36,153,-519,23.6,1744.2,18,3,0,8,7,8,0,0,0,0,17289,6.8,17945,226,48,-153,519,22.6,1728.9
4522304761,1,53,4,0,4,6,5,1,0,1,0,15426,7.0,18021,207,59,-2376,-894,20.7,1542.6,38,7,1,6,4,9,1,1,0,0,17802,7.0,18915,227,59,2376,894,22.7,1780.2
4525091372,1,38,3,0,3,7,4,0,0,0,0,14343,6.6,16877,209,39,-3049,-2220,20.9,1434.3,19,1,1,7,3,9,0,0,0,0,17392,7.2,19097,241,51,3049,2220,24.1,1739.2
4504857073,1,14,3,0,9,10,5,1,1,0,0,17302,6.8,17065,197,39,-1085,-1716,19.7,1730.2,17,0,1,10,9,9,0,0,0,0,18387,7.2,18781,208,67,1085,1716,20.8,1838.7
4515427154,0,15,0,0,6,9,6,0,0,0,0,18187,7.0,18454,223,55,299,-1051,22.3,1818.7,13,1,1,9,6,7,1,0,1,0,17888,7.2,19505,215,60,-299,1051,21.5,1788.8
4487706140,0,16,1,1,3,6,2,0,0,0,0,15096,6.8,16516,222,46,-1625,-2418,22.2,1509.6,18,1,0,6,3,10,0,0,0,0,16721,7.0,18934,236,56,1625,2418,23.6,1672.1
4520898233,0,78,4,0,4,3,4,2,1,1,0,15906,6.8,19219,238,67,406,1283,23.8,1590.6,15,3,1,3,4,3,0,0,0,0,15500,7.0,17936,220,64,-406,-1283,22.0,1550.0
4446243794,1,16,4,0,1,5,1,2,1,1,0,14942,7.0,17727,210,83,-1215,-756,21.0,1494.2,21,3,1,5,1,7,0,0,0,0,16157,7.0,18483,233,52,1215,756,23.3,1615.7
4481181249,0,19,0,0,1,14,0,0,0,0,0,12519,6.0,13642,152,41,-7527,-4309,15.2,1251.9,24,3,1,14,1,14,0,0,0,0,20046,7.2,17951,220,43,7527,4309,22.0,2004.6
4524922802,1,16,5,1,12,4,14,0,0,0,0,18338,7.0,18468,211,43,3054,2510,21.1,1833.8,18,0,0,4,12,2,1,1,0,0,15284,6.6,15958,190,61,-3054,-2510,19.0,1528.4
4513963315,1,16,2,0,5,2,9,2,1,1,0,16636,7.0,19367,246,64,2547,1517,24.6,1663.6,15,1,1,2,5,0,0,0,0,0,14089,6.8,17850,215,56,-2547,-1517,21.5,1408.9
4510973023,0,13,5,1,8,4,11,1,1,0,0,16357,6.6,17543,196,48,-82,280,19.6,1635.7,11,2,0,4,8,4,0,0,0,0,16439,6.8,17263,241,45,82,-280,24.1,1643.9
4518065335,0,14,0,0,5,10,4,0,0,0,0,15660,7.0,18016,201,50,-2602,-550,20.1,1566.0,170,3,1,10,5,14,1,1,0,0,18262,7.2,18566,197,42,2602,550,19.7,1826.2
4513601289,0,14,2,1,8,7,14,0,0,0,0,17077,6.6,16354,171,56,974,-1050,17.1,1707.7,16,1,0,7,8,4,1,1,0,0,16103,6.8,17404,200,48,-974,1050,20.0,1610.3
4524683257,0,12,3,0,4,7,2,0,0,0,0,15125,6.8,17217,223,56,-3346,-1685,22.3,1512.5,18,4,1,7,4,8,2,1,1,1,18471,7.2,18902,219,54,3346,1685,21.9,1847.1
4507440061,0,41,4,1,9,6,10,1,1,0,0,17090,7.2,18470,216,44,989,755,21.6,1709.0,17,2,0,6,9,5,0,0,0,0,16101,6.8,17715,213,56,-989,-755,21.3,1610.1
4477376343,1,12,5,1,12,5,13,1,1,0,0,19740,7.4,19505,228,68,4498,4087,22.8,1974.0,21,1,0,5,12,6,0,0,0,0,15242,6.2,15418,183,40,-4498,-4087,18.3,1524.2
4517546735,1,85,6,1,9,1,11,1,1,0,0,18824,7.2,19996,237,59,5240,2335,23.7,1882.4,20,2,0,1,9,0,0,0,0,0,13584,7.0,17661,217,42,-5240,-2335,21.7,1358.4
4506294418,0,17,1,0,2,2,1,0,0,0,0,15831,7.4,19463,271,64,1134,1160,27.1,1583.1,12,3,1,2,2,0,1,1,0,0,14697,7.0,18303,238,61,-1134,-1160,23.8,1469.7
4474923915,0,19,5,0,3,8,2,0,0,0,0,15085,6.8,17193,231,56,-2695,-152,23.1,1508.5,20,4,1,8,3,12,0,0,0,0,17780,6.6,17345,218,52,2695,152,21.8,1778.0
4523841785,1,20,4,1,12,6,9,1,1,0,0,18259,7.2,19685,218,48,2254,1555,21.8,1825.9,17,4,0,6,12,3,0,0,0,0,16005,7.0,18130,215,42,-2254,-1555,21.5,1600.5
4521032277,1,16,3,0,7,7,7,2,1,1,0,17239,7.4,19174,222,48,1167,2368,22.2,1723.9,12,2,1,7,7,7,0,0,0,0,16072,6.6,16806,182,58,-1167,-2368,18.2,1607.2
4524609422,1,16,3,1,3,4,2,2,1,1,0,14501,6.6,16819,201,46,-250,489,20.1,1450.1,15,4,0,4,3,6,0,0,0,0,14751,6.4,16330,212,39,250,-489,21.2,1475.1
4475170098,0,12,4,0,5,6,5,1,0,1,0,16216,7.0,19002,211,71,-976,-964,21.1,1621.6,15,2,1,6,5,8,1,1,0,0,17192,7.6,19966,222,69,976,964,22.2,1719.2
4509108829,1,16,2,1,9,7,9,0,0,0,0,17668,7.2,18804,230,55,1024,750,23.0,1766.8,11,4,0,7,9,5,0,0,0,0,16644,7.2,18054,226,48,-1024,-750,22.6,1664.4
4509906383,0,16,1,0,7,11,8,0,0,0,0,15919,6.8,16956,200,32,-2604,-1096,20.0,1591.9,15,1,1,11,7,10,0,0,0,0,18523,7.0,18052,183,48,2604,1096,18.3,1852.3
4508974549,1,16,7,0,6,7,4,1,0,1,0,16823,7.0,18727,213,52,151,806,21.3,1682.3,19,6,1,7,6,8,1,1,0,0,16672,6.8,17921,226,48,-151,-806,22.6,1667.2
4442547798,1,19,2,1,7,5,10,0,0,0,0,16491,6.8,17031,199,45,1774,1305,19.9,1649.1,19,2,0,5,7,5,0,0,0,0,14717,6.4,15726,170,34,-1774,-1305,17.0,1471.7
4446019299,1,17,1,1,6,3,7,1,1,0,1,18564,7.0,18738,239,44,4518,1715,23.9,1856.4,11,3,0,3,6,2,0,0,0,0,14046,6.8,17023,169,55,-4518,-1715,16.9,1404.6
4527293021,1,10,7,1,5,3,5,1,1,0,0,15239,7.2,18919,218,45,742,2904,21.8,1523.9,22,2,0,3,5,4,0,0,0,0,14497,6.6,16015,182,58,-742,-2904,18.2,1449.7
4514521054,0,15,4,0,2,9,2,1,1,0,0,14730,6.6,17103,246,41,-4406,-2663,24.6,1473.0,30,1,1,9,2,6,1,0,1,1,19136,7.6,19766,233,60,4406,2663,23.3,1913.6
4513101672,0,15,2,1,8,6,8,1,0,1,0,17124,6.4,16900,207,55,1315,63,20.7,1712.4,17,3,0,6,8,6,0,0,0,0,15809,6.6,16837,209,33,-1315,-63,20.9,1580.9
4518016212,1,16,3,0,6,6,3,0,0,0,0,16266,7.0,17825,213,51,920,1098,21.3,1626.6,15,4,1,6,6,4,0,0,0,0,15346,6.6,16727,210,40,-920,-1098,21.0,1534.6
4493650518,0,18,2,0,6,12,9,0,0,0,0,16944,7.0,17663,193,52,-2761,-2375,19.3,1694.4,14,3,1,12,6,12,1,1,0,0,19705,7.4,20038,227,52,2761,2375,22.7,1970.5
4506730764,1,78,18,0,6,3,4,2,1,1,1,18704,7.6,20796,260,67,3917,2196,26.0,1870.4,39,0,1,3,6,1,0,0,0,0,14787,7.0,18600,216,60,-3917,-2196,21.6,1478.7
4474770389,1,19,2,1,5,4,7,1,1,0,0,16359,7.0,18199,210,64,917,-90,21.0,1635.9,15,1,0,4,5,4,0,0,0,0,15442,7.0,18289,218,55,-917,90,21.8,1544.2
4511985259,1,88,4,1,9,7,8,0,0,0,0,18283,7.4,19207,243,44,3038,3164,24.3,1828.3,21,7,0,7,9,5,1,1,0,0,15245,6.4,16043,147,52,-3038,-3164,14.7,1524.5
4522478777,1,25,1,1,13,5,15,0,0,0,0,19475,7.0,18495,218,37,4519,2852,21.8,1947.5,11,1,0,5,13,3,0,0,0,0,14956,6.4,15643,189,32,-4519,-2852,18.9,1495.6
4465418365,0,14,0,0,5,9,3,0,0,0,0,15905,6.8,17772,203,43,-1798,-1804,20.3,1590.5,14,4,1,9,5,5,1,1,0,0,17703,7.0,19576,218,58,1798,1804,21.8,1770.3
4527580524,0,16,2,0,6,8,9,1,1,0,0,15666,6.4,16073,208,39,-2468,-2552,20.8,1566.6,13,2,1,8,6,6,1,0,1,0,18134,7.2,18625,231,60,2468,2552,23.1,1813.4
4519231725,1,40,4,0,12,9,11,1,1,0,0,18395,7.2,18790,193,36,718,1313,19.3,1839.5,14,1,1,9,12,9,0,0,0,0,17677,7.0,17477,206,48,-718,-1313,20.6,1767.7
4509254722,1,13,3,0,6,10,6,1,1,0,0,16279,7.0,18734,226,56,-1753,-1095,22.6,1627.9,16,5,1,10,6,6,0,0,0,0,18032,7.0,19829,253,52,1753,1095,25.3,1803.2
4524541241,1,16,3,1,9,1,12,1,0,1,1,18626,7.4,19683,205,38,5448,4419,20.5,1862.6,16,1,0,1,9,1,1,1,0,0,13178,6.4,15264,179,45,-5448,-4419,17.9,1317.8
4520723739,1,13,1,1,1,2,1,0,0,0,0,14654,6.8,16892,225,56,-96,-1063,22.5,1465.4,16,1,0,2,1,1,0,0,0,0,14750,7.0,17955,240,40,96,1063,24.0,1475.0
4459084553,0,21,7,0,5,5,6,0,0,0,0,16110,6.8,17732,245,38,-1519,-1488,24.5,1611.0,20,5,1,5,5,10,1,1,0,0,17629,7.2,19220,228,76,1519,1488,22.8,1762.9
4515780099,0,18,2,0,4,7,6,0,0,0,0,15052,7.0,16945,194,50,-1729,-1258,19.4,1505.2,17,6,1,7,4,8,1,1,0,0,16781,7.0,18203,226,48,1729,1258,22.6,1678.1
4524480433,0,11,3,1,3,10,1,1,1,0,0,13744,6.4,15449,167,50,-4663,-3624,16.7,1374.4,15,2,0,10,3,11,0,0,0,0,18407,7.2,19073,219,44,4663,3624,21.9,1840.7
4519708625,0,14,3,1,7,5,9,0,0,0,0,16655,7.2,18948,208,50,791,1064,20.8,1665.5,34,1,0,5,7,6,2,1,1,0,15864,6.8,17884,212,58,-791,-1064,21.2,1586.4
4521686224,0,145,2,0,2,6,1,0,0,0,0,14062,6.8,17156,219,44,-2226,-2642,21.9,1406.2,14,5,1,6,2,2,2,1,1,0,16288,7.4,19798,238,59,2226,2642,23.8,1628.8
4445877402,1,16,2,1,10,4,9,1,0,1,0,17933,7.2,19728,217,52,2690,2444,21.7,1793.3,14,2,0,4,10,6,1,1,0,0,15243,6.8,17284,213,56,-2690,-2444,21.3,1524.3
4478063031,0,30,4,0,5,6,5,0,0,0,0,15978,6.8,18068,210,52,-323,214,21.0,1597.8,31,4,1,6,5,6,1,1,0,0,16301,7.0,17854,203,48,323,-214,20.3,1630.1
4514527472,1,13,5,0,13,3,11,1,0,1,0,19133,7.4,20110,223,40,4238,3475,22.3,1913.3,14,0,1,3,13,2,1,1,0,0,14895,6.6,16635,168,80,-4238,-3475,16.8,1489.5
4512135752,1,13,4,0,4,2,3,0,0,0,0,15750,7.0,18310,233,52,755,-289,23.3,1575.0,16,2,1,2,4,2,1,1,0,0,14995,7.0,18599,248,57,-755,289,24.8,1499.5
4517762316,1,16,3,1,6,7,3,0,0,0,0,16241,7.2,18124,238,47,-602,-905,23.8,1624.1,16,3,0,7,6,5,0,0,0,0,16843,7.2,19029,232,68,602,905,23.2,1684.3
4508177030,1,42,2,0,4,6,2,1,1,0,0,15272,7.0,18442,205,47,-716,573,20.5,1527.2,145,3,1,6,4,5,0,0,0,0,15988,6.8,17869,207,50,716,-573,20.7,1598.8
4518204390,0,14,3,1,11,12,9,0,0,0,0,17840,7.0,18114,175,51,-2425,-1827,17.5,1784.0,28,2,0,12,11,12,2,1,1,1,20265,7.4,19941,197,58,2425,1827,19.7,2026.5
4496613517,0,17,4,1,9,10,5,0,0,0,0,17193,7.0,18326,224,40,-1027,-1434,22.4,1719.3,16,2,0,10,9,6,0,0,0,0,18220,7.6,19760,236,56,1027,1434,23.6,1822.0
4447392049,0,43,6,1,11,4,12,1,0,1,0,18976,7.4,20326,256,43,2856,1262,25.6,1897.6,16,0,0,4,11,6,1,1,0,0,16120,7.2,19064,210,72,-2856,-1262,21.0,1612.0
4495407654,0,16,5,0,7,4,9,0,0,0,0,17610,6.8,17644,233,48,1883,973,23.3,1761.0,16,2,1,4,7,4,0,0,0,0,15727,6.6,16671,212,62,-1883,-973,21.2,1572.7
4492410898,0,16,2,1,7,6,7,0,0,0,0,16440,6.8,17181,197,37,-635,-1449,19.7,1644.0,11,5,0,6,7,8,1,1,0,0,17075,7.0,18630,246,49,635,1449,24.6,1707.5
4484971945,0,16,4,1,7,10,6,1,1,0,0,17448,6.8,17864,205,62,-102,363,20.5,1744.8,42,4,0,10,7,11,0,0,0,0,17550,6.8,17501,181,50,102,-363,18.1,1755.0
4469754326,1,21,2,1,13,11,8,1,1,0,0,18834,6.8,17602,203,56,1059,1185,20.3,1883.4,19,4,0,11,13,12,0,0,0,0,17775,6.4,16417,182,44,-1059,-1185,18.2,1777.5
4521293545,1,17,1,1,6,2,5,1,0,1,0,17834,7.2,19145,276,44,3797,2242,27.6,1783.4,10,1,0,2,6,3,1,1,0,0,14037,6.8,16903,202,48,-3797,-2242,20.2,1403.7
4455008187,0,19,3,1,7,7,5,0,0,0,0,15321,6.6,17311,171,44,-2338,-2724,17.1,1532.1,15,3,0,7,7,10,0,0,0,0,17659,7.4,20035,225,47,2338,2724,22.5,1765.9
4485867015,0,16,1,1,7,8,4,1,1,0,0,15863,7.0,18126,178,58,-735,-742,17.8,1586.3,17,0,0,8,7,3,0,0,0,0,16598,7.0,18868,231,56,735,742,23.1,1659.8
4507707842,1,20,3,0,6,9,2,1,1,0,0,15054,6.4,16819,209,26,-2018,-1345,20.9,1505.4,17,4,1,9,6,14,0,0,0,0,17072,7.2,18164,169,57,2018,1345,16.9,1707.2
4475613752,1,16,2,0,10,9,7,2,1,1,0,17793,7.2,19322,215,59,508,1164,21.5,1779.3,15,1,1,9,10,10,0,0,0,0,17285,7.0,18158,193,56,-508,-1164,19.3,1728.5
4502901044,0,14,4,0,3,3,2,1,1,0,0,15297,7.0,19210,246,56,131,370,24.6,1529.7,20,2,1,3,3,1,0,0,0,0,15166,7.2,18840,227,64,-131,-370,22.7,1516.6
4524162182,1,15,5,1,6,2,8,1,1,0,0,18027,7.2,19090,252,53,3909,1938,25.2,1802.7,15,2,0,2,6,1,0,0,0,0,14118,6.6,17152,219,37,-3909,-1938,21.9,1411.8
4513856190,0,37,3,1,4,6,6,0,0,0,0,15871,6.8,17242,224,56,-752,-1764,22.4,1587.1,14,10,0,6,4,4,2,1,1,0,16623,7.0,19006,228,72,752,1764,22.8,1662.3
4466463229,1,16,1,0,1,2,1,0,0,0,0,14399,6.8,18382,229,46,-621,319,22.9,1439.9,10,2,1,2,1,2,0,0,0,0,15020,6.8,18063,228,52,621,-319,22.8,1502.0
4509344771,1,12,1,0,4,7,4,1,0,1,0,15891,7.2,19024,200,59,-820,-298,20.0,1589.1,35,1,1,7,4,7,1,1,0,0,16711,7.4,19322,214,48,820,298,21.4,1671.1
4519612989,0,27,2,0,10,12,13,1,1,0,0,17283,6.4,16235,184,36,-845,-1743,18.4,1728.3,14,5,1,12,10,7,0,0,0,0,18128,6.8,17978,208,68,845,1743,20.8,1812.8
4492353523,1,13,2,1,7,6,7,0,0,0,0,16920,7.0,17906,204,60,1563,901,20.4,1692.0,16,3,0,6,7,8,0,0,0,0,15357,6.8,17005,178,56,-1563,-901,17.8,1535.7
4405265632,1,14,4,1,4,4,5,0,0,0,0,16139,6.8,17770,245,46,690,444,24.5,1613.9,21,4,0,4,4,7,1,1,0,0,15449,6.8,17326,206,52,-690,-444,20.6,1544.9
4465150081,1,18,2,1,10,10,10,1,1,0,0,18062,7.0,17871,190,62,-1293,-713,19.0,1806.2,13,2,0,10,10,10,0,0,0,0,19355,7.2,18584,247,50,1293,713,24.7,1935.5
4519341811,1,42,1,1,12,5,10,0,0,0,0,19270,7.6,19668,229,55,3855,1646,22.9,1927.0,13,0,0,5,12,1,2,1,1,0,15415,7.0,18022,213,56,-3855,-1646,21.3,1541.5
4465964389,0,36,6,0,4,8,7,0,0,0,0,14795,6.6,16491,190,36,-3431,-1020,19.0,1479.5,27,1,1,8,4,11,1,1,0,0,18226,6.8,17511,221,47,3431,1020,22.1,1822.6
4413462978,1,18,2,1,5,2,6,1,1,0,0,15814,7.0,17846,240,52,1012,191,24.0,1581.4,34,2,0,2,5,1,0,0,0,0,14802,6.8,17655,229,51,-1012,-191,22.9,1480.2
4519053243,0,16,2,1,9,12,15,0,0,0,0,16494,6.2,15865,156,40,-1484,-1528,15.6,1649.4,16,0,0,12,9,14,1,1,0,0,17978,6.6,17393,196,56,1484,1528,19.6,1797.8
4515691372,0,12,2,1,4,9,2,0,0,0,0,15790,6.6,16879,215,45,-1876,-2154,21.5,1579.0,17,0,0,9,4,10,1,1,0,0,17666,7.4,19033,208,60,1876,2154,20.8,1766.6
4492128831,0,15,7,0,5,8,6,0,0,0,0,15242,6.4,16237,204,44,-1707,-1600,20.4,1524.2,31,4,1,8,5,10,1,1,0,0,16949,6.8,17837,231,51,1707,1600,23.1,1694.9
4521311431,1,19,0,1,6,7,5,0,0,0,0,16217,6.8,17326,217,41,112,79,21.7,1621.7,14,4,0,7,6,8,2,1,1,0,16105,6.8,17247,225,43,-112,-79,22.5,1610.5
4517499041,0,12,3,1,3,4,4,1,1,0,0,15523,7.0,18159,233,60,-279,-411,23.3,1552.3,13,1,0,4,3,6,0,0,0,0,15802,7.2,18570,247,52,279,411,24.7,1580.2
4492581093,1,14,0,1,4,4,6,0,0,0,0,15866,7.0,18127,221,53,218,-598,22.1,1586.6,40,3,0,4,4,4,1,1,0,0,15648,7.2,18725,219,60,-218,598,21.9,1564.8
4449468024,0,35,0,0,4,9,4,0,0,0,0,15337,6.8,17456,211,43,-1167,-1265,21.1,1533.7,16,6,1,9,4,8,0,0,0,0,16504,7.0,18721,173,45,1167,1265,17.3,1650.4
4522663961,0,19,3,0,3,5,1,0,0,0,0,15143,7.2,19080,233,59,-927,967,23.3,1514.3,16,4,1,5,3,7,1,1,0,0,16070,7.0,18113,216,48,927,-967,21.6,1607.0
4478763628,0,16,0,0,5,8,5,0,0,0,0,15738,6.8,16964,215,42,-1769,-1859,21.5,1573.8,17,4,1,8,5,15,1,1,0,0,17507,7.2,18823,185,81,1769,1859,18.5,1750.7
4524483591,0,12,3,0,3,8,1,0,0,0,0,14290,6.8,17459,204,52,-3260,-1060,20.4,1429.0,18,3,1,8,3,8,1,1,0,0,17550,7.2,18519,221,61,3260,1060,22.1,1755.0
4522422661,1,16,3,1,4,6,6,1,1,0,0,16452,7.0,18564,234,54,271,22,23.4,1645.2,14,1,0,6,4,1,1,0,1,0,16181,7.0,18542,224,64,-271,-22,22.4,1618.1
4489524700,0,12,0,1,7,8,6,1,1,0,0,17011,7.2,18754,231,48,-2215,-138,23.1,1701.1,13,0,0,8,7,13,1,0,1,2,19226,7.0,18892,206,62,2215,138,20.6,1922.6
4475185229,1,39,0,0,11,5,12,1,0,1,2,20920,7.2,19263,243,36,5418,3077,24.3,2092.0,12,0,1,5,11,8,0,0,0,0,15502,6.8,16186,173,47,-5418,-3077,17.3,1550.2
4522626494,1,16,1,1,4,3,3,0,0,0,0,16048,7.2,19032,255,64,1454,1411,25.5,1604.8,13,1,0,3,4,3,0,0,0,0,14594,7.0,17621,234,34,-1454,-1411,23.4,1459.4
4511386287,0,19,7,1,10,7,8,1,1,0,1,18822,7.0,18319,224,51,2830,1605,22.4,1882.2,21,1,0,7,10,5,1,0,1,0,15992,6.6,16714,195,47,-2830,-1605,19.5,1599.2
4526552295,1,38,1,1,6,4,8,0,0,0,0,16352,7.0,18600,230,52,209,-6,23.0,1635.2,19,5,0,4,6,6,1,0,1,0,16143,7.0,18606,243,48,-209,6,24.3,1614.3
4525780504,0,13,2,0,3,2,6,0,0,0,0,14509,6.8,16800,191,52,-1749,-1247,19.1,1450.9,16,3,1,2,3,3,2,1,1,0,16258,6.8,18047,251,65,1749,1247,25.1,1625.8
4495129038,1,30,3,1,13,7,14,1,1,0,0,19526,7.4,19551,225,53,3003,3063,22.5,1952.6,13,1,0,7,13,9,0,0,0,0,16523,6.6,16488,200,57,-3003,-3063,20.0,1652.3
4440152952,1,14,5,0,6,6,8,0,0,0,0,16171,6.8,17226,191,52,-857,-1356,19.1,1617.1,18,2,1,6,6,5,1,1,0,0,17028,7.0,18582,234,59,857,1356,23.4,1702.8
4507806528,1,12,3,1,6,4,5,2,1,1,0,15994,6.8,18356,235,43,1396,2369,23.5,1599.4,12,0,0,4,6,4,0,0,0,0,14598,6.6,15987,166,56,-1396,-2369,16.6,1459.8
4484535583,0,24,4,0,2,9,2,0,0,0,0,14714,6.8,17620,217,49,-2484,-1989,21.7,1471.4,14,3,1,9,2,7,0,0,0,0,17198,7.4,19609,232,43,2484,1989,23.2,1719.8
4479856862,1,19,5,1,7,7,8,1,1,0,0,16282,6.8,16565,211,44,686,-89,21.1,1628.2,55,3,0,7,7,6,1,0,1,0,15596,6.6,16654,180,51,-686,89,18.0,1559.6
4526910124,0,13,1,1,7,6,9,0,0,0,0,17740,7.0,18658,252,37,1419,1036,25.2,1774.0,13,5,0,6,7,7,2,1,1,0,16321,6.8,17622,215,56,-1419,-1036,21.5,1632.1
4497173280,1,18,2,1,11,9,5,0,0,0,0,18702,7.4,18736,234,53,1713,1791,23.4,1870.2,15,3,0,9,11,6,0,0,0,0,16989,6.6,16945,179,38,-1713,-1791,17.9,1698.9
4510734919,0,16,4,1,5,7,3,0,0,0,0,16259,6.6,17235,221,64,-67,-1341,22.1,1625.9,36,6,0,7,5,12,1,1,0,0,16326,7.2,18576,200,44,67,1341,20.0,1632.6
4481875944,1,14,2,0,7,11,7,0,0,0,0,15177,6.4,15795,152,36,-3891,-2689,15.2,1517.7,41,0,1,11,7,9,0,0,0,0,19068,7.2,18484,218,43,3891,2689,21.8,1906.8
4525983895,1,17,2,0,7,2,5,1,0,1,0,17026,6.8,18847,254,40,2439,2360,25.4,1702.6,17,1,1,2,7,2,0,0,0,0,14587,6.6,16487,230,41,-2439,-2360,23.0,1458.7
4452273327,0,48,5,1,4,3,6,0,0,0,0,16596,7.0,18596,252,64,539,818,25.2,1659.6,19,8,0,3,4,2,1,1,0,0,16057,6.6,17778,236,51,-539,-818,23.6,1605.7
4525009090,0,14,0,0,3,7,3,0,0,0,0,15571,7.2,18029,212,60,-1431,-648,21.2,1557.1,15,1,1,7,3,9,1,1,0,0,17002,7.0,18677,241,51,1431,648,24.1,1700.2
4516357947,0,17,3,1,8,9,12,1,1,0,1,17268,6.6,15979,194,48,-952,-1337,19.4,1726.8,19,1,0,9,8,7,1,0,1,0,18220,6.6,17316,214,55,952,1337,21.4,1822.0
4515605515,0,15,6,0,2,3,2,0,0,0,0,15656,6.8,17712,240,51,265,682,24.0,1565.6,58,3,1,3,2,6,2,1,1,0,15391,6.6,17030,201,55,-265,-682,20.1,1539.1
4517882103,0,16,0,0,7,8,7,0,0,0,0,17084,7.0,17884,224,52,-100,-120,22.4,1708.4,16,3,1,8,7,10,1,1,0,0,17184,7.0,18004,207,59,100,120,20.7,1718.4
4517522957,0,25,3,1,4,8,7,0,0,0,0,14627,6.6,16086,193,47,-3960,-4005,19.3,1462.7,16,8,0,8,4,9,1,1,0,0,18587,7.6,20091,247,68,3960,4005,24.7,1858.7
4518215400,0,18,1,0,7,8,5,0,0,0,0,16768,7.2,19368,225,58,-268,-155,22.5,1676.8,15,2,1,8,7,9,1,1,0,0,17036,7.2,19523,221,65,268,155,22.1,1703.6
4488919403,0,15,0,0,5,5,7,0,0,0,0,14469,6.2,15329,136,48,-2579,-3819,13.6,1446.9,14,3,1,5,5,2,1,0,1,0,17048,7.2,19148,244,60,2579,3819,24.4,1704.8
4472833324,1,13,3,1,6,7,5,0,0,0,0,16399,6.8,17056,219,43,580,-54,21.9,1639.9,14,1,0,7,6,7,0,0,0,0,15819,6.6,17110,189,43,-580,54,18.9,1581.9
4476200313,1,16,4,0,8,2,6,1,1,0,0,17315,7.2,18903,232,47,4064,3736,23.2,1731.5,16,6,1,2,8,1,0,0,0,0,13251,6.2,15167,181,45,-4064,-3736,18.1,1325.1
4489966675,1,27,2,1,5,5,6,0,0,0,0,16281,6.8,17527,233,48,128,-368,23.3,1628.1,17,4,0,5,5,10,1,1,0,0,16153,7.2,17895,223,51,-128,368,22.3,1615.3
4488342223,0,13,1,1,3,6,1,0,0,0,0,14734,6.8,17665,226,42,-1871,-605,22.6,1473.4,19,0,0,6,3,6,0,0,0,0,16605,7.0,18270,231,48,1871,605,23.1,1660.5
4527324458,1,24,2,1,4,2,5,0,0,0,0,15356,6.4,16499,233,45,925,-400,23.3,1535.6,17,3,0,2,4,3,0,0,0,0,14431,6.8,16899,206,56,-925,400,20.6,1443.1
4523631613,1,19,4,1,9,7,9,0,0,0,0,17756,7.0,18384,211,40,1975,969,21.1,1775.6,19,6,0,7,9,4,0,0,0,0,15781,6.6,17415,210,38,-1975,-969,21.0,1578.1
4525016359,1,18,5,1,8,3,4,0,0,0,0,18347,7.4,19605,251,59,2493,1826,25.1,1834.7,15,4,0,3,8,2,1,1,0,0,15854,7.0,17779,233,44,-2493,-1826,23.3,1585.4
4468739944,1,17,2,0,8,5,16,1,1,0,0,16291,6.8,16847,179,42,478,1166,17.9,1629.1,20,4,1,5,8,8,0,0,0,0,15813,6.4,15681,205,40,-478,-1166,20.5,1581.3
4518358306,0,42,4,0,6,11,10,1,1,0,0,16245,7.0,18044,208,50,-3451,-2220,20.8,1624.5,26,5,1,11,6,10,1,0,1,0,19696,7.6,20264,235,59,3451,2220,23.5,1969.6
4497724425,1,15,1,1,16,5,14,1,1,0,0,19098,7.0,18636,203,37,2447,247,20.3,1909.8,11,0,0,5,16,3,0,0,0,0,16651,7.0,18389,207,63,-2447,-247,20.7,1665.1
4526094689,1,15,4,1,7,5,6,0,0,0,0,17327,7.0,18249,215,60,2281,292,21.5,1732.7,47,2,0,5,7,2,0,0,0,0,15046,7.0,17957,205,38,-2281,-292,20.5,1504.6
4476872627,0,14,3,0,3,3,5,0,0,0,0,14259,6.4,15830,202,38,-1034,-846,20.2,1425.9,14,2,1,3,3,0,1,1,0,0,15293,6.6,16676,229,54,1034,846,22.9,1529.3
4522834412,1,42,5,1,8,7,11,1,1,0,0,17971,7.0,19666,209,64,523,-69,20.9,1797.1,24,5,0,7,8,9,0,0,0,0,17448,7.2,19735,237,61,-523,69,23.7,1744.8
4521148922,1,16,3,1,9,5,18,2,1,1,1,19011,7.0,17878,201,57,3451,202,20.1,1901.1,46,1,0,5,9,4,0,0,0,0,15560,7.0,17676,224,44,-3451,-202,22.4,1556.0
4518532291,0,86,2,0,5,11,5,0,0,0,0,17155,7.2,18632,224,72,-1516,391,22.4,1715.5,17,2,1,11,5,12,1,1,0,0,18671,7.0,18241,228,40,1516,-391,22.8,1867.1
4487381952,1,18,3,0,14,12,11,0,0,0,0,19118,7.2,19312,218,29,646,1756,21.8,1911.8,17,3,1,12,14,13,1,0,1,0,18472,6.8,17556,211,46,-646,-1756,21.1,1847.2
4449831560,0,14,4,0,3,10,3,1,1,0,0,15225,7.0,17939,211,58,-2707,-1826,21.1,1522.5,16,0,1,10,3,11,0,0,0,0,17932,7.4,19765,209,52,2707,1826,20.9,1793.2
4518589161,1,79,1,0,3,7,3,0,0,0,0,15065,6.8,17306,239,31,-2560,-2062,23.9,1506.5,17,2,1,7,3,6,2,1,1,0,17625,7.2,19368,242,63,2560,2062,24.2,1762.5
4488749710,1,15,2,0,7,6,4,1,1,0,0,16544,7.0,18907,247,47,272,1485,24.7,1654.4,36,3,1,6,7,6,0,0,0,0,16272,7.0,17422,221,54,-272,-1485,22.1,1627.2
4524445302,1,18,1,0,12,9,10,0,0,0,0,17597,6.4,15938,143,48,905,1054,14.3,1759.7,12,3,1,9,12,9,0,0,0,0,16692,6.2,14884,181,40,-905,-1054,18.1,1669.2
4450950525,1,20,2,1,5,6,3,0,0,0,0,16038,7.0,18686,219,60,329,1704,21.9,1603.8,13,2,0,6,5,3,1,1,0,0,15709,6.8,16982,208,56,-329,-1704,20.8,1570.9
4472987459,1,16,3,1,6,7,6,1,1,0,0,17330,7.2,18821,226,63,777,1580,22.6,1733.0,15,1,0,7,6,13,0,0,0,0,16553,6.8,17241,195,44,-777,-1580,19.5,1655.3
4492812373,1,22,5,0,3,2,1,1,0,1,0,16246,7.2,19387,253,60,2679,3685,25.3,1624.6,13,2,1,2,3,2,1,1,0,0,13567,6.6,15702,169,60,-2679,-3685,16.9,1356.7
4513367721,0,16,3,1,5,3,5,1,0,1,0,16128,7.0,17286,226,62,822,363,22.6,1612.8,17,4,0,3,5,5,0,0,0,0,15306,6.6,16923,229,44,-822,-363,22.9,1530.6
4510754518,1,19,3,0,5,4,3,1,1,0,0,17061,7.6,20292,249,76,1217,2934,24.9,1706.1,15,1,1,4,5,6,0,0,0,0,15844,6.6,17358,218,48,-1217,-2934,21.8,1584.4
4521364269,1,16,1,1,6,0,5,1,1,0,0,17002,7.2,19584,227,59,4376,4106,22.7,1700.2,18,2,0,0,6,0,0,0,0,0,12626,6.2,15478,184,48,-4376,-4106,18.4,1262.6
4525226675,1,21,3,1,9,7,13,0,0,0,0,17331,6.8,17982,201,59,1099,-98,20.1,1733.1,20,3,0,7,9,7,1,1,0,0,16232,6.8,18080,195,52,-1099,98,19.5,1623.2
4512194286,0,14,1,0,3,8,1,0,0,0,0,15539,6.8,17792,214,72,-2925,-2112,21.4,1553.9,20,3,1,8,3,9,2,1,1,0,18464,7.2,19904,242,47,2925,2112,24.2,1846.4
4521689217,0,16,2,0,3,7,2,1,1,0,0,15252,7.0,18024,224,56,-1293,-380,22.4,1525.2,38,3,1,7,3,8,0,0,0,0,16545,7.0,18404,219,48,1293,380,21.9,1654.5
4495631767,1,17,9,1,9,2,9,2,1,1,1,20464,7.4,19989,251,65,6597,4613,25.1,2046.4,15,2,0,2,9,2,0,0,0,0,13867,6.2,15376,215,40,-6597,-4613,21.5,1386.7
4505075524,0,10,0,0,5,8,2,0,0,0,0,15913,6.8,18220,225,46,-1091,-892,22.5,1591.3,16,1,1,8,5,6,1,1,0,0,17004,7.2,19112,208,66,1091,892,20.8,1700.4
4527532264,1,16,1,1,9,10,13,1,1,0,0,17469,6.8,16911,195,45,-1022,-1200,19.5,1746.9,14,4,0,10,9,13,0,0,0,0,18491,6.8,18111,248,33,1022,1200,24.8,1849.1
4499643197,1,20,1,0,5,6,7,1,1,0,0,15087,6.4,16343,213,44,-764,-120,21.3,1508.7,17,1,1,6,5,12,0,0,0,0,15851,6.6,16463,211,48,764,120,21.1,1585.1
4455316787,1,14,4,1,8,3,8,0,0,0,0,18513,7.2,18739,250,40,4098,1004,25.0,1851.3,12,0,0,3,8,4,0,0,0,0,14415,6.8,17735,194,60,-4098,-1004,19.4,1441.5
4515621267,0,73,4,0,3,9,4,0,0,0,0,14282,6.6,16446,182,49,-4690,-3429,18.2,1428.2,15,8,1,9,3,11,1,1,0,0,18972,7.4,19875,235,65,4690,3429,23.5,1897.2
4478422383,1,17,0,1,8,7,8,1,1,0,0,17200,6.6,17501,226,36,528,-805,22.6,1720.0,13,1,0,7,8,7,0,0,0,0,16672,7.2,18306,199,69,-528,805,19.9,1667.2
4508717293,0,18,3,1,5,8,3,0,0,0,0,15177,6.6,16094,206,33,-2399,-2317,20.6,1517.7,15,3,0,8,5,7,1,1,0,0,17576,7.0,18411,243,47,2399,2317,24.3,1757.6
4472185629,0,20,1,0,5,8,4,0,0,0,0,16164,7.0,17971,233,44,-2274,-2172,23.3,1616.4,17,3,1,8,5,10,1,1,0,0,18438,7.4,20143,240,60,2274,2172,24.0,1843.8
4522224845,1,84,3,1,9,6,4,1,1,0,0,18726,7.4,20142,257,51,2673,2723,25.7,1872.6,38,2,0,6,9,11,0,0,0,0,16053,6.8,17419,196,52,-2673,-2723,19.6,1605.3
4494142673,0,14,3,1,3,3,5,0,0,0,0,15389,6.8,17782,231,60,-1930,-1452,23.1,1538.9,19,4,0,3,3,4,2,1,1,1,17319,7.2,19234,276,52,1930,1452,27.6,1731.9
4494500781,1,18,5,0,6,9,7,2,1,1,0,18050,7.2,18264,238,60,284,681,23.8,1805.0,58,5,1,9,6,15,0,0,0,0,17766,6.8,17583,207,52,-284,-681,20.7,1776.6
4482120889,1,18,2,1,11,5,11,2,1,1,0,18544,7.0,18246,213,44,3046,1162,21.3,1854.4,13,1,0,5,11,5,0,0,0,0,15498,6.6,17084,198,48,-3046,-1162,19.8,1549.8
4516554844,1,14,6,0,12,11,13,0,0,0,0,18950,7.4,18183,216,40,227,939,21.6,1895.0,17,4,1,11,12,13,0,0,0,0,18723,6.8,17244,217,44,-227,-939,21.7,1872.3
4465004748,1,18,1,0,8,4,10,2,1,1,0,16993,7.2,18608,212,48,937,530,21.2,1699.3,19,3,1,4,8,3,0,0,0,0,16056,7.0,18078,205,66,-937,-530,20.5,1605.6
4492831778,1,12,3,0,8,10,8,0,0,0,0,15968,6.4,15868,145,42,-1912,-19,14.5,1596.8,15,3,1,10,8,13,1,1,0,0,17880,6.6,15887,191,33,1912,19,19.1,1788.0
4513547440,0,14,4,1,4,10,2,0,0,0,0,15945,7.0,17784,229,56,-1757,-1856,22.9,1594.5,28,1,0,10,4,8,2,1,1,0,17702,7.2,19640,209,60,1757,1856,20.9,1770.2
4523031223,1,21,3,1,4,6,5,0,0,0,0,15454,6.8,17256,199,45,-1648,-1354,19.9,1545.4,15,5,0,6,4,3,2,1,1,1,17102,7.0,18610,217,52,1648,1354,21.7,1710.2
4467390349,0,17,3,1,4,10,4,0,0,0,0,14450,6.4,16178,191,44,-4625,-3193,19.1,1445.0,15,4,0,10,4,11,0,0,0,0,19075,7.2,19371,236,53,4625,3193,23.6,1907.5
4522690017,0,17,4,1,5,9,5,0,0,0,0,14819,6.4,15937,183,46,-3477,-3301,18.3,1481.9,41,5,0,9,5,7,1,1,0,0,18296,7.2,19238,227,58,3477,3301,22.7,1829.6
4424078266,1,15,1,0,6,14,6,0,0,0,0,16205,6.4,16887,196,56,-3622,-1908,19.6,1620.5,15,1,1,14,6,16,2,1,1,0,19827,7.0,18795,224,40,3622,1908,22.4,1982.7
4515934415,0,33,4,0,4,7,5,1,1,0,0,14205,6.4,15571,204,19,-4462,-3453,20.4,1420.5,18,1,1,7,4,7,0,0,0,0,18667,7.0,19024,269,57,4462,3453,26.9,1866.7
4527291288,1,34,1,1,12,4,14,2,1,1,0,18723,7.2,18851,190,59,2246,1265,19.0,1872.3,12,1,0,4,12,5,0,0,0,0,16477,6.8,17586,227,45,-2246,-1265,22.7,1647.7
4501451685,1,14,4,0,5,8,7,2,1,1,0,16256,7.0,17637,231,56,-1623,-1144,23.1,1625.6,14,0,1,8,5,9,0,0,0,0,17879,7.0,18781,243,48,1623,1144,24.3,1787.9
4515397290,1,21,1,0,5,10,8,1,1,0,0,16408,7.0,18014,228,42,-2936,-1305,22.8,1640.8,18,2,1,10,5,17,0,0,0,0,19344,7.0,19319,232,68,2936,1305,23.2,1934.4
4523122447,1,16,4,1,4,3,3,1,1,0,0,15791,7.0,17326,224,56,960,-812,22.4,1579.1,16,4,0,3,4,5,0,0,0,0,14831,7.0,18138,223,49,-960,812,22.3,1483.1
4508460252,1,16,3,0,3,4,3,0,0,0,0,15496,7.0,17876,214,52,-1406,-1328,21.4,1549.6,56,2,1,4,3,5,2,1,1,0,16902,7.2,19204,234,68,1406,1328,23.4,1690.2
4518287583,0,17,1,0,4,9,4,0,0,0,0,16184,6.8,17808,239,68,-1620,-720,23.9,1618.4,15,4,1,9,4,8,0,0,0,0,17804,7.2,18528,218,52,1620,720,21.8,1780.4
4484094550,0,17,5,0,2,6,5,1,1,0,0,14697,6.8,17577,230,56,-1769,-587,23.0,1469.7,18,5,1,6,2,6,0,0,0,0,16466,7.0,18164,254,40,1769,587,25.4,1646.6
4463141174,0,16,5,1,4,2,2,1,0,1,0,15447,6.6,16928,217,52,580,-1033,21.7,1544.7,20,4,0,2,4,2,1,1,0,0,14867,6.8,17961,228,64,-580,1033,22.8,1486.7
4470382093,0,16,4,1,6,8,5,0,0,0,0,16625,7.2,18202,226,48,-810,-730,22.6,1662.5,17,4,0,8,6,9,0,0,0,0,17435,7.4,18932,234,48,810,730,23.4,1743.5
4510349153,0,13,0,0,5,8,3,0,0,0,0,15817,7.2,18561,212,64,-2378,-478,21.2,1581.7,17,2,1,8,5,10,1,1,0,0,18195,7.2,19039,226,68,2378,478,22.6,1819.5
4434247820,1,15,2,0,10,10,7,0,0,0,0,17047,7.2,18719,202,40,-1518,-1106,20.2,1704.7,18,2,1,10,10,5,1,1,0,0,18565,7.4,19825,256,47,1518,1106,25.6,1856.5
4506599171,1,138,2,1,10,6,5,1,1,0,0,16929,7.2,19809,222,51,580,2959,22.2,1692.9,14,1,0,6,10,11,0,0,0,0,16349,6.8,16850,192,43,-580,-2959,19.2,1634.9
4454291477,1,15,0,0,5,10,1,0,0,0,0,15605,7.0,19324,216,58,-2048,-29,21.6,1560.5,12,0,1,10,5,13,1,1,0,0,17653,7.4,19353,221,52,2048,29,22.1,1765.3
4525572602,0,13,2,0,3,4,3,0,0,0,0,15043,6.8,17669,203,69,-635,202,20.3,1504.3,16,1,1,4,3,3,1,1,0,0,15678,6.8,17467,242,40,635,-202,24.2,1567.8
4524895124,1,16,3,0,12,9,15,0,0,0,0,18106,6.6,16668,186,48,862,-442,18.6,1810.6,17,4,1,9,12,11,1,1,0,0,17244,6.8,17110,204,48,-862,442,20.4,1724.4
4522201208,0,35,1,0,5,3,5,1,0,1,1,17854,7.4,20383,230,56,2323,2120,23.0,1785.4,13,1,1,3,5,2,0,0,0,0,15531,7.0,18263,219,52,-2323,-2120,21.9,1553.1
4477238060,1,29,10,1,13,2,18,1,0,1,2,22212,7.4,19473,257,40,8977,5411,25.7,2221.2,61,1,0,2,13,3,0,0,0,0,13235,6.0,14062,161,52,-8977,-5411,16.1,1323.5
4493888202,1,11,3,1,13,3,13,1,0,1,1,19940,7.4,20030,192,52,5521,4435,19.2,1994.0,15,4,0,3,13,2,0,0,0,0,14419,6.6,15595,212,31,-5521,-4435,21.2,1441.9
4496656923,1,22,5,1,13,3,21,0,0,0,0,20387,7.0,18610,232,35,5680,2175,23.2,2038.7,18,4,0,3,13,4,1,1,0,0,14707,6.4,16435,196,48,-5680,-2175,19.6,1470.7
4426241259,1,15,4,1,9,3,17,1,1,0,0,17478,7.2,18671,257,47,1071,107,25.7,1747.8,15,2,0,3,9,1,1,0,1,0,16407,7.0,18564,274,60,-1071,-107,27.4,1640.7
4509595307,0,38,4,0,2,5,2,0,0,0,0,13889,6.8,16733,193,57,-1656,-453,19.3,1388.9,13,3,1,5,2,8,1,1,0,0,15545,6.6,17186,229,44,1656,453,22.9,1554.5
4456942619,1,23,4,1,9,7,7,0,0,0,0,18351,7.0,19205,222,57,2556,3518,22.2,1835.1,19,3,0,7,9,11,1,1,0,0,15795,6.6,15687,170,53,-2556,-3518,17.0,1579.5
4525114135,0,12,5,0,6,4,8,1,1,0,0,16855,7.0,18370,248,44,1265,1248,24.8,1685.5,16,5,1,4,6,4,1,0,1,0,15590,6.8,17122,207,52,-1265,-1248,20.7,1559.0
4475328452,1,13,4,0,11,7,10,1,1,0,0,18582,6.8,18084,207,36,2419,1118,20.7,1858.2,17,2,1,7,11,8,0,0,0,0,16163,7.0,16966,193,52,-2419,-1118,19.3,1616.3
4500139038,1,22,2,1,9,11,16,0,0,0,0,18398,6.8,17918,202,47,1235,-270,20.2,1839.8,44,4,0,11,9,15,1,1,0,0,17163,7.0,18188,197,48,-1235,270,19.7,1716.3
4473131351,1,15,4,1,8,8,6,1,1,0,0,17928,6.8,17767,217,45,1250,297,21.7,1792.8,17,6,0,8,8,13,0,0,0,0,16678,6.8,17470,192,38,-1250,-297,19.2,1667.8
4499921176,0,9,2,1,5,15,5,0,0,0,0,14689,6.0,14871,168,36,-7206,-6046,16.8,1468.9,16,1,0,15,5,10,1,1,0,0,21895,7.4,20917,279,58,7206,6046,27.9,2189.5
4494864543,0,18,2,0,8,5,6,0,0,0,0,16237,6.8,17830,209,48,335,675,20.9,1623.7,16,1,1,5,8,5,1,1,0,0,15902,6.8,17155,192,64,-335,-675,19.2,1590.2
4461019811,1,11,2,1,8,6,7,1,1,0,0,17135,7.6,19855,216,60,1247,2354,21.6,1713.5,14,0,0,6,8,9,0,0,0,0,15888,6.8,17501,196,42,-1247,-2354,19.6,1588.8
4450023077,1,19,4,1,4,7,4,0,0,0,0,15407,6.6,16669,223,40,-1207,-2081,22.3,1540.7,19,2,0,7,4,4,0,0,0,0,16614,7.4,18750,226,60,1207,2081,22.6,1661.4
4495935822,1,20,4,0,7,5,8,0,0,0,0,16747,6.8,18344,198,40,1058,1735,19.8,1674.7,19,8,1,5,7,9,1,1,0,0,15689,6.6,16609,198,46,-1058,-1735,19.8,1568.9
4441631647,0,17,4,1,3,7,3,1,1,0,0,14900,7.0,18354,214,60,-1966,263,21.4,1490.0,19,5,0,7,3,7,0,0,0,0,16866,7.2,18091,214,54,1966,-263,21.4,1686.6
4526149121,0,13,2,0,1,6,1,1,1,0,0,14289,6.8,16754,220,56,-2946,-2952,22.0,1428.9,17,1,1,6,1,7,0,0,0,0,17235,7.2,19706,223,67,2946,2952,22.3,1723.5
4515850930,0,18,4,1,5,5,7,0,0,0,0,16524,7.0,18962,245,59,96,-21,24.5,1652.4,22,2,0,5,5,6,2,1,1,0,16428,7.0,18983,257,56,-96,21,25.7,1642.8
4431143877,0,17,3,0,1,6,2,0,0,0,0,13731,6.6,16666,218,44,-3864,-2759,21.8,1373.1,24,4,1,6,1,10,1,1,0,0,17595,7.2,19425,263,48,3864,2759,26.3,1759.5
4381127762,1,17,1,1,12,3,11,1,1,0,0,18722,7.2,18618,212,57,4246,3880,21.2,1872.2,46,2,0,3,12,6,0,0,0,0,14476,6.0,14738,176,44,-4246,-3880,17.6,1447.6
4509682522,1,13,1,0,2,6,1,0,0,0,0,14804,7.0,17613,239,44,-1645,-1076,23.9,1480.4,28,1,1,6,2,7,1,1,0,0,16449,6.8,18689,245,47,1645,1076,24.5,1644.9
4511494997,0,18,5,0,2,5,2,0,0,0,0,14415,6.8,17248,215,49,-1674,-772,21.5,1441.5,19,5,1,5,2,6,1,1,0,0,16089,6.8,18020,246,44,1674,772,24.6,1608.9
4525379386,0,15,3,0,5,7,3,1,1,0,0,14765,6.8,16480,189,38,-2108,-1510,18.9,1476.5,16,1,1,7,5,8,0,0,0,0,16873,7.4,17990,212,66,2108,1510,21.2,1687.3
4525058133,1,13,6,0,12,8,17,1,1,0,0,19198,6.6,17559,199,46,3024,2225,19.9,1919.8,50,2,1,8,12,15,0,0,0,0,16174,6.4,15334,176,34,-3024,-2225,17.6,1617.4
4497520104,1,141,2,0,6,6,6,0,0,0,0,16830,7.0,18944,226,51,708,1208,22.6,1683.0,18,2,1,6,6,4,2,1,1,0,16122,6.8,17736,204,54,-708,-1208,20.4,1612.2
4462936541,0,14,4,0,9,11,7,0,0,0,0,17137,7.0,18112,188,46,-1730,24,18.8,1713.7,12,4,1,11,9,11,2,1,1,0,18867,7.0,18088,211,40,1730,-24,21.1,1886.7
4500210333,1,17,11,1,10,1,13,1,1,0,0,19602,7.4,20259,236,57,5238,2654,23.6,1960.2,67,0,0,1,10,2,0,0,0,0,14364,6.8,17605,209,76,-5238,-2654,20.9,1436.4
4517997197,1,16,1,1,5,7,7,0,0,0,0,15485,6.6,16891,201,46,-215,-546,20.1,1548.5,12,2,0,7,5,8,2,1,1,0,15700,6.8,17437,170,56,215,546,17.0,1570.0
4520683892,1,18,2,1,7,3,9,0,0,0,0,16981,7.2,19106,232,46,2483,2299,23.2,1698.1,45,1,0,3,7,3,1,1,0,0,14498,6.6,16807,190,52,-2483,-2299,19.0,1449.8
4523011787,1,14,2,1,10,5,12,1,1,0,0,18936,7.2,19738,253,51,4798,5096,25.3,1893.6,19,0,0,5,10,5,0,0,0,0,14138,6.0,14642,176,36,-4798,-5096,17.6,1413.8
4520676421,1,46,3,1,11,1,13,0,0,0,0,18761,7.2,19378,230,62,4172,1918,23.0,1876.1,14,2,0,1,11,1,0,0,0,0,14589,6.8,17460,259,47,-4172,-1918,25.9,1458.9
4526390951,0,12,1,0,2,9,2,0,0,0,0,14606,6.8,17633,200,71,-3513,-1630,20.0,1460.6,14,0,1,9,2,6,1,1,0,0,18119,7.4,19263,221,60,3513,1630,22.1,1811.9
4459332063,1,16,1,1,5,3,6,0,0,0,0,15721,6.6,17087,210,48,435,-1039,21.0,1572.1,17,1,0,3,5,3,0,0,0,0,15286,6.8,18126,229,55,-435,1039,22.9,1528.6
4523035585,1,25,3,0,5,7,2,0,0,0,0,14877,7.0,17258,205,44,-1550,-1018,20.5,1487.7,15,0,1,7,5,8,0,0,0,0,16427,7.0,18276,211,55,1550,1018,21.1,1642.7
4511485561,1,19,4,1,8,4,13,1,1,0,0,16712,6.8,17797,194,48,2357,1436,19.4,1671.2,54,3,0,4,8,3,0,0,0,0,14355,6.4,16361,162,52,-2357,-1436,16.2,1435.5
4520555192,0,40,1,0,2,9,1,1,1,0,0,14478,6.6,16901,237,48,-3613,-1592,23.7,1447.8,13,2,1,9,2,9,0,0,0,0,18091,7.0,18493,232,52,3613,1592,23.2,1809.1
4478851692,0,13,3,0,4,7,5,0,0,0,0,15614,7.0,17578,241,53,-816,172,24.1,1561.4,32,3,1,7,4,9,1,1,0,0,16430,6.8,17406,234,38,816,-172,23.4,1643.0
4517959994,1,16,1,0,4,6,6,0,0,0,0,16040,7.0,17545,214,64,109,66,21.4,1604.0,16,3,1,6,4,6,1,1,0,0,15931,6.8,17479,221,40,-109,-66,22.1,1593.1
4506306158,1,17,7,0,9,5,15,0,0,0,0,17965,7.0,18483,210,63,2584,2273,21.0,1796.5,19,3,1,5,9,5,0,0,0,0,15381,6.4,16210,220,36,-2584,-2273,22.0,1538.1
4484490025,0,16,1,0,5,12,6,0,0,0,0,15782,6.4,16172,195,44,-2707,-2136,19.5,1578.2,19,3,1,12,5,10,1,1,0,0,18489,7.0,18308,233,40,2707,2136,23.3,1848.9
4461216989,1,37,4,1,8,4,12,0,0,0,0,18340,7.2,18170,250,56,3206,1437,25.0,1834.0,19,3,0,4,8,7,0,0,0,0,15134,6.6,16733,180,63,-3206,-1437,18.0,1513.4
4525239262,0,13,1,1,7,7,8,0,0,0,0,17181,6.8,18170,231,51,267,162,23.1,1718.1,17,1,0,7,7,9,2,1,1,0,16914,6.8,18008,220,56,-267,-162,22.0,1691.4
4465280441,0,76,2,0,10,9,13,0,0,0,0,18695,7.2,18459,225,48,601,152,22.5,1869.5,47,2,1,9,10,9,0,0,0,0,18094,7.0,18307,199,52,-601,-152,19.9,1809.4
4519229802,0,21,5,0,3,8,1,0,0,0,0,14269,6.6,16844,200,48,-3145,-2166,20.0,1426.9,19,5,1,8,3,10,1,1,0,0,17414,7.2,19010,235,53,3145,2166,23.5,1741.4
4482138912,1,19,2,1,9,7,19,0,0,0,0,19092,7.2,19183,226,44,2035,1188,22.6,1909.2,18,2,0,7,9,8,1,1,0,0,17057,7.0,17995,214,56,-2035,-1188,21.4,1705.7
4505511340,0,16,6,1,10,9,10,0,0,0,0,17818,6.8,17651,204,41,-1272,-1634,20.4,1781.8,45,9,0,9,10,9,0,0,0,0,19090,7.2,19285,258,36,1272,1634,25.8,1909.0
4484501357,0,17,3,0,1,5,3,0,0,0,0,14463,6.8,18394,224,68,-2820,-1048,22.4,1446.3,18,2,1,5,1,8,1,1,0,0,17283,7.4,19442,258,68,2820,1048,25.8,1728.3
4524113252,0,20,1,1,7,11,7,0,0,0,0,16171,6.4,16252,166,52,-2171,-2897,16.6,1617.1,21,5,0,11,7,13,1,1,0,0,18342,7.0,19149,220,43,2171,2897,22.0,1834.2
4522069049,0,13,0,0,2,4,1,1,0,1,0,15448,7.0,18033,215,63,209,1023,21.5,1544.8,49,3,1,4,2,4,0,0,0,0,15239,6.8,17010,224,43,-209,-1023,22.4,1523.9
4509888379,1,23,1,0,8,5,8,1,1,0,0,16259,6.8,16785,171,59,656,-718,17.1,1625.9,19,2,1,5,8,3,1,0,1,0,15603,6.8,17503,230,48,-656,718,23.0,1560.3
4523444869,0,16,0,1,5,3,6,0,0,0,0,15840,6.8,17440,211,52,923,828,21.1,1584.0,17,3,0,3,5,4,1,1,0,0,14917,6.4,16612,235,46,-923,-828,23.5,1491.7
4524907104,0,35,2,0,4,7,6,2,1,1,0,16234,7.0,18544,218,58,-449,-83,21.8,1623.4,19,1,1,7,4,5,0,0,0,0,16683,7.2,18627,202,60,449,83,20.2,1668.3
4516897705,0,16,4,1,7,5,6,1,0,1,0,17182,7.2,18530,243,50,946,357,24.3,1718.2,76,2,0,5,7,5,1,1,0,0,16236,7.0,18173,228,66,-946,-357,22.8,1623.6
4467191022,0,21,4,1,3,6,4,1,1,0,0,15026,6.4,16386,202,52,-2243,-3667,20.2,1502.6,37,5,0,6,3,8,0,0,0,0,17269,7.6,20053,229,75,2243,3667,22.9,1726.9
4518398383,0,13,2,1,11,4,4,1,1,0,0,18232,7.4,19347,231,55,3987,3310,23.1,1823.2,12,1,0,4,11,3,0,0,0,0,14245,6.4,16037,168,40,-3987,-3310,16.8,1424.5
4512774492,1,50,4,1,6,4,8,2,1,1,0,16248,6.8,17200,200,52,1463,1490,20.0,1624.8,48,2,0,4,6,8,0,0,0,0,14785,6.6,15710,169,52,-1463,-1490,16.9,1478.5
4503041917,1,16,1,0,2,9,3,0,0,0,0,14269,6.4,15867,203,41,-3941,-3623,20.3,1426.9,12,4,1,9,2,9,1,1,0,0,18210,7.2,19490,239,46,3941,3623,23.9,1821.0
4480198184,0,18,1,0,6,10,9,0,0,0,0,16853,7.0,18059,225,44,-1590,-1867,22.5,1685.3,12,2,1,10,6,9,1,1,0,0,18443,7.2,19926,242,55,1590,1867,24.2,1844.3
4514809732,0,51,2,0,3,5,4,0,0,0,0,13952,6.2,15665,172,47,-3559,-2812,17.2,1395.2,125,3,1,5,3,3,2,1,1,1,17511,7.0,18477,230,57,3559,2812,23.0,1751.1
4378269284,1,13,2,1,16,4,17,1,1,0,1,19651,7.0,18318,200,36,5195,2289,20.0,1965.1,11,1,0,4,16,3,0,0,0,0,14456,6.4,16029,179,52,-5195,-2289,17.9,1445.6
4486544471,1,12,2,0,10,9,10,0,0,0,0,17706,6.8,17870,212,48,578,144,21.2,1770.6,11,1,1,9,10,6,0,0,0,0,17128,7.0,17726,204,38,-578,-144,20.4,1712.8
4508436860,1,40,2,1,10,2,14,1,1,0,0,17618,7.0,18556,203,36,4373,4286,20.3,1761.8,13,4,0,2,10,3,0,0,0,0,13245,6.0,14270,184,24,-4373,-4286,18.4,1324.5
4484723064,0,51,2,0,5,7,7,0,0,0,0,15175,6.4,16256,170,60,-1243,-1229,17.0,1517.5,18,0,1,7,5,6,1,1,0,0,16418,6.8,17485,219,37,1243,1229,21.9,1641.8
4520672989,1,15,2,1,10,7,8,1,1,0,0,18468,7.2,18822,221,51,1142,283,22.1,1846.8,18,3,0,7,10,6,0,0,0,0,17326,7.2,18539,252,40,-1142,-283,25.2,1732.6
4486323074,1,16,3,1,5,7,7,2,1,1,1,18334,7.4,19247,231,70,1111,26,23.1,1833.4,18,4,0,7,5,7,0,0,0,0,17223,7.4,19221,240,56,-1111,-26,24.0,1722.3
4462178191,1,19,2,1,7,0,9,1,1,0,1,18745,7.0,18917,259,48,4783,2851,25.9,1874.5,12,1,0,0,7,0,1,0,1,0,13962,6.4,16066,217,64,-4783,-2851,21.7,1396.2
4500208615,0,18,3,0,6,6,4,0,0,0,0,15789,6.6,17312,230,35,-966,-901,23.0,1578.9,15,3,1,6,6,5,1,1,0,0,16755,7.0,18213,231,48,966,901,23.1,1675.5
4516851869,0,13,3,1,2,9,0,1,1,0,0,13803,6.6,16366,203,55,-4410,-4163,20.3,1380.3,12,1,0,9,2,3,1,0,1,0,18213,7.4,20529,236,72,4410,4163,23.6,1821.3
4470635951,1,15,3,1,9,5,15,0,0,0,0,18721,7.2,19444,240,48,2411,1852,24.0,1872.1,14,4,0,5,9,6,1,1,0,0,16310,6.8,17592,219,58,-2411,-1852,21.9,1631.0
4526845553,1,35,4,0,6,7,4,1,0,1,0,16150,6.8,18167,213,57,-830,-448,21.3,1615.0,14,1,1,7,6,5,0,0,0,0,16980,7.0,18615,226,52,830,448,22.6,1698.0
4518416008,1,19,2,0,5,9,6,0,0,0,0,16032,6.8,17171,220,45,-2222,-1252,22.0,1603.2,15,1,1,9,5,10,1,1,0,0,18254,7.0,18423,225,40,2222,1252,22.5,1825.4
4526769239,0,78,2,0,6,6,7,1,1,0,1,18084,7.2,19140,228,48,2139,547,22.8,1808.4,13,2,1,6,6,5,1,0,1,0,15945,7.0,18593,201,59,-2139,-547,20.1,1594.5
4525341772,0,17,4,0,8,7,9,1,1,0,0,16786,7.2,19026,244,42,-117,815,24.4,1678.6,16,6,1,7,8,13,1,0,1,0,16903,6.8,18211,223,60,117,-815,22.3,1690.3
4526316157,0,11,2,0,4,13,3,0,0,0,0,14539,6.6,16271,165,53,-6139,-4548,16.5,1453.9,58,3,1,13,4,12,0,0,0,0,20678,7.6,20819,224,50,6139,4548,22.4,2067.8
4524841427,0,16,2,1,9,8,12,1,0,1,0,16649,6.2,15616,166,36,-1152,-2193,16.6,1664.9,19,2,0,8,9,8,1,1,0,0,17801,6.8,17809,208,48,1152,2193,20.8,1780.1
4499631955,0,17,1,0,8,9,7,0,0,0,0,16397,7.0,18004,183,45,-1253,933,18.3,1639.7,20,2,1,9,8,9,0,0,0,0,17650,6.6,17071,199,47,1253,-933,19.9,1765.0
4496724887,1,23,5,1,8,2,13,1,1,0,0,17575,7.2,18579,228,52,2658,1915,22.8,1757.5,18,3,0,2,8,2,0,0,0,0,14917,6.6,16664,211,50,-2658,-1915,21.1,1491.7
4498660251,1,16,3,0,8,6,7,1,1,0,0,17104,7.0,18350,223,64,-111,1062,22.3,1710.4,36,2,1,6,8,8,1,0,1,1,17215,6.8,17288,201,48,111,-1062,20.1,1721.5
4460755163,1,15,2,0,5,7,5,0,0,0,0,16005,6.8,17737,218,55,-1313,-1424,21.8,1600.5,35,0,1,7,5,8,0,0,0,0,17318,7.0,19161,239,52,1313,1424,23.9,1731.8
4494818793,0,16,2,0,6,8,3,0,0,0,0,15334,6.4,16172,203,44,-1343,-768,20.3,1533.4,21,3,1,8,6,5,1,1,0,0,16677,6.6,16940,204,36,1343,768,20.4,1667.7
4510821185,0,19,5,0,6,6,4,0,0,0,0,16839,7.0,18230,222,57,468,370,22.2,1683.9,19,3,1,6,6,8,1,1,0,0,16371,6.8,17860,211,58,-468,-370,21.1,1637.1
4426118717,0,18,5,1,8,3,14,1,1,0,0,17160,7.0,17725,191,66,2841,1484,19.1,1716.0,18,3,0,3,8,1,0,0,0,0,14319,6.6,16241,208,57,-2841,-1484,20.8,1431.9
4439533081,0,14,1,0,4,4,6,1,0,1,0,16180,6.8,17769,217,56,1338,1039,21.7,1618.0,15,3,1,4,4,3,0,0,0,0,14842,6.6,16730,216,47,-1338,-1039,21.6,1484.2
4521413190,1,15,5,0,7,3,4,1,1,0,0,16616,7.2,19895,246,43,958,2603,24.6,1661.6,20,0,1,3,7,5,0,0,0,0,15658,6.8,17292,229,48,-958,-2603,22.9,1565.8
4522690291,1,12,1,1,7,5,7,1,0,1,0,16426,6.8,17766,187,46,846,-1893,18.7,1642.6,13,2,0,5,7,0,1,1,0,0,15580,7.4,19659,231,61,-846,1893,23.1,1558.0
4513906148,1,20,3,1,10,2,12,1,1,0,0,19035,7.4,19265,239,60,5465,3492,23.9,1903.5,33,1,0,2,10,2,0,0,0,0,13570,6.4,15773,190,32,-5465,-3492,19.0,1357.0
4458122797,1,14,2,1,7,2,10,0,0,0,0,17130,7.0,18124,226,47,1931,1567,22.6,1713.0,16,2,0,2,7,4,0,0,0,0,15199,6.8,16557,219,52,-1931,-1567,21.9,1519.9
4523036176,0,20,7,0,9,8,11,1,1,0,0,18304,7.2,19032,237,42,1606,1036,23.7,1830.4,86,4,1,8,9,9,1,0,1,0,16698,7.0,17996,198,41,-1606,-1036,19.8,1669.8
4506462868,1,23,3,0,4,6,5,0,0,0,0,15364,7.0,18063,210,51,-946,630,21.0,1536.4,19,4,1,6,4,8,1,1,0,0,16310,6.8,17433,229,40,946,-630,22.9,1631.0
4515658862,0,36,5,0,2,7,2,1,0,1,0,15279,7.0,18355,236,59,-1526,-1082,23.6,1527.9,14,6,1,7,2,10,1,1,0,0,16805,7.4,19437,236,40,1526,1082,23.6,1680.5
4452414330,1,11,2,1,7,8,4,0,0,0,0,17226,7.0,19315,226,58,-193,548,22.6,1722.6,18,3,0,8,7,7,1,1,0,0,17419,7.2,18767,223,48,193,-548,22.3,1741.9
4524557404,0,16,2,0,4,9,4,0,0,0,0,15608,6.6,16536,197,50,-1690,-2943,19.7,1560.8,37,4,1,9,4,8,0,0,0,0,17298,7.2,19479,220,54,1690,2943,22.0,1729.8
4509771893,1,14,1,0,6,6,8,0,0,0,0,16433,7.0,18215,229,52,-350,49,22.9,1643.3,16,2,1,6,6,4,0,0,0,0,16783,7.0,18166,224,43,350,-49,22.4,1678.3
4483304287,1,92,3,0,6,4,7,1,1,0,0,16541,7.0,19056,249,44,1294,1165,24.9,1654.1,13,1,1,4,6,6,0,0,0,0,15247,7.0,17891,211,50,-1294,-1165,21.1,1524.7
4508714816,0,15,0,0,2,6,1,0,0,0,0,14990,6.8,17870,221,69,-1510,-1756,22.1,1499.0,13,1,1,6,2,9,1,1,0,0,16500,7.4,19626,228,56,1510,1756,22.8,1650.0
4511773311,1,12,1,0,2,3,2,1,1,0,0,13879,6.6,16393,194,44,-1499,-1628,19.4,1387.9,17,5,1,3,2,1,0,0,0,0,15378,7.0,18021,226,40,1499,1628,22.6,1537.8
4454438289,1,15,1,1,8,10,15,1,1,0,0,17231,7.0,17898,193,59,-1471,-1810,19.3,1723.1,16,5,0,10,8,11,0,0,0,0,18702,7.2,19708,213,52,1471,1810,21.3,1870.2
4523342801,1,41,1,0,2,3,1,1,1,0,0,14756,7.2,18676,237,64,-1318,132,23.7,1475.6,17,5,1,3,2,5,0,0,0,0,16074,6.8,18544,266,38,1318,-132,26.6,1607.4
4522215186,0,19,4,1,3,6,3,1,0,1,0,15417,6.8,16990,224,56,-691,-666,22.4,1541.7,17,4,0,6,3,11,1,1,0,0,16108,6.8,17656,213,48,691,666,21.3,1610.8
4502626777,1,18,2,1,11,4,9,1,1,0,0,18438,7.2,18924,212,60,3742,3229,21.2,1843.8,17,2,0,4,11,6,0,0,0,0,14696,6.2,15695,184,56,-3742,-3229,18.4,1469.6
4463171259,0,14,3,0,7,10,4,2,1,1,1,17023,6.4,16951,201,44,-1148,-2197,20.1,1702.3,18,1,1,10,7,8,0,0,0,0,18171,7.2,19148,226,43,1148,2197,22.6,1817.1
4510961298,0,12,5,0,4,4,7,0,0,0,0,16538,6.8,18285,253,64,239,-305,25.3,1653.8,51,2,1,4,4,6,2,1,1,0,16299,7.2,18590,243,59,-239,305,24.3,1629.9
4521516098,1,13,3,1,5,3,4,2,1,1,0,15889,7.0,18189,217,52,874,-302,21.7,1588.9,39,2,0,3,5,4,0,0,0,0,15015,7.2,18491,215,52,-874,302,21.5,1501.5
4507966982,0,46,1,0,5,10,7,0,0,0,0,16263,6.8,16732,198,52,-1911,-2325,19.8,1626.3,16,13,1,10,5,7,1,1,0,0,18174,7.2,19057,220,45,1911,2325,22.0,1817.4
4482060310,1,16,0,1,12,7,14,1,1,0,0,19276,7.2,19221,192,49,1801,2218,19.2,1927.6,14,1,0,7,12,8,0,0,0,0,17475,6.8,17003,217,36,-1801,-2218,21.7,1747.5
4481135148,1,17,3,1,9,6,8,1,0,1,1,18758,7.2,18617,228,44,2137,490,22.8,1875.8,15,3,0,6,9,6,0,0,0,0,16621,6.8,18127,234,52,-2137,-490,23.4,1662.1
4509444763,1,17,1,0,3,7,2,0,0,0,0,15632,7.0,18400,232,72,-1822,-1467,23.2,1563.2,16,4,1,7,3,6,2,1,1,0,17454,7.4,19867,244,52,1822,1467,24.4,1745.4
4524400852,1,15,3,1,14,8,14,2,1,1,1,21927,7.4,20604,250,57,5263,3213,25.0,2192.7,22,3,0,8,14,11,0,0,0,0,16664,7.0,17391,174,51,-5263,-3213,17.4,1666.4
4515862927,0,17,5,1,5,9,8,1,0,1,0,14927,6.6,16626,194,44,-3214,-2318,19.4,1492.7,19,3,0,9,5,11,1,1,0,0,18141,7.0,18944,239,39,3214,2318,23.9,1814.1
4511142535,0,21,1,1,5,9,5,0,0,0,0,15555,6.4,15866,200,35,-2286,-3935,20.0,1555.5,16,3,0,9,5,7,1,1,0,0,17841,7.6,19801,220,82,2286,3935,22.0,1784.1
4520670087,0,18,0,0,10,4,6,0,0,0,0,17125,7.0,17861,210,40,1294,453,21.0,1712.5,14,3,1,4,10,3,1,1,0,0,15831,7.0,17408,223,56,-1294,-453,22.3,1583.1
4497764283,0,16,0,1,6,11,5,0,0,0,0,15165,6.6,16025,188,31,-3709,-4015,18.8,1516.5,14,4,0,11,6,8,1,1,0,0,18874,7.2,20040,227,68,3709,4015,22.7,1887.4
4497972211,1,16,4,0,4,3,5,0,0,0,0,15429,7.0,18085,238,41,39,-301,23.8,1542.9,15,3,1,3,4,2,1,1,0,0,15390,7.0,18386,238,60,-39,301,23.8,1539.0
4527623126,1,16,4,1,6,6,3,1,0,1,0,16904,7.2,18744,245,54,406,782,24.5,1690.4,18,3,0,6,6,9,1,1,0,0,16498,6.8,17962,210,58,-406,-782,21.0,1649.8
4455725708,1,13,2,1,12,10,10,1,1,0,0,18913,7.2,19076,183,55,1051,12,18.3,1891.3,13,0,0,10,12,7,0,0,0,0,17862,7.2,19064,209,40,-1051,-12,20.9,1786.2
4524601777,0,16,4,1,6,5,13,0,0,0,0,15859,6.8,16551,209,44,-947,-2043,20.9,1585.9,24,4,0,5,6,6,0,0,0,0,16806,6.8,18594,218,61,947,2043,21.8,1680.6
4520057961,1,17,2,1,6,3,6,1,1,0,0,16498,7.2,18910,233,60,1857,1385,23.3,1649.8,60,1,0,3,6,4,0,0,0,0,14641,7.0,17525,204,60,-1857,-1385,20.4,1464.1
4522651290,1,14,4,0,2,4,1,0,0,0,0,14721,7.0,18073,234,51,-964,72,23.4,1472.1,19,0,1,4,2,4,1,1,0,0,15685,7.0,18001,238,48,964,-72,23.8,1568.5
4518824724,1,14,0,0,3,4,3,0,0,0,0,15190,7.0,18530,231,51,-1449,313,23.1,1519.0,16,3,1,4,3,4,2,1,1,0,16639,7.0,18217,264,48,1449,-313,26.4,1663.9
4515220685,1,19,1,0,6,6,3,0,0,0,0,16780,6.8,18032,244,54,253,-529,24.4,1678.0,19,4,1,6,6,6,2,1,1,0,16527,7.2,18561,222,58,-253,529,22.2,1652.7
4516748308,1,15,1,1,8,6,4,0,0,0,1,17706,6.8,18003,194,40,1893,763,19.4,1770.6,16,1,0,6,8,7,1,1,0,0,15813,6.6,17240,193,44,-1893,-763,19.3,1581.3
4479907998,0,44,1,1,7,4,6,1,1,0,0,16375,7.0,18026,172,62,143,713,17.2,1637.5,16,2,0,4,7,3,1,0,1,0,16232,6.6,17313,217,54,-143,-713,21.7,1623.2
4444371751,0,18,0,1,5,9,2,1,1,0,0,13945,5.8,14302,155,56,-5763,-4731,15.5,1394.5,14,2,0,9,5,11,1,0,1,2,19708,7.4,19033,203,60,5763,4731,20.3,1970.8
4452787695,1,17,4,1,2,2,3,2,1,1,0,15290,7.0,17983,253,47,-9,-307,25.3,1529.0,19,1,0,2,2,2,0,0,0,0,15299,7.0,18290,243,58,9,307,24.3,1529.9
4502625560,1,14,2,1,8,7,7,1,1,0,0,17472,7.2,18967,224,52,1177,763,22.4,1747.2,14,2,0,7,8,7,0,0,0,0,16295,7.2,18204,183,68,-1177,-763,18.3,1629.5
4464785685,1,18,2,1,6,2,5,1,1,0,0,18121,7.4,19941,257,68,3713,3023,25.7,1812.1,21,5,0,2,6,1,1,0,1,0,14408,6.6,16918,241,40,-3713,-3023,24.1,1440.8
4467932600,1,17,1,1,9,4,5,1,1,0,0,18135,7.2,18974,233,48,2649,1251,23.3,1813.5,17,2,0,4,9,3,0,0,0,0,15486,6.8,17723,219,52,-2649,-1251,21.9,1548.6
4522236632,1,18,3,0,5,7,3,1,1,0,0,16535,7.2,19103,206,80,956,2176,20.6,1653.5,16,6,1,7,5,5,0,0,0,0,15579,6.6,16927,197,48,-956,-2176,19.7,1557.9
4498726341,1,18,3,1,12,5,6,0,0,0,0,18967,7.6,19855,240,48,3595,2595,24.0,1896.7,13,1,0,5,12,3,1,1,0,0,15372,6.8,17260,217,56,-3595,-2595,21.7,1537.2
4524773384,1,18,0,0,7,7,10,1,1,0,0,16585,6.8,16982,191,42,-536,-864,19.1,1658.5,17,1,1,7,7,9,0,0,0,0,17121,6.8,17846,234,52,536,864,23.4,1712.1
4499811143,1,15,0,1,9,3,9,0,0,0,1,20026,7.2,19142,246,51,6773,5215,24.6,2002.6,82,2,0,3,9,4,1,1,0,0,13253,6.2,13927,148,32,-6773,-5215,14.8,1325.3
4492591291,0,29,3,0,4,12,3,0,0,0,0,15036,6.4,15796,194,52,-2568,-3931,19.4,1503.6,39,2,1,12,4,8,0,0,0,0,17604,7.4,19727,198,57,2568,3931,19.8,1760.4
4522630339,0,17,1,1,3,5,3,0,0,0,0,15699,6.8,17479,226,49,-907,-1650,22.6,1569.9,15,3,0,5,3,6,1,1,0,0,16606,7.4,19129,244,55,907,1650,24.4,1660.6
4505468000,0,15,2,0,4,7,4,0,0,0,0,15624,6.8,18203,229,58,-1647,-1866,22.9,1562.4,14,8,1,7,4,7,1,1,0,0,17271,7.4,20069,243,58,1647,1866,24.3,1727.1
4520714829,0,16,7,1,6,7,9,0,0,0,0,16778,7.2,17640,218,60,-1446,-965,21.8,1677.8,21,2,0,7,6,10,2,1,1,1,18224,7.0,18605,234,39,1446,965,23.4,1822.4
4520027205,0,15,0,1,5,8,4,0,0,0,0,15975,6.8,18165,227,56,-1963,-1151,22.7,1597.5,15,1,0,8,5,10,1,1,0,0,17938,7.2,19316,225,52,1963,1151,22.5,1793.8
4519214985,1,17,3,0,8,7,14,0,0,0,0,17261,6.8,17685,219,44,-112,-198,21.9,1726.1,12,2,1,7,8,8,1,1,0,0,17373,7.0,17883,221,52,112,198,22.1,1737.3
4459818225,0,15,4,0,3,1,5,1,1,0,0,15544,7.0,18418,236,64,-590,558,23.6,1554.4,17,2,1,1,3,1,1,0,1,1,16134,6.8,17860,228,52,590,-558,22.8,1613.4
4509854738,1,16,1,1,7,4,8,1,1,0,0,16351,6.8,17063,171,55,1487,1143,17.1,1635.1,15,0,0,4,7,2,0,0,0,0,14864,6.4,15920,224,28,-1487,-1143,22.4,1486.4
4518232196,0,16,2,0,3,7,2,0,0,0,0,15189,6.8,18569,217,67,-1527,-457,21.7,1518.9,37,3,1,7,3,9,1,1,0,0,16716,7.2,19026,224,44,1527,457,22.4,1671.6
4526802762,0,20,2,0,1,11,2,0,0,0,0,13177,6.2,15610,177,48,-7314,-6034,17.7,1317.7,21,6,1,11,1,13,1,1,0,0,20491,7.8,21644,258,68,7314,6034,25.8,2049.1
4487385988,1,56,2,0,6,2,9,1,1,0,0,16751,7.0,18674,239,42,832,551,23.9,1675.1,17,2,1,2,6,2,0,0,0,0,15919,6.8,18123,225,69,-832,-551,22.5,1591.9
4509977321,0,12,4,0,2,5,1,0,0,0,0,14349,7.0,17864,199,62,-2289,-277,19.9,1434.9,20,1,1,5,2,4,1,1,0,0,16638,7.2,18141,246,57,2289,277,24.6,1663.8
4524900733,1,16,1,0,6,9,3,1,1,0,0,15704,6.6,17114,199,52,-1332,-2004,19.9,1570.4,14,6,1,9,6,10,0,0,0,0,17036,7.2,19118,217,40,1332,2004,21.7,1703.6
4527210467,0,42,4,0,1,6,3,1,1,0,0,14261,7.0,17724,198,67,-2160,85,19.8,1426.1,67,4,1,6,1,11,0,0,0,0,16421,6.8,17639,207,39,2160,-85,20.7,1642.1
4514247326,1,18,4,1,5,1,5,0,0,0,0,17114,7.4,19292,253,51,2861,2287,25.3,1711.4,16,3,0,1,5,1,1,1,0,0,14253,6.8,17005,248,51,-2861,-2287,24.8,1425.3
4476285396,0,15,3,1,3,7,2,0,0,0,0,14756,6.6,16229,226,48,-2175,-2386,22.6,1475.6,15,3,0,7,3,9,0,0,0,0,16931,7.2,18615,233,50,2175,2386,23.3,1693.1
4518263954,0,15,1,1,8,3,13,0,0,0,0,18509,7.0,18932,270,36,3602,274,27.0,1850.9,12,3,0,3,8,3,1,1,0,0,14907,7.0,18658,217,62,-3602,-274,21.7,1490.7
4523410225,0,17,0,1,6,5,10,0,0,0,0,16233,7.0,17076,223,38,70,-928,22.3,1623.3,19,2,0,5,6,7,2,1,1,0,16163,7.0,18004,225,76,-70,928,22.5,1616.3
4523286020,0,21,3,1,6,7,4,1,1,0,0,15514,6.8,17211,185,52,-1640,-1839,18.5,1551.4,13,1,0,7,6,8,1,0,1,0,17154,7.2,19050,234,52,1640,1839,23.4,1715.4
4464761847,0,12,19,1,9,5,11,2,1,1,0,17791,7.2,18823,198,61,1090,342,19.8,1779.1,37,4,0,5,9,6,0,0,0,0,16701,6.8,18481,265,44,-1090,-342,26.5,1670.1
4508433875,0,21,2,1,3,9,3,0,0,0,0,14426,6.6,16666,205,42,-3954,-1940,20.5,1442.6,18,7,0,9,3,7,1,1,0,1,18380,7.2,18606,254,56,3954,1940,25.4,1838.0
4520836773,1,14,2,0,5,7,1,1,0,1,0,16864,7.0,19251,240,57,-70,-456,24.0,1686.4,14,0,1,7,5,5,1,1,0,0,16934,7.6,19707,223,65,70,456,22.3,1693.4
4498847348,1,18,2,1,11,3,19,1,1,0,0,18348,7.2,19343,226,60,3294,1808,22.6,1834.8,38,4,0,3,11,3,0,0,0,0,15054,6.8,17535,218,44,-3294,-1808,21.8,1505.4
4516179607,1,17,0,0,8,2,11,1,1,0,0,17499,7.4,18873,217,56,2282,1265,21.7,1749.9,15,1,1,2,8,2,0,0,0,0,15217,7.0,17608,237,56,-2282,-1265,23.7,1521.7
4525067296,1,12,0,1,3,7,2,0,0,0,0,14788,6.6,17345,215,48,-2025,-2448,21.5,1478.8,17,3,0,7,3,6,1,1,0,0,16813,7.2,19793,233,65,2025,2448,23.3,1681.3
4500724232,1,37,3,1,2,2,1,1,0,1,0,14886,6.8,18605,234,55,762,1570,23.4,1488.6,51,3,0,2,2,1,1,1,0,0,14124,6.8,17035,209,44,-762,-1570,20.9,1412.4
4511135816,0,12,3,0,5,5,4,0,0,0,0,16840,7.2,19282,264,53,-103,859,26.4,1684.0,17,2,1,5,5,3,2,1,1,1,16943,7.0,18423,219,48,103,-859,21.9,1694.3
4516971846,0,15,4,0,1,3,2,0,0,0,0,15196,6.8,17168,262,40,52,-934,26.2,1519.6,15,3,1,3,1,2,1,0,1,0,15144,7.0,18102,246,47,-52,934,24.6,1514.4
4523933812,1,19,2,1,6,4,7,1,0,1,0,16940,7.0,17896,244,49,2038,357,24.4,1694.0,12,2,0,4,6,6,0,0,0,0,14902,6.8,17539,198,48,-2038,-357,19.8,1490.2
4526615576,1,14,4,1,3,5,5,0,0,0,0,14788,6.6,16201,223,44,-166,-1446,22.3,1478.8,16,3,0,5,3,3,0,0,0,0,14954,7.0,17647,188,52,166,1446,18.8,1495.4
4497770545,0,17,4,0,4,6,1,0,0,0,0,15519,7.0,18527,255,48,-1149,-217,25.5,1551.9,20,4,1,6,4,7,0,0,0,0,16668,7.2,18744,238,64,1149,217,23.8,1666.8
4434732074,1,19,3,0,2,6,1,1,1,0,0,14107,6.6,17015,180,72,-1699,-364,18.0,1410.7,20,3,1,6,2,10,0,0,0,0,15806,6.8,17379,220,40,1699,364,22.0,1580.6
4523618632,1,15,5,1,6,3,11,1,1,0,0,16389,7.0,17937,241,36,817,-94,24.1,1638.9,38,2,0,3,6,3,0,0,0,0,15572,6.8,18031,229,58,-817,94,22.9,1557.2
4509303236,1,13,2,0,6,6,9,1,1,0,0,16239,7.0,18439,203,52,36,-234,20.3,1623.9,19,3,1,6,6,3,0,0,0,0,16203,7.2,18673,224,50,-36,234,22.4,1620.3
4486211322,0,37,2,0,5,4,4,0,0,0,0,16273,7.2,19371,241,48,1161,2387,24.1,1627.3,14,1,1,4,5,3,1,1,0,0,15112,6.6,16984,224,44,-1161,-2387,22.4,1511.2
4500830976,1,15,18,1,4,2,3,1,1,0,0,15811,7.2,18673,242,52,886,355,24.2,1581.1,42,2,0,2,4,1,0,0,0,0,14925,7.2,18318,236,55,-886,-355,23.6,1492.5
4524635959,0,18,3,0,6,6,6,1,1,0,0,15571,6.8,16898,190,60,-1137,-982,19.0,1557.1,17,1,1,6,6,5,1,0,1,0,16708,7.0,17880,228,52,1137,982,22.8,1670.8
4516158411,0,13,2,0,3,9,3,1,0,1,0,15356,7.2,18213,186,57,-3505,-778,18.6,1535.6,16,2,1,9,3,10,1,1,0,1,18861,7.2,18991,247,36,3505,778,24.7,1886.1
4500529514,0,12,1,0,3,8,3,0,0,0,0,15035,6.4,15909,202,50,-2930,-2300,20.2,1503.5,16,3,1,8,3,9,1,1,0,0,17965,7.0,18209,238,48,2930,2300,23.8,1796.5
4467214068,0,90,8,0,2,10,2,1,0,1,0,14519,6.8,17122,223,40,-3798,-2950,22.3,1451.9,45,5,1,10,2,13,1,1,0,0,18317,7.4,20072,226,64,3798,2950,22.6,1831.7
4482210564,0,14,4,0,7,11,6,0,0,0,0,16749,7.0,17716,192,40,-2233,-1112,19.2,1674.9,17,2,1,11,7,10,1,1,0,0,18982,7.2,18828,215,58,2233,1112,21.5,1898.2
4526740074,1,15,1,1,7,1,6,1,1,0,0,16474,7.0,18843,225,52,2402,2440,22.5,1647.4,10,0,0,1,7,1,0,0,0,0,14072,6.4,16403,206,54,-2402,-2440,20.6,1407.2
4511021907,0,38,5,0,4,8,4,0,0,0,0,15937,7.2,18739,219,50,-2138,-990,21.9,1593.7,15,4,1,8,4,13,1,1,0,0,18075,7.2,19729,254,52,2138,990,25.4,1807.5
4525953112,1,20,3,1,9,2,18,1,1,0,0,17936,7.0,18452,218,48,3350,1590,21.8,1793.6,16,2,0,2,9,2,0,0,0,0,14586,6.8,16862,213,58,-3350,-1590,21.3,1458.6
4515772836,1,15,3,1,8,2,4,1,1,0,0,16466,6.8,18740,205,51,2489,2364,20.5,1646.6,14,2,0,2,8,2,0,0,0,0,13977,6.8,16376,194,50,-2489,-2364,19.4,1397.7
4523434637,1,44,9,1,7,5,8,1,1,0,0,16379,6.8,17323,207,48,377,372,20.7,1637.9,19,6,0,5,7,9,0,0,0,0,16002,6.8,16951,243,44,-377,-372,24.3,1600.2
4521670146,0,50,1,0,5,6,4,0,0,0,0,15620,7.0,17968,214,63,-1083,-127,21.4,1562.0,23,5,1,6,5,10,1,1,0,0,16703,7.0,18095,218,40,1083,127,21.8,1670.3
4508272671,1,14,4,1,9,5,11,1,1,0,0,17120,7.0,17636,163,56,1426,128,16.3,1712.0,18,3,0,5,9,2,0,0,0,0,15694,6.8,17508,207,52,-1426,-128,20.7,1569.4
4510857801,0,14,4,0,8,11,10,0,0,0,0,18452,7.0,17864,241,42,-69,-634,24.1,1845.2,15,5,1,11,8,10,2,1,1,0,18521,7.0,18498,180,60,69,634,18.0,1852.1
4526265417,1,12,2,1,7,2,10,1,1,0,0,18234,7.4,19881,243,64,4651,4293,24.3,1823.4,9,1,0,2,7,2,0,0,0,0,13583,6.2,15588,156,52,-4651,-4293,15.6,1358.3
4490516014,1,16,2,1,6,7,9,1,0,1,0,16512,7.4,18547,207,75,-1314,-1027,20.7,1651.2,39,2,0,7,6,10,1,1,0,0,17826,7.2,19574,246,67,1314,1027,24.6,1782.6
4463456988,1,16,2,0,7,3,4,2,1,1,0,17071,7.2,19347,234,64,1738,2447,23.4,1707.1,16,3,1,3,7,2,0,0,0,0,15333,6.8,16900,226,57,-1738,-2447,22.6,1533.3
4521049898,0,14,0,1,6,9,6,0,0,0,0,15821,6.8,17419,208,43,-3364,-1990,20.8,1582.1,139,2,0,9,6,7,1,0,1,1,19185,7.2,19409,230,49,3364,1990,23.0,1918.5
4510540123,0,32,2,1,8,9,7,1,0,1,0,17258,7.0,18755,214,40,-978,78,21.4,1725.8,12,1,0,9,8,8,1,1,0,0,18236,7.2,18677,207,61,978,-78,20.7,1823.6
4473558954,0,16,1,0,5,5,3,0,0,0,0,15153,7.2,18629,191,51,-809,411,19.1,1515.3,15,1,1,5,5,5,1,1,0,0,15962,7.0,18218,216,44,809,-411,21.6,1596.2
4505709089,0,42,2,0,7,8,8,1,1,0,0,16122,7.0,17866,186,56,-1782,-308,18.6,1612.2,32,4,1,8,7,10,1,0,1,0,17904,7.0,18174,253,41,1782,308,25.3,1790.4
4497647589,1,18,2,1,8,0,6,0,0,0,0,18609,7.2,19904,244,64,5109,3009,24.4,1860.9,14,2,0,0,8,0,1,1,0,0,13500,6.6,16895,216,56,-5109,-3009,21.6,1350.0
4518349357,0,13,2,1,8,8,10,0,0,0,0,17850,7.4,19495,256,54,30,-249,25.6,1785.0,13,1,0,8,8,7,1,1,0,0,17820,7.2,19744,234,68,-30,249,23.4,1782.0
4450459916,0,14,3,1,6,12,7,1,1,0,0,16043,7.0,17409,220,51,-3089,-2946,22.0,1604.3,20,4,0,12,6,12,0,0,0,0,19132,7.6,20355,235,50,3089,2946,23.5,1913.2
4523478644,0,30,5,0,6,8,6,0,0,0,0,15567,6.6,16972,167,47,-1737,-776,16.7,1556.7,25,2,1,8,6,6,1,1,0,0,17304,7.0,17748,245,52,1737,776,24.5,1730.4
4488138739,0,16,4,0,0,5,0,0,0,0,0,14526,6.8,17736,246,64,-2320,-1718,24.6,1452.6,17,1,1,5,0,6,1,1,0,0,16846,7.4,19454,248,60,2320,1718,24.8,1684.6
4522467340,1,19,5,0,6,5,5,0,0,0,0,16391,6.8,17693,222,44,709,946,22.2,1639.1,41,2,1,5,6,6,0,0,0,0,15682,6.8,16747,188,59,-709,-946,18.8,1568.2
4522182395,0,12,1,1,3,2,3,0,0,0,0,15591,7.0,17801,239,42,536,-18,23.9,1559.1,12,1,0,2,3,2,1,0,1,0,15055,7.0,17819,234,50,-536,18,23.4,1505.5
4419275391,0,15,2,0,6,6,5,0,0,0,0,15856,7.0,17723,224,47,-460,60,22.4,1585.6,16,2,1,6,6,7,1,1,0,0,16316,6.8,17663,238,36,460,-60,23.8,1631.6
4519327182,1,14,2,0,9,8,13,0,0,0,0,18808,7.2,19323,244,40,948,292,24.4,1880.8,15,3,1,8,9,10,1,1,0,0,17860,7.0,19031,234,71,-948,-292,23.4,1786.0
4516964938,0,14,5,0,10,11,10,0,0,0,0,17702,6.4,16589,198,44,-1478,-1657,19.8,1770.2,16,2,1,11,10,14,0,0,0,0,19180,6.8,18246,202,52,1478,1657,20.2,1918.0
4526080128,1,17,1,1,11,3,10,0,0,0,0,18092,7.0,18652,213,43,4024,2465,21.3,1809.2,14,1,0,3,11,1,1,1,0,0,14068,6.2,16187,212,40,-4024,-2465,21.2,1406.8
4458639336,0,12,0,0,7,7,2,0,0,0,0,17004,7.2,19168,216,69,341,-352,21.6,1700.4,35,1,1,7,7,4,1,1,0,0,16663,7.2,19520,207,47,-341,352,20.7,1666.3
4467411161,0,18,2,1,9,8,7,1,0,1,1,18490,6.8,16745,215,33,479,-658,21.5,1849.0,15,2,0,8,9,15,1,1,0,0,18011,6.8,17403,230,47,-479,658,23.0,1801.1
4439856081,0,16,2,0,4,11,3,0,0,0,0,15098,6.8,18104,225,55,-3779,-1537,22.5,1509.8,12,2,1,11,4,10,2,1,1,0,18877,7.4,19641,227,42,3779,1537,22.7,1887.7
4470384241,1,16,3,1,10,4,12,1,1,0,0,18945,7.0,18620,234,44,2542,525,23.4,1894.5,13,2,0,4,10,4,0,0,0,0,16403,6.8,18095,231,76,-2542,-525,23.1,1640.3
4519665715,0,15,2,0,8,9,5,0,0,0,0,16355,6.8,17998,198,59,-994,266,19.8,1635.5,16,4,1,9,8,9,1,1,0,0,17349,6.8,17732,202,40,994,-266,20.2,1734.9
4521832077,1,23,1,0,5,5,5,0,0,0,0,16165,7.2,18868,229,52,857,1040,22.9,1616.5,15,4,1,5,5,3,1,1,0,0,15308,7.0,17828,197,56,-857,-1040,19.7,1530.8
4518075871,0,23,7,0,7,6,6,0,0,0,0,16949,7.0,18440,236,61,16,560,23.6,1694.9,22,7,1,6,7,7,2,1,1,0,16933,7.2,17880,232,40,-16,-560,23.2,1693.3
4518384119,1,17,3,0,7,15,11,0,0,0,0,16378,6.4,16097,189,48,-4552,-4208,18.9,1637.8,16,5,1,15,7,20,1,1,0,0,20930,7.4,20305,234,56,4552,4208,23.4,2093.0
4508763924,1,19,4,0,10,12,17,1,1,0,0,17872,7.0,18662,206,68,-2696,70,20.6,1787.2,21,3,1,12,10,17,1,0,1,1,20568,7.2,18592,245,36,2696,-70,24.5,2056.8
4524952365,1,14,6,1,12,8,15,2,1,1,0,19809,7.0,18530,221,52,3574,1210,22.1,1980.9,22,2,0,8,12,11,0,0,0,0,16235,6.8,17320,166,45,-3574,-1210,16.6,1623.5
4507100108,1,17,3,1,4,2,5,1,0,1,0,16559,7.0,17552,216,52,1928,257,21.6,1655.9,12,5,0,2,4,1,1,1,0,0,14631,6.6,17295,248,48,-1928,-257,24.8,1463.1
4506650887,1,14,8,1,9,4,6,1,0,1,1,19279,7.6,19873,230,69,4305,3750,23.0,1927.9,203,1,0,4,9,4,1,1,0,0,14974,6.4,16123,182,42,-4305,-3750,18.2,1497.4
4470217349,1,14,2,1,4,3,4,0,0,0,0,17137,7.4,19582,261,64,1482,41,26.1,1713.7,14,1,0,3,4,2,2,1,1,0,15655,7.4,19541,230,72,-1482,-41,23.0,1565.5
4518577931,0,14,3,0,3,5,5,0,0,0,0,15529,6.6,17787,237,46,-522,-1373,23.7,1552.9,18,2,1,5,3,2,1,1,0,0,16051,7.0,19160,222,60,522,1373,22.2,1605.1
4442045981,1,73,1,1,9,4,5,1,1,0,0,17965,7.4,20621,229,64,2954,4490,22.9,1796.5,19,1,0,4,9,8,0,0,0,0,15011,6.4,16131,208,41,-2954,-4490,20.8,1501.1
4421809925,1,16,2,1,6,10,7,0,0,0,0,16172,6.4,15969,191,52,-1260,-2264,19.1,1617.2,19,1,0,10,6,12,1,1,0,0,17432,6.8,18233,207,49,1260,2264,20.7,1743.2
4494892035,0,17,2,0,3,9,4,0,0,0,0,15331,6.6,16126,212,48,-2436,-3016,21.2,1533.1,11,4,1,9,3,5,1,1,0,0,17767,7.2,19142,237,45,2436,3016,23.7,1776.7
4457799018,0,10,1,0,5,10,4,0,0,0,0,14750,6.6,15820,185,44,-3688,-4038,18.5,1475.0,76,1,1,10,5,12,2,1,1,0,18438,7.2,19858,189,60,3688,4038,18.9,1843.8
4463341783,1,17,4,0,7,2,6,1,1,0,0,17616,7.0,18140,243,54,2590,1018,24.3,1761.6,19,4,1,2,7,4,1,0,1,0,15026,6.6,17122,248,46,-2590,-1018,24.8,1502.6
4431352906,1,44,1,0,4,4,4,1,0,1,0,15426,7.0,17981,211,54,-99,151,21.1,1542.6,16,1,1,4,4,2,1,1,0,0,15525,6.8,17830,230,56,99,-151,23.0,1552.5
4387774615,0,15,3,0,3,4,1,0,0,0,0,14205,7.0,18034,197,50,-1099,-396,19.7,1420.5,12,3,1,4,3,4,1,1,0,0,15304,7.0,18430,236,43,1099,396,23.6,1530.4
4479685423,0,27,0,0,2,9,2,0,0,0,0,13977,6.2,15531,197,52,-4221,-3570,19.7,1397.7,14,3,1,9,2,14,1,1,0,0,18198,7.0,19101,233,44,4221,3570,23.3,1819.8
4519928092,1,24,1,1,10,7,9,2,1,1,0,18572,7.2,19279,208,60,1923,734,20.8,1857.2,14,2,0,7,10,4,0,0,0,0,16649,7.0,18545,205,51,-1923,-734,20.5,1664.9
4521787222,0,16,3,0,4,6,2,2,1,1,0,14975,7.0,18139,201,58,-1530,-146,20.1,1497.5,40,5,1,6,4,8,0,0,0,0,16505,7.2,18285,220,63,1530,146,22.0,1650.5
4480526985,1,17,2,1,6,3,6,0,0,0,0,17186,7.0,18505,234,68,2320,2234,23.4,1718.6,17,2,0,3,6,6,0,0,0,0,14866,6.6,16271,207,44,-2320,-2234,20.7,1486.6
4523810614,0,16,2,0,5,5,6,1,1,0,0,16253,6.8,18163,212,46,-17,-1171,21.2,1625.3,14,3,1,5,5,2,0,0,0,0,16270,7.2,19334,243,55,17,1171,24.3,1627.0
4523976473,1,14,4,1,6,1,9,2,1,1,1,18435,7.2,18643,254,44,4751,641,25.4,1843.5,12,0,0,1,6,0,0,0,0,0,13684,6.8,18002,203,52,-4751,-641,20.3,1368.4
4494766750,1,68,2,1,9,3,16,0,0,0,0,17718,7.0,18091,209,48,3017,1450,20.9,1771.8,17,2,0,3,9,2,0,0,0,0,14701,6.8,16641,197,52,-3017,-1450,19.7,1470.1
4524404606,0,85,3,1,4,8,5,0,0,0,0,15426,7.0,17467,226,47,-2023,-2678,22.6,1542.6,16,2,0,8,4,4,1,1,0,0,17449,7.4,20145,251,60,2023,2678,25.1,1744.9
4508717967,0,18,2,0,15,6,15,0,0,0,0,19931,7.0,18115,213,40,4375,3249,21.3,1993.1,17,1,1,6,15,6,0,0,0,0,15556,6.2,14866,169,40,-4375,-3249,16.9,1555.6
4520654397,1,16,7,1,1,0,1,1,0,1,0,15268,7.2,18685,269,56,296,440,26.9,1526.8,21,2,0,0,1,0,1,1,0,0,14972,7.2,18245,251,71,-296,-440,25.1,1497.2
4472625849,0,22,2,0,12,9,10,1,0,1,0,18291,6.8,17873,208,56,1693,1979,20.8,1829.1,12,2,1,9,12,11,0,0,0,0,16598,6.4,15894,180,47,-1693,-1979,18.0,1659.8
4493760439,1,143,2,1,3,5,3,1,1,0,0,14767,6.8,16754,214,60,-1371,-1951,21.4,1476.7,18,8,0,5,3,4,0,0,0,0,16138,7.0,18705,256,43,1371,1951,25.6,1613.8
4485493657,0,16,3,1,6,7,8,0,0,0,0,16554,6.6,17192,215,49,-154,-193,21.5,1655.4,16,2,0,7,6,9,1,0,1,0,16708,6.8,17385,218,48,154,193,21.8,1670.8
4464386796,0,14,1,0,5,10,2,1,0,1,0,15974,6.8,18618,226,60,-2545,-1541,22.6,1597.4,13,4,1,10,5,9,1,1,0,0,18519,7.6,20159,247,56,2545,1541,24.7,1851.9
4483910758,0,12,3,0,3,5,2,1,0,1,0,15385,7.0,17822,227,56,-989,-1102,22.7,1538.5,15,4,1,5,3,3,1,1,0,0,16374,7.4,18924,224,63,989,1102,22.4,1637.4
4480203372,0,13,2,0,9,4,12,0,0,0,1,19292,6.8,18197,213,49,4062,2332,21.3,1929.2,26,2,1,4,9,6,2,1,1,0,15230,6.4,15865,191,42,-4062,-2332,19.1,1523.0
4449347058,0,34,5,0,6,9,7,0,0,0,0,16777,7.2,19056,219,48,-1681,41,21.9,1677.7,19,4,1,9,6,9,0,0,0,0,18458,7.4,19015,241,41,1681,-41,24.1,1845.8
4463147006,1,18,1,0,4,5,3,1,1,0,0,14722,6.4,16664,187,40,-675,-2016,18.7,1472.2,77,1,1,5,4,5,0,0,0,0,15397,7.2,18680,185,52,675,2016,18.5,1539.7
4516186940,0,38,2,1,6,5,10,1,0,1,0,16616,6.6,17450,215,56,930,2011,21.5,1661.6,15,0,0,5,6,7,0,0,0,0,15686,6.2,15439,168,60,-930,-2011,16.8,1568.6
4510706282,0,17,2,0,6,2,7,1,0,1,0,16646,7.2,18530,226,51,2352,1002,22.6,1664.6,12,1,1,2,6,2,1,1,0,0,14294,6.8,17528,210,60,-2352,-1002,21.0,1429.4
4526752854,0,15,5,0,9,4,7,0,0,0,0,16847,7.0,19212,211,45,1843,3584,21.1,1684.7,17,2,1,4,9,4,0,0,0,0,15004,6.2,15628,194,50,-1843,-3584,19.4,1500.4
4462529490,0,16,4,0,11,13,13,1,1,0,0,18549,6.8,16837,182,56,-1048,-450,18.2,1854.9,15,4,1,13,11,17,1,0,1,1,19597,6.8,17287,201,40,1048,450,20.1,1959.7
4496833105,0,17,1,0,7,6,10,1,0,1,0,16578,7.0,18528,206,56,-597,275,20.6,1657.8,21,5,1,6,7,6,1,1,0,0,17175,6.8,18253,242,56,597,-275,24.2,1717.5
4500135002,1,13,2,1,10,8,10,0,0,0,0,17692,7.2,18587,203,63,1018,1319,20.3,1769.2,12,1,0,8,10,10,1,1,0,0,16674,6.8,17268,201,38,-1018,-1319,20.1,1667.4
4527276272,0,13,10,0,8,10,8,1,1,0,0,17048,7.0,18361,230,61,171,1158,23.0,1704.8,43,5,1,10,8,10,0,0,0,0,16877,6.8,17203,185,35,-171,-1158,18.5,1687.7
4525761133,1,15,0,1,7,4,8,0,0,0,0,17329,7.4,19681,224,55,1870,1791,22.4,1732.9,18,2,0,4,7,3,1,1,0,0,15459,6.8,17890,243,32,-1870,-1791,24.3,1545.9
4485591192,1,17,6,0,4,6,6,1,1,0,0,15931,6.8,17539,222,52,-730,-251,22.2,1593.1,19,1,1,6,4,7,0,0,0,0,16661,7.0,17790,213,64,730,251,21.3,1666.1
4456531683,0,17,3,0,6,12,3,0,0,0,0,15676,6.6,17356,210,44,-2653,-376,21.0,1567.6,15,1,1,12,6,15,1,1,0,0,18329,7.0,17732,191,48,2653,376,19.1,1832.9
4448510561,0,16,3,0,5,10,5,0,0,0,0,15867,6.8,17737,227,47,-1806,-1253,22.7,1586.7,19,1,1,10,5,9,0,0,0,0,17673,7.2,18990,200,44,1806,1253,20.0,1767.3
4524198218,0,18,3,1,5,6,5,1,1,0,0,16533,6.6,17396,231,43,251,-340,23.1,1653.3,44,3,0,6,5,6,0,0,0,0,16282,7.0,17736,217,61,-251,340,21.7,1628.2
4457833778,1,17,1,1,5,6,5,0,0,0,0,16781,6.8,18303,222,48,679,1400,22.2,1678.1,17,0,0,6,5,6,1,1,0,0,16102,6.6,16903,192,57,-679,-1400,19.2,1610.2
4521180188,1,13,2,0,3,3,2,1,1,0,0,15188,7.0,17748,236,57,52,1036,23.6,1518.8,14,1,1,3,3,3,0,0,0,0,15136,6.6,16712,214,55,-52,-1036,21.4,1513.6
4523489626,1,16,2,1,8,6,4,1,1,0,0,16883,7.2,18957,215,52,955,642,21.5,1688.3,16,1,0,6,8,5,0,0,0,0,15928,7.0,18315,206,59,-955,-642,20.6,1592.8
4519247401,1,40,5,1,9,5,11,1,1,0,0,17654,7.0,19048,249,40,1405,2118,24.9,1765.4,15,4,0,5,9,6,1,0,1,0,16249,6.8,16930,204,40,-1405,-2118,20.4,1624.9
4495742635,1,14,3,1,14,6,17,1,1,0,0,20177,7.8,21248,236,56,3696,3558,23.6,2017.7,7,3,0,6,14,5,0,0,0,0,16481,7.0,17690,207,47,-3696,-3558,20.7,1648.1
4507704018,0,16,1,0,7,1,6,1,0,1,0,17820,7.6,20320,234,68,3462,2960,23.4,1782.0,10,0,1,1,7,1,1,1,0,0,14358,6.8,17360,205,60,-3462,-2960,20.5,1435.8
4522652739,0,16,4,1,4,2,3,2,1,1,0,16125,7.2,19055,235,56,1236,144,23.5,1612.5,28,4,0,2,4,2,0,0,0,0,14889,7.4,18911,249,60,-1236,-144,24.9,1488.9
4519157822,0,28,2,1,9,6,11,0,0,0,0,17210,6.6,17039,195,36,643,-8,19.5,1721.0,15,6,0,6,9,8,0,0,0,0,16567,6.8,17047,197,55,-643,8,19.7,1656.7
4511941552,1,17,6,0,8,2,9,1,1,0,0,16699,7.0,18113,238,36,1718,1073,23.8,1669.9,16,3,1,2,8,3,0,0,0,0,14981,6.8,17040,225,56,-1718,-1073,22.5,1498.1
4518677931,1,18,2,1,13,7,12,1,1,0,0,19558,7.0,19133,215,44,3257,1407,21.5,1955.8,15,2,0,7,13,5,0,0,0,0,16301,6.8,17726,203,66,-3257,-1407,20.3,1630.1
4505704302,0,16,4,0,3,6,2,1,0,1,0,15524,6.6,17326,217,58,-645,-1495,21.7,1552.4,41,1,1,6,3,5,1,1,0,0,16169,7.2,18821,200,70,645,1495,20.0,1616.9
4521842384,1,12,4,0,3,5,6,0,0,0,0,14771,7.0,17825,227,44,-1426,-26,22.7,1477.1,24,2,1,5,3,4,2,1,1,0,16197,7.0,17851,218,52,1426,26,21.8,1619.7
4519839148,0,15,3,1,5,1,7,1,1,0,0,15990,7.2,18712,221,54,811,881,22.1,1599.0,16,2,0,1,5,1,0,0,0,0,15179,7.0,17831,235,65,-811,-881,23.5,1517.9
4407377509,1,30,10,1,15,7,15,2,1,1,0,20822,6.8,18683,237,53,5040,2681,23.7,2082.2,20,4,0,7,15,8,0,0,0,0,15782,6.4,16002,187,26,-5040,-2681,18.7,1578.2
4522399054,1,38,2,1,5,5,6,1,1,0,0,16794,6.8,17320,229,39,510,-747,22.9,1679.4,37,4,0,5,5,6,1,0,1,0,16284,7.2,18067,216,55,-510,747,21.6,1628.4
4512312350,1,16,2,1,7,4,4,1,1,0,0,17107,7.2,19237,218,68,2169,2453,21.8,1710.7,30,1,0,4,7,4,0,0,0,0,14938,6.6,16784,212,40,-2169,-2453,21.2,1493.8
4487454478,1,15,1,1,10,4,11,0,0,0,0,18314,7.0,17903,219,31,3884,2224,21.9,1831.4,11,0,0,4,10,6,1,1,0,0,14430,6.6,15679,167,48,-3884,-2224,16.7,1443.0
4522688117,0,12,0,0,2,6,1,0,0,0,0,13736,6.2,16381,188,52,-3593,-2516,18.8,1373.6,17,2,1,6,2,7,2,1,1,0,17329,7.0,18897,227,68,3593,2516,22.7,1732.9
4513861752,0,18,5,0,6,8,8,0,0,0,0,16606,7.0,18604,226,43,-1325,64,22.6,1660.6,19,4,1,8,6,11,1,1,0,0,17931,7.2,18540,233,56,1325,-64,23.3,1793.1
4450382504,1,36,3,1,9,2,13,0,0,0,0,19570,7.8,21203,259,74,4826,4472,25.9,1957.0,17,3,0,2,9,4,1,1,0,0,14744,6.6,16731,229,52,-4826,-4472,22.9,1474.4
4518222649,0,14,4,0,5,5,5,1,0,1,0,16115,7.2,18971,237,48,516,2485,23.7,1611.5,19,2,1,5,5,8,0,0,0,0,15599,6.6,16486,213,42,-516,-2485,21.3,1559.9
4496336635,1,35,2,1,3,6,5,0,0,0,0,14703,6.8,16970,198,36,-2127,-1619,19.8,1470.3,18,2,0,6,3,10,1,1,0,0,16830,7.0,18589,233,55,2127,1619,23.3,1683.0
4525010648,1,37,1,0,10,8,10,0,0,0,0,18588,7.2,19735,225,64,2382,2614,22.5,1858.8,16,1,1,8,10,7,0,0,0,0,16206,6.8,17121,192,28,-2382,-2614,19.2,1620.6
4513121653,0,18,2,1,5,6,8,0,0,0,0,16324,7.0,17343,216,44,-683,-676,21.6,1632.4,14,2,0,6,5,5,0,0,0,0,17007,7.0,18019,248,52,683,676,24.8,1700.7
4526903183,0,85,2,0,6,9,7,0,0,0,0,16223,6.8,17056,196,36,-605,-782,19.6,1622.3,13,2,1,9,6,7,1,1,0,0,16828,7.0,17838,203,56,605,782,20.3,1682.8
4497887298,0,68,0,0,1,14,1,1,1,0,0,13438,5.8,14164,174,53,-7655,-4485,17.4,1343.8,15,4,1,14,1,18,0,0,0,1,21093,7.0,18649,234,29,7655,4485,23.4,2109.3
4483668263,0,13,0,1,6,4,6,1,0,1,0,16422,7.0,17507,212,53,-19,-1122,21.2,1642.2,11,1,0,4,6,2,0,0,0,0,16441,7.0,18629,256,68,19,1122,25.6,1644.1
4518477698,0,15,6,0,6,8,7,1,1,0,0,16111,6.8,17170,204,48,-1556,-1808,20.4,1611.1,15,2,1,8,6,5,0,0,0,0,17667,7.2,18978,241,40,1556,1808,24.1,1766.7
4463266834,1,14,3,0,6,6,10,1,1,0,0,16701,7.0,17762,196,56,-16,-467,19.6,1670.1,17,1,1,6,6,3,0,0,0,0,16717,7.2,18229,232,47,16,467,23.2,1671.7
4508392711,1,15,1,0,6,4,8,0,0,0,0,17214,7.2,18948,244,52,2045,1938,24.4,1721.4,15,3,1,4,6,5,1,1,0,0,15169,6.8,17010,220,40,-2045,-1938,22.0,1516.9
4518566693,1,18,4,0,7,6,7,0,0,0,0,16948,7.0,18437,222,44,707,1131,22.2,1694.8,14,1,1,6,7,6,0,0,0,0,16241,6.8,17306,221,32,-707,-1131,22.1,1624.1
4516341582,1,19,6,0,6,4,5,1,0,1,0,17481,7.4,19040,248,39,1784,1193,24.8,1748.1,18,5,1,4,6,3,1,1,0,0,15697,7.0,17847,216,60,-1784,-1193,21.6,1569.7
4485746291,1,19,4,0,11,1,13,1,0,1,1,20251,7.4,20985,263,61,6942,6381,26.3,2025.1,19,6,1,1,11,1,1,1,0,0,13309,6.2,14604,186,42,-6942,-6381,18.6,1330.9
4445248435,0,32,3,0,5,8,3,1,1,0,0,14795,6.6,16454,178,52,-2914,-2683,17.8,1479.5,19,3,1,8,5,11,1,0,1,0,17709,7.2,19137,229,52,2914,2683,22.9,1770.9
4527015583,0,14,1,0,6,11,4,0,0,0,0,15775,6.8,17025,206,44,-2861,-1651,20.6,1577.5,17,1,1,11,6,14,1,1,0,0,18636,7.0,18676,210,52,2861,1651,21.0,1863.6
4419298949,0,17,2,1,5,9,5,0,0,0,0,15953,6.8,16466,223,51,-1047,-193,22.3,1595.3,16,1,0,9,5,10,1,1,0,0,17000,6.4,16659,179,68,1047,193,17.9,1700.0
4448445178,0,18,3,0,4,10,3,0,0,0,0,15341,6.8,17802,204,44,-2310,-1604,20.4,1534.1,17,3,1,10,4,11,1,1,0,0,17651,7.2,19406,220,56,2310,1604,22.0,1765.1
4460567207,0,15,2,1,14,7,16,1,1,0,0,20269,7.4,20117,242,32,3331,1795,24.2,2026.9,15,1,0,7,14,7,0,0,0,0,16938,7.0,18322,192,56,-3331,-1795,19.2,1693.8
4460036381,1,13,1,0,3,7,3,1,1,0,0,14659,6.2,15944,193,48,-944,-2050,19.3,1465.9,13,1,1,7,3,6,0,0,0,0,15603,6.8,17994,213,48,944,2050,21.3,1560.3
4503243020,0,17,2,0,3,12,3,0,0,0,0,14232,6.6,16592,216,38,-5617,-4035,21.6,1423.2,15,2,1,12,3,17,1,1,0,0,19849,7.6,20627,238,68,5617,4035,23.8,1984.9
4521770795,0,13,4,0,2,7,1,0,0,0,0,14573,6.8,17827,212,58,-2928,-1796,21.2,1457.3,15,1,1,7,2,8,2,1,1,0,17501,7.2,19623,239,55,2928,1796,23.9,1750.1
4507824198,1,17,1,1,7,2,5,1,0,1,0,16649,7.4,19322,226,47,1256,-295,22.6,1664.9,16,6,0,2,7,1,1,1,0,0,15393,7.4,19617,268,63,-1256,295,26.8,1539.3
4519408439,0,89,1,0,5,7,5,0,0,0,0,15856,7.0,18029,224,44,295,630,22.4,1585.6,15,2,1,7,5,6,0,0,0,0,15561,6.8,17399,173,51,-295,-630,17.3,1556.1
4527444282,0,13,2,0,3,9,2,1,1,0,0,13876,6.6,16521,175,47,-3248,-1706,17.5,1387.6,46,1,1,9,3,8,0,0,0,0,17124,7.0,18227,194,52,3248,1706,19.4,1712.4
4507014159,1,17,3,0,9,6,12,0,0,0,0,16765,6.6,16518,181,34,911,-276,18.1,1676.5,20,5,1,6,9,4,1,1,0,0,15854,6.8,16794,182,50,-911,276,18.2,1585.4
4526160950,0,51,2,1,4,2,6,0,0,0,0,15236,6.8,17761,196,52,194,143,19.6,1523.6,15,2,0,2,4,3,1,1,0,0,15042,6.8,17618,254,48,-194,-143,25.4,1504.2
4510692119,1,13,3,1,11,4,17,1,1,0,0,18456,7.2,19034,214,60,2724,2170,21.4,1845.6,49,0,0,4,11,7,0,0,0,0,15732,6.6,16864,218,61,-2724,-2170,21.8,1573.2
4454570782,0,12,3,1,4,8,6,0,0,0,0,15428,6.8,16985,213,54,-2190,-3375,21.3,1542.8,15,2,0,8,4,7,2,1,1,0,17618,7.6,20360,218,67,2190,3375,21.8,1761.8
4521539321,0,106,1,1,5,9,8,0,0,0,0,15651,6.6,16491,211,55,-1554,-781,21.1,1565.1,12,2,0,9,5,10,0,0,0,0,17205,6.8,17272,203,36,1554,781,20.3,1720.5
4447355844,1,41,5,1,5,4,3,1,1,0,0,15277,6.6,17240,207,47,-387,795,20.7,1527.7,19,13,0,4,5,5,0,0,0,0,15664,6.4,16445,217,59,387,-795,21.7,1566.4
4497099523,0,58,2,0,9,10,10,2,1,1,0,18368,7.2,19062,204,52,-328,137,20.4,1836.8,14,1,1,10,9,13,0,0,0,0,18696,7.2,18925,230,52,328,-137,23.0,1869.6
4503471693,1,20,6,0,4,7,3,0,0,0,0,15434,7.0,18097,235,49,-1806,-226,23.5,1543.4,20,4,1,7,4,12,1,1,0,0,17240,7.2,18323,224,58,1806,226,22.4,1724.0
4473941338,0,16,1,0,4,11,4,0,0,0,0,15358,6.8,17610,210,47,-3019,-848,21.0,1535.8,15,1,1,11,4,12,1,1,0,0,18377,7.2,18458,207,56,3019,848,20.7,1837.7
4503653541,0,20,0,1,6,5,5,0,0,0,0,15428,6.8,16724,201,46,-491,-1417,20.1,1542.8,35,5,0,5,6,4,1,1,0,0,15919,6.8,18141,211,62,491,1417,21.1,1591.9
4508533364,1,125,1,1,8,8,9,1,0,1,0,16502,7.0,17726,198,45,342,-444,19.8,1650.2,36,3,0,8,8,8,1,1,0,0,16160,7.0,18170,195,48,-342,444,19.5,1616.0
4500102951,0,14,4,1,7,7,7,0,0,0,0,16781,6.8,17415,194,52,-2063,-1448,19.4,1678.1,27,1,0,7,7,7,0,0,0,1,18844,7.0,18863,232,52,2063,1448,23.2,1884.4
4520349175,1,16,6,0,8,5,10,0,0,0,0,17258,6.8,17683,216,52,2310,1946,21.6,1725.8,20,0,1,5,8,5,0,0,0,0,14948,6.6,15737,176,40,-2310,-1946,17.6,1494.8
4519538851,1,54,3,1,6,4,8,1,0,1,0,16606,7.0,18225,237,48,1385,969,23.7,1660.6,19,2,0,4,6,2,0,0,0,0,15221,7.0,17256,217,60,-1385,-969,21.7,1522.1
4470106010,0,19,3,0,6,5,4,1,1,0,0,16000,7.2,18965,181,79,230,1894,18.1,1600.0,14,3,1,5,6,4,0,0,0,0,15770,6.8,17071,236,36,-230,-1894,23.6,1577.0
4525860232,1,17,2,0,9,6,9,0,0,0,0,17643,6.8,17908,218,36,1550,1042,21.8,1764.3,36,1,1,6,9,8,2,1,1,0,16093,6.6,16866,183,52,-1550,-1042,18.3,1609.3
4522596231,1,18,2,1,9,4,11,0,0,0,1,20170,7.2,19190,257,54,5619,3506,25.7,2017.0,17,3,0,4,9,5,1,1,0,0,14551,6.4,15684,198,44,-5619,-3506,19.8,1455.1
4500030602,1,12,1,1,6,11,8,1,1,0,0,15855,6.8,17383,204,48,-2536,-2343,20.4,1585.5,13,0,0,11,6,11,0,0,0,0,18391,7.0,19726,218,48,2536,2343,21.8,1839.1
4465820697,0,16,3,0,3,7,2,1,0,1,0,15104,6.8,17634,228,38,-2831,-1651,22.8,1510.4,16,1,1,7,3,8,1,1,0,0,17935,7.4,19285,242,66,2831,1651,24.2,1793.5
4494067243,1,18,4,1,4,8,3,1,1,0,0,15330,6.6,16197,203,57,-2366,-3382,20.3,1533.0,16,5,0,8,4,12,0,0,0,0,17696,7.2,19579,229,51,2366,3382,22.9,1769.6
4479932808,0,15,3,0,1,3,1,0,0,0,0,13638,6.8,16479,190,59,-2033,-1612,19.0,1363.8,19,3,1,3,1,3,0,0,0,0,15671,7.2,18091,238,47,2033,1612,23.8,1567.1
4452004237,1,13,5,0,5,7,7,1,1,0,0,15293,6.4,16208,202,50,-1555,-1234,20.2,1529.3,17,1,1,7,5,11,0,0,0,0,16848,6.8,17442,210,51,1555,1234,21.0,1684.8
4521137660,0,51,2,0,3,4,5,1,1,0,0,14945,6.4,16491,215,50,-1696,-2153,21.5,1494.5,17,4,1,4,3,3,0,0,0,0,16641,7.0,18644,226,53,1696,2153,22.6,1664.1
4508287669,1,21,4,0,5,7,4,0,0,0,1,16791,7.0,17929,225,48,482,617,22.5,1679.1,9,1,1,7,5,5,1,1,0,0,16309,6.8,17312,207,58,-482,-617,20.7,1630.9
4496024408,1,12,7,1,4,7,5,0,0,0,0,14703,6.6,16749,232,33,-1323,-591,23.2,1470.3,41,2,0,7,4,15,0,0,0,0,16026,6.8,17340,191,39,1323,591,19.1,1602.6
4508104960,1,20,3,1,8,2,11,1,1,0,0,17375,7.0,18886,241,38,2804,2924,24.1,1737.5,16,3,0,2,8,3,0,0,0,0,14571,6.6,15962,226,40,-2804,-2924,22.6,1457.1
4524520097,0,14,1,0,0,6,0,0,0,0,0,13421,6.6,17265,221,52,-3543,-1737,22.1,1342.1,13,2,1,6,0,7,1,1,0,0,16964,7.2,19002,242,48,3543,1737,24.2,1696.4
4474804095,1,48,1,0,6,9,8,0,0,0,0,16241,7.0,18864,211,60,-1539,-601,21.1,1624.1,24,1,1,9,6,9,1,1,0,0,17780,7.2,19465,249,52,1539,601,24.9,1778.0
4525024400,0,15,23,0,8,13,12,0,0,0,0,16342,6.6,16909,165,42,-5219,-3480,16.5,1634.2,41,2,1,13,8,15,0,0,0,1,21561,7.4,20389,263,40,5219,3480,26.3,2156.1
4500348663,0,45,1,1,5,4,5,0,0,0,0,15788,6.8,18069,200,56,647,481,20.0,1578.8,19,3,0,4,5,2,2,1,1,0,15141,7.0,17588,228,56,-647,-481,22.8,1514.1
4522499744,1,15,1,1,5,7,6,1,1,0,0,16328,6.8,17945,241,50,-972,-1814,24.1,1632.8,15,0,0,7,5,8,0,0,0,0,17300,7.2,19759,233,53,972,1814,23.3,1730.0
4517515942,0,22,4,1,10,9,8,1,1,0,0,17394,7.0,18046,195,28,-614,-846,19.5,1739.4,14,3,0,9,10,8,0,0,0,0,18008,7.0,18892,187,92,614,846,18.7,1800.8
4521508038,1,17,1,1,5,4,4,0,0,0,0,16450,7.0,18801,229,72,1771,1846,22.9,1645.0,18,0,0,4,5,4,1,1,0,0,14679,6.6,16955,194,46,-1771,-1846,19.4,1467.9
4491649164,1,16,1,0,3,4,3,0,0,0,0,15459,7.0,18000,230,55,-174,231,23.0,1545.9,15,4,1,4,3,5,2,1,1,0,15633,7.0,17769,212,48,174,-231,21.2,1563.3
4510758423,1,16,4,1,6,1,4,0,0,0,0,17007,7.4,19713,242,52,3332,2410,24.2,1700.7,16,2,0,1,6,2,1,1,0,0,13675,6.8,17303,194,68,-3332,-2410,19.4,1367.5
4522775881,1,14,2,1,7,4,8,1,1,0,0,17651,6.8,18454,229,60,3245,307,22.9,1765.1,16,2,0,4,7,3,0,0,0,0,14406,6.8,18147,179,52,-3245,-307,17.9,1440.6
4496346599,0,19,3,0,6,8,9,1,1,0,0,15731,6.8,17396,236,37,-2238,-1138,23.6,1573.1,17,2,1,8,6,8,0,0,0,0,17969,7.2,18534,235,65,2238,1138,23.5,1796.9
4487249336,1,38,0,1,11,6,15,1,1,0,0,19218,7.0,19389,197,56,3248,2147,19.7,1921.8,16,2,0,6,11,4,0,0,0,0,15970,6.8,17242,205,48,-3248,-2147,20.5,1597.0
4521325400,0,15,0,0,5,9,5,1,1,0,0,15880,6.8,17975,199,56,-3840,-2835,19.9,1588.0,12,2,1,9,5,11,1,0,1,0,19720,7.6,20810,239,76,3840,2835,23.9,1972.0
4526240730,1,16,2,1,10,11,18,1,1,0,0,18588,7.4,18787,205,65,432,1389,20.5,1858.8,20,3,0,11,10,12,0,0,0,0,18156,6.8,17398,186,45,-432,-1389,18.6,1815.6
4441924667,0,16,6,1,7,5,6,0,0,0,0,16381,7.0,18126,221,56,134,-1142,22.1,1638.1,14,2,0,5,7,3,2,1,1,0,16247,7.2,19268,231,64,-134,1142,23.1,1624.7
4438293749,1,14,1,0,4,7,4,0,0,0,0,15381,7.2,18597,222,56,-758,313,22.2,1538.1,15,1,1,7,4,5,0,0,0,0,16139,7.2,18284,194,51,758,-313,19.4,1613.9
4450770211,0,17,7,0,8,9,13,1,1,0,0,17579,7.2,18266,224,41,475,1006,22.4,1757.9,22,2,1,9,8,10,0,0,0,0,17104,6.8,17260,205,36,-475,-1006,20.5,1710.4
4506057736,0,16,2,0,1,5,2,1,0,1,0,13235,6.4,15728,187,40,-2466,-1449,18.7,1323.5,19,6,1,5,1,6,1,1,0,0,15701,6.6,17177,221,31,2466,1449,22.1,1570.1
4419845019,0,14,1,0,4,13,3,0,0,0,0,14129,6.6,16038,174,32,-5489,-3743,17.4,1412.9,18,2,1,13,4,21,1,1,0,0,19618,7.4,19781,185,69,5489,3743,18.5,1961.8
4527028383,0,92,3,1,3,6,0,1,1,0,0,14746,6.8,17610,206,56,-1108,-370,20.6,1474.6,16,1,0,6,3,6,0,0,0,0,15854,7.0,17980,210,52,1108,370,21.0,1585.4
4525352224,1,129,17,0,6,6,6,1,1,0,0,16666,6.8,17512,185,58,132,-28,18.5,1666.6,47,1,1,6,6,6,0,0,0,0,16534,6.8,17540,237,40,-132,28,23.7,1653.4
4513593085,0,13,1,0,3,6,4,0,0,0,0,14907,6.6,17149,226,32,-2342,-1982,22.6,1490.7,17,0,1,6,3,5,0,0,0,0,17249,7.2,19131,262,51,2342,1982,26.2,1724.9
4515382430,1,23,5,0,5,8,7,1,0,1,0,16250,6.8,17847,233,52,-964,-202,23.3,1625.0,22,4,1,8,5,7,1,1,0,0,17214,6.8,18049,221,44,964,202,22.1,1721.4
4523295777,1,41,3,1,8,7,6,2,1,1,0,17287,7.0,18953,215,62,817,266,21.5,1728.7,18,4,0,7,8,7,0,0,0,0,16470,7.2,18687,218,56,-817,-266,21.8,1647.0
4525291177,0,73,3,1,9,13,15,0,0,0,0,16300,5.8,13423,141,29,-3173,-4350,14.1,1630.0,14,2,0,13,9,18,1,1,0,0,19473,7.0,17773,207,46,3173,4350,20.7,1947.3
4465840053,1,17,1,0,10,10,3,0,0,0,0,16993,7.2,19167,195,61,-1019,699,19.5,1699.3,29,5,1,10,10,10,0,0,0,0,18012,7.2,18468,202,38,1019,-699,20.2,1801.2
4512913820,1,47,2,0,3,12,3,1,0,1,0,15096,6.2,15306,212,50,-2483,-1696,21.2,1509.6,14,20,1,12,3,16,1,1,0,0,17579,6.6,17002,144,41,2483,1696,14.4,1757.9
4520742612,0,40,3,1,4,8,6,2,1,1,0,15404,6.6,16706,203,49,-1332,-1998,20.3,1540.4,18,5,0,8,4,4,0,0,0,0,16736,7.2,18704,204,45,1332,1998,20.4,1673.6
4511779453,0,15,4,0,3,3,2,1,1,0,0,14876,7.0,17630,221,51,81,450,22.1,1487.6,41,2,1,3,3,6,1,0,1,0,14795,7.0,17180,218,52,-81,-450,21.8,1479.5
4500738441,0,23,2,1,5,9,4,0,0,0,0,15675,6.6,16844,229,39,-1614,-2256,22.9,1567.5,14,3,0,9,5,12,1,1,0,0,17289,7.2,19100,215,56,1614,2256,21.5,1728.9
4519327401,0,16,5,1,6,8,11,1,1,0,0,16031,6.6,17016,215,57,-987,-1705,21.5,1603.1,18,1,0,8,6,8,0,0,0,0,17018,6.8,18721,223,55,987,1705,22.3,1701.8
4525051331,1,15,5,0,8,4,12,1,1,0,0,17306,6.8,18073,237,43,2170,1383,23.7,1730.6,14,2,1,4,8,5,0,0,0,0,15136,6.4,16690,218,44,-2170,-1383,21.8,1513.6
4520356694,1,15,4,0,4,6,2,0,0,0,0,15063,6.8,17979,206,64,-1213,-1013,20.6,1506.3,19,5,1,6,4,2,1,1,0,0,16276,7.0,18992,253,56,1213,1013,25.3,1627.6
4518273376,1,14,2,0,12,3,11,2,1,1,0,19082,7.2,18970,226,52,4305,2244,22.6,1908.2,38,1,1,3,12,2,0,0,0,0,14777,6.6,16726,216,44,-4305,-2244,21.6,1477.7
4483696050,1,15,6,1,10,6,11,1,1,0,0,19380,7.2,19467,244,64,3844,2740,24.4,1938.0,17,4,0,6,10,6,0,0,0,0,15536,6.4,16727,189,46,-3844,-2740,18.9,1553.6
4523121371,0,16,2,1,5,13,4,0,0,0,0,14988,6.2,15585,186,40,-3562,-3319,18.6,1498.8,10,3,0,13,5,20,0,0,0,0,18550,7.2,18904,208,52,3562,3319,20.8,1855.0
4475315521,0,13,6,1,6,9,7,0,0,0,0,15291,6.2,15389,190,56,-2889,-3905,19.0,1529.1,17,2,0,9,6,10,1,1,0,0,18180,7.2,19294,228,51,2889,3905,22.8,1818.0
4504404678,1,15,4,1,3,1,3,1,1,0,0,16426,7.4,19543,251,75,2296,2033,25.1,1642.6,18,0,0,1,3,2,0,0,0,0,14130,6.8,17510,236,46,-2296,-2033,23.6,1413.0
4472805332,0,15,2,0,4,6,3,0,0,0,0,14962,7.0,18176,201,48,-1672,-2213,20.1,1496.2,15,3,1,6,4,3,0,0,0,0,16634,7.4,20389,237,68,1672,2213,23.7,1663.4
4525171527,1,16,1,1,6,3,6,1,1,0,0,14887,6.4,14486,159,36,-498,-2244,15.9,1488.7,17,3,0,3,6,1,1,0,1,0,15385,6.6,16730,227,56,498,2244,22.7,1538.5
4509719745,1,44,6,0,13,6,13,0,0,0,0,18933,7.4,19905,210,45,2109,3154,21.0,1893.3,19,2,1,6,13,10,0,0,0,0,16824,6.6,16751,194,50,-2109,-3154,19.4,1682.4
4490117676,1,60,4,1,3,2,2,0,0,0,0,15271,7.0,18182,199,59,356,58,19.9,1527.1,16,0,0,2,3,2,0,0,0,0,14915,7.0,18124,232,39,-356,-58,23.2,1491.5
4510534597,0,15,3,0,3,9,3,0,0,0,0,14512,6.6,16088,226,32,-3476,-4019,22.6,1451.2,13,0,1,9,3,6,2,1,1,0,17988,7.4,20107,249,55,3476,4019,24.9,1798.8
4521046337,1,16,3,1,8,3,8,0,0,0,0,17849,7.0,18536,227,40,3364,2412,22.7,1784.9,15,1,0,3,8,2,1,1,0,0,14485,6.4,16124,223,49,-3364,-2412,22.3,1448.5
4523433938,0,16,0,0,3,4,4,0,0,0,0,15875,6.8,17351,241,42,186,-273,24.1,1587.5,38,5,1,4,3,4,0,0,0,0,15689,7.2,17624,232,45,-186,273,23.2,1568.9
4524787286,0,99,5,0,7,10,11,0,0,0,0,16332,6.8,17067,196,56,-1514,-893,19.6,1633.2,15,4,1,10,7,9,1,1,0,0,17846,6.8,17960,211,48,1514,893,21.1,1784.6
4449918896,0,13,2,1,10,4,7,0,0,0,0,17498,7.4,19402,224,45,2084,2869,22.4,1749.8,10,2,0,4,10,4,0,0,0,0,15414,6.4,16533,228,36,-2084,-2869,22.8,1541.4
4501239867,0,11,1,0,8,8,10,0,0,0,0,17208,7.2,18713,231,45,-737,667,23.1,1720.8,12,1,1,8,8,10,0,0,0,0,17945,6.8,18046,239,29,737,-667,23.9,1794.5
4515573943,0,14,2,0,7,10,3,0,0,0,0,16418,6.8,17424,199,52,-1517,-62,19.9,1641.8,19,5,1,10,7,14,1,1,0,0,17935,6.8,17486,211,48,1517,62,21.1,1793.5
4516563869,1,14,4,1,8,6,10,1,1,0,0,17776,6.8,18126,224,45,1072,411,22.4,1777.6,17,2,0,6,8,8,0,0,0,0,16704,6.6,17715,238,51,-1072,-411,23.8,1670.4
4467448834,0,27,4,0,3,8,2,0,0,0,0,15179,7.0,17994,238,47,-2537,-1603,23.8,1517.9,16,3,1,8,3,6,1,1,0,0,17716,7.2,19597,216,64,2537,1603,21.6,1771.6
4523017372,1,16,2,1,12,6,10,1,1,0,0,19529,7.6,19979,242,48,3316,2032,24.2,1952.9,34,1,0,6,12,6,0,0,0,0,16213,6.8,17947,197,64,-3316,-2032,19.7,1621.3
4509340231,0,14,0,0,8,11,9,1,1,0,0,16712,6.8,17809,190,35,-2339,-917,19.0,1671.2,38,4,1,11,8,19,0,0,0,0,19051,7.2,18726,228,40,2339,917,22.8,1905.1
4515544332,1,26,7,1,11,2,16,0,0,0,0,18405,7.0,19055,228,45,4817,4522,22.8,1840.5,18,6,0,2,11,2,0,0,0,0,13588,6.2,14533,193,43,-4817,-4522,19.3,1358.8
4510818767,0,16,1,1,4,10,4,0,0,0,0,16256,6.8,17776,248,57,-2528,-2509,24.8,1625.6,16,4,0,10,4,15,2,1,1,0,18784,7.6,20285,221,58,2528,2509,22.1,1878.4
4520798455,1,15,2,1,5,5,6,0,0,0,0,16248,7.2,18554,251,40,1144,464,25.1,1624.8,13,3,0,5,5,5,0,0,0,0,15104,7.0,18090,199,56,-1144,-464,19.9,1510.4
4519886299,1,16,4,1,8,4,10,2,1,1,1,18678,7.0,18538,231,56,3999,2223,23.1,1867.8,13,1,0,4,8,5,0,0,0,0,14679,6.6,16315,193,42,-3999,-2223,19.3,1467.9
4513910209,0,20,1,1,4,3,6,1,1,0,0,14992,7.0,17756,213,48,-471,-1021,21.3,1499.2,14,2,0,3,4,1,0,0,0,0,15463,7.2,18777,240,52,471,1021,24.0,1546.3
4472405035,1,39,2,1,7,6,9,1,1,0,0,17079,7.0,17964,212,44,-365,855,21.2,1707.9,17,3,0,6,7,10,0,0,0,0,17444,6.8,17109,238,44,365,-855,23.8,1744.4
4455647637,0,10,5,0,2,10,3,0,0,0,0,14094,6.2,15768,197,57,-5521,-3591,19.7,1409.4,19,2,1,10,2,14,1,1,0,0,19615,7.4,19359,258,52,5521,3591,25.8,1961.5
4517857557,0,14,2,0,4,5,7,1,1,0,0,15786,6.8,17823,207,54,-92,-1170,20.7,1578.6,15,2,1,5,4,3,0,0,0,0,15878,7.4,18993,215,50,92,1170,21.5,1587.8
4493057700,1,56,4,1,13,4,16,1,1,0,2,20308,7.0,18069,216,52,5058,1536,21.6,2030.8,17,2,0,4,13,3,0,0,0,0,15250,6.6,16533,197,64,-5058,-1536,19.7,1525.0
4456033648,1,16,1,1,3,5,2,1,1,0,0,15156,6.6,17247,207,61,-1063,-2035,20.7,1515.6,14,1,0,5,3,4,0,0,0,0,16219,7.2,19282,229,44,1063,2035,22.9,1621.9
4527960459,1,16,4,1,7,1,5,1,0,1,0,17170,7.0,19211,251,54,3234,2427,25.1,1717.0,21,2,0,1,7,1,0,0,0,0,13936,6.8,16784,203,68,-3234,-2427,20.3,1393.6
4526228041,1,15,3,1,10,4,11,0,0,0,0,18346,7.0,18224,228,36,3454,1882,22.8,1834.6,16,3,0,4,10,5,2,1,1,0,14892,6.6,16342,192,52,-3454,-1882,19.2,1489.2
4476251549,1,18,6,0,8,7,9,0,0,0,0,18048,7.2,18082,242,57,1831,994,24.2,1804.8,17,5,1,7,8,11,2,1,1,0,16217,6.8,17088,218,40,-1831,-994,21.8,1621.7
4513550456,0,16,6,1,5,9,4,0,0,0,0,16105,7.0,17701,237,52,-1198,-833,23.7,1610.5,19,4,0,9,5,8,1,0,1,0,17303,7.2,18534,230,40,1198,833,23.0,1730.3
4527530188,1,99,7,1,6,7,7,1,1,0,0,17193,7.4,18554,257,55,577,1371,25.7,1719.3,22,3,0,7,6,8,0,0,0,0,16616,6.8,17183,228,47,-577,-1371,22.8,1661.6
4521474530,0,15,0,0,7,11,4,1,1,0,0,16113,6.4,16221,186,46,-1172,-1033,18.6,1611.3,15,3,1,11,7,14,0,0,0,0,17285,6.8,17254,203,28,1172,1033,20.3,1728.5
4480457394,1,17,0,0,5,5,4,1,1,0,0,16525,7.0,18498,230,57,1262,413,23.0,1652.5,17,2,1,5,5,3,0,0,0,0,15263,7.0,18085,212,54,-1262,-413,21.2,1526.3
4518173580,1,51,11,1,9,1,9,0,0,0,0,18640,7.4,20923,249,63,4388,3527,24.9,1864.0,18,5,0,1,9,1,1,1,0,0,14252,6.8,17396,221,64,-4388,-3527,22.1,1425.2
4519740782,1,18,1,1,6,3,5,2,1,1,0,17119,7.2,18962,233,57,2031,1967,23.3,1711.9,16,1,0,3,6,3,0,0,0,0,15088,6.8,16995,209,52,-2031,-1967,20.9,1508.8
4521710145,0,14,1,0,3,6,4,0,0,0,0,15688,6.8,17439,239,52,-1434,-1422,23.9,1568.8,11,4,1,6,3,5,1,0,1,0,17122,7.0,18861,237,52,1434,1422,23.7,1712.2
4518992670,0,12,2,0,2,3,2,0,0,0,0,15351,7.0,18539,245,55,390,-828,24.5,1535.1,35,6,1,3,2,1,2,1,1,0,14961,7.2,19367,235,56,-390,828,23.5,1496.1
4524768975,0,15,2,1,10,15,12,0,0,0,0,18051,6.8,17921,201,41,-2224,-2008,20.1,1805.1,15,3,0,15,10,13,1,1,0,0,20275,7.4,19929,226,48,2224,2008,22.6,2027.5
4521918813,1,17,1,1,5,6,2,1,1,0,0,15476,7.0,18246,233,47,-706,-873,23.3,1547.6,24,4,0,6,5,7,0,0,0,0,16182,7.4,19119,244,36,706,873,24.4,1618.2
4493025099,0,17,2,0,6,8,6,0,0,0,0,15222,6.2,15621,178,31,-1262,-1379,17.8,1522.2,17,2,1,8,6,7,0,0,0,0,16484,6.6,17000,178,36,1262,1379,17.8,1648.4
4467077556,0,17,3,0,1,5,1,0,0,0,0,14777,6.8,17674,231,59,-1664,-990,23.1,1477.7,47,3,1,5,1,7,1,0,1,0,16441,7.2,18664,236,46,1664,990,23.6,1644.1
4519250441,0,16,3,0,1,12,0,1,0,1,0,13981,6.6,16277,220,52,-5870,-3642,22.0,1398.1,41,4,1,12,1,18,0,0,0,0,19851,7.4,19919,234,53,5870,3642,23.4,1985.1
4524411421,1,16,0,0,10,10,14,1,1,0,0,18138,7.0,18159,208,55,908,306,20.8,1813.8,15,1,1,10,10,16,0,0,0,0,17230,7.0,17853,210,44,-908,-306,21.0,1723.0
4523260482,1,36,8,1,7,4,11,1,1,0,0,16482,6.6,16880,222,46,1086,756,22.2,1648.2,21,4,0,4,7,6,0,0,0,0,15396,6.4,16124,212,58,-1086,-756,21.2,1539.6
4524952056,0,87,1,0,4,15,4,0,0,0,0,14720,6.2,15031,183,30,-4440,-4020,18.3,1472.0,10,1,1,15,4,14,0,0,0,0,19160,7.4,19051,201,51,4440,4020,20.1,1916.0
4522806079,1,18,4,1,4,5,2,1,1,0,0,15261,6.6,17058,233,46,-393,-1504,23.3,1526.1,18,4,0,5,4,5,0,0,0,0,15654,7.2,18562,208,52,393,1504,20.8,1565.4
4511256473,1,17,0,0,8,7,9,0,0,0,0,18593,7.4,20037,252,66,2277,1630,25.2,1859.3,13,1,1,7,8,9,1,1,0,0,16316,7.2,18407,203,56,-2277,-1630,20.3,1631.6
4517825338,1,16,4,1,7,2,6,0,0,0,0,17423,7.4,19973,248,55,2822,2207,24.8,1742.3,24,3,0,2,7,2,1,1,0,0,14601,7.0,17766,219,64,-2822,-2207,21.9,1460.1
4499944333,0,11,1,1,3,9,3,0,0,0,0,14291,6.4,15475,212,48,-4991,-3526,21.2,1429.1,17,0,0,9,3,13,2,1,1,1,19282,7.2,19001,216,53,4991,3526,21.6,1928.2
4505416038,0,56,1,1,2,1,4,0,0,0,0,15755,7.0,18468,258,69,1684,1773,25.8,1575.5,16,3,0,1,2,1,0,0,0,0,14071,6.8,16695,212,56,-1684,-1773,21.2,1407.1
4523463632,1,14,2,1,11,3,14,1,1,0,0,18758,7.0,18710,212,49,4335,2324,21.2,1875.8,13,3,0,3,11,3,0,0,0,0,14423,6.6,16386,215,43,-4335,-2324,21.5,1442.3
4516712526,1,20,2,1,11,4,11,1,1,0,0,19035,7.4,19997,232,43,2739,1170,23.2,1903.5,16,2,0,4,11,5,1,0,1,0,16296,7.2,18827,268,44,-2739,-1170,26.8,1629.6
4521954992,0,18,1,0,2,2,2,0,0,0,0,14310,7.0,17797,207,44,-740,76,20.7,1431.0,15,4,1,2,2,2,1,1,0,0,15050,7.0,17721,242,47,740,-76,24.2,1505.0
4516967863,1,16,2,1,7,8,5,2,1,1,1,17931,7.0,18404,210,65,-546,-104,21.0,1793.1,12,4,0,8,7,13,0,0,0,0,18477,7.0,18508,217,50,546,104,21.7,1847.7
4516791797,1,14,6,0,9,7,9,0,0,0,0,18151,7.2,19393,227,44,847,1606,22.7,1815.1,19,0,1,7,9,9,0,0,0,0,17304,7.0,17787,226,60,-847,-1606,22.6,1730.4
4517741452,1,38,0,1,6,4,7,2,1,1,0,16886,6.8,18261,221,56,184,-131,22.1,1688.6,16,4,0,4,6,5,0,0,0,0,16702,7.0,18392,237,64,-184,131,23.7,1670.2
4521641335,1,45,3,1,13,7,13,1,0,1,0,18022,6.8,17168,182,36,1643,2462,18.2,1802.2,17,2,0,7,13,6,1,1,0,1,16379,6.2,14706,153,46,-1643,-2462,15.3,1637.9
4498032785,1,16,4,1,8,0,12,1,1,0,0,17519,7.2,19252,222,52,3272,1914,22.2,1751.9,15,2,0,0,8,0,0,0,0,0,14247,6.6,17338,232,52,-3272,-1914,23.2,1424.7
4524619949,0,14,3,0,3,10,4,0,0,0,0,14742,6.6,15941,215,52,-3540,-3279,21.5,1474.2,21,0,1,10,3,13,1,1,0,0,18282,7.2,19220,227,44,3540,3279,22.7,1828.2
4506680103,0,16,4,1,11,9,12,0,0,0,0,18200,7.0,17815,202,39,1211,-757,20.2,1820.0,18,3,0,9,11,10,1,1,0,0,16989,7.2,18572,211,60,-1211,757,21.1,1698.9
4519280079,1,24,5,0,3,5,2,1,1,0,0,14247,6.6,16806,226,41,-1597,-715,22.6,1424.7,38,5,1,5,3,8,1,0,1,0,15844,6.8,17521,218,47,1597,715,21.8,1584.4
4479148881,1,19,3,1,4,5,3,1,1,0,0,15936,7.0,18164,255,56,-189,-709,25.5,1593.6,17,2,0,5,4,4,0,0,0,0,16125,7.4,18873,252,44,189,709,25.2,1612.5
4493402938,0,11,4,1,7,10,5,0,0,0,0,16112,7.0,18155,202,42,-2967,-758,20.2,1611.2,15,1,0,10,7,10,0,0,0,0,19079,7.2,18913,238,45,2967,758,23.8,1907.9
4524213588,0,13,1,0,7,5,6,1,0,1,0,17042,7.4,19460,207,60,934,776,20.7,1704.2,9,0,1,5,7,4,0,0,0,0,16108,7.4,18684,248,48,-934,-776,24.8,1610.8
4513417068,0,15,1,1,3,6,3,1,1,0,0,15299,6.4,17076,230,52,-874,-1276,23.0,1529.9,39,1,0,6,3,6,0,0,0,0,16173,7.0,18352,231,44,874,1276,23.1,1617.3
4436906182,1,13,1,1,4,6,5,0,0,0,0,15420,6.8,16822,235,41,-1633,-2918,23.5,1542.0,17,2,0,6,4,5,1,0,1,0,17053,7.4,19740,253,52,1633,2918,25.3,1705.3
4518770887,0,18,3,0,2,5,5,0,0,0,0,14851,6.6,17101,245,41,-1068,-17,24.5,1485.1,14,1,1,5,2,7,2,1,1,0,15919,6.8,17118,212,46,1068,17,21.2,1591.9
4517945518,1,42,3,1,7,3,4,1,1,0,0,16305,7.0,18269,217,48,1947,1867,21.7,1630.5,13,14,0,3,7,2,0,0,0,0,14358,6.6,16402,180,56,-1947,-1867,18.0,1435.8
4463280330,1,18,2,0,9,9,6,1,1,0,0,18137,7.0,19154,218,62,201,1596,21.8,1813.7,17,3,1,9,9,14,0,0,0,0,17936,6.6,17558,197,61,-201,-1596,19.7,1793.6
4520585674,1,18,5,0,6,4,7,0,0,0,0,16421,7.0,18708,224,44,267,-52,22.4,1642.1,16,9,1,4,6,7,1,1,0,0,16154,7.2,18760,241,55,-267,52,24.1,1615.4
4522207567,1,16,3,1,12,3,11,1,1,0,0,18248,7.4,19855,201,48,3296,3231,20.1,1824.8,12,0,0,3,12,3,0,0,0,0,14952,6.4,16624,201,47,-3296,-3231,20.1,1495.2
4525617953,0,16,1,1,5,7,4,1,1,0,0,16666,7.2,18258,236,64,-790,-741,23.6,1666.6,33,0,0,7,5,7,0,0,0,0,17456,7.2,18999,230,60,790,741,23.0,1745.6
4437489184,0,34,2,0,10,9,9,1,1,0,0,18329,7.0,18315,219,53,947,-188,21.9,1832.9,47,3,1,9,10,11,0,0,0,0,17382,7.2,18503,194,48,-947,188,19.4,1738.2
4525333513,1,17,3,0,6,6,2,0,0,0,0,16047,6.8,17256,218,43,-132,-330,21.8,1604.7,15,5,1,6,6,4,2,1,1,0,16179,6.6,17586,218,64,132,330,21.8,1617.9
4510930492,0,12,1,0,0,5,0,0,0,0,0,13561,6.6,16632,222,56,-2876,-2098,22.2,1356.1,17,2,1,5,0,8,1,1,0,0,16437,7.0,18730,233,59,2876,2098,23.3,1643.7
4525183831,0,46,4,1,4,0,3,1,0,1,0,16346,7.0,19072,272,50,2655,1326,27.2,1634.6,14,2,0,0,4,0,1,1,0,0,13691,6.8,17746,218,69,-2655,-1326,21.8,1369.1
4514530513,0,12,1,0,6,11,5,0,0,0,0,16281,6.8,17569,209,53,-2082,-2125,20.9,1628.1,14,0,1,11,6,9,1,1,0,0,18363,7.4,19694,206,64,2082,2125,20.6,1836.3
4509558169,0,18,3,0,7,7,4,0,0,0,0,16581,7.0,18360,198,54,462,1726,19.8,1658.1,12,2,1,7,7,8,0,0,0,0,16119,6.6,16634,200,47,-462,-1726,20.0,1611.9
4505122795,0,14,3,0,1,5,1,0,0,0,0,14001,6.4,16037,221,52,-2744,-1330,22.1,1400.1,20,3,1,5,1,11,1,1,0,0,16745,7.0,17367,244,44,2744,1330,24.4,1674.5
4482012777,1,67,4,1,9,6,10,0,0,0,0,17742,6.8,18190,185,56,1311,557,18.5,1774.2,14,9,0,6,9,6,1,1,0,0,16431,7.0,17633,232,54,-1311,-557,23.2,1643.1
4512376408,0,11,3,1,8,4,8,1,1,0,0,18385,7.2,19050,244,57,2957,1677,24.4,1838.5,13,4,0,4,8,6,0,0,0,0,15428,6.8,17373,210,46,-2957,-1677,21.0,1542.8
4526586173,0,17,1,0,6,4,5,0,0,0,0,16819,7.0,18039,244,54,1621,128,24.4,1681.9,18,2,1,4,6,2,1,1,0,0,15198,6.8,17911,219,55,-1621,-128,21.9,1519.8
4514381198,1,183,2,0,8,11,8,0,0,0,0,16900,6.8,17296,168,52,-590,527,16.8,1690.0,10,0,1,11,8,10,0,0,0,0,17490,6.4,16769,186,48,590,-527,18.6,1749.0
4525762276,1,17,4,0,8,10,11,1,1,0,0,17541,7.0,18201,216,52,-862,931,21.6,1754.1,128,2,1,10,8,16,0,0,0,0,18403,7.0,17270,219,46,862,-931,21.9,1840.3
4519589584,0,18,1,1,4,2,3,0,0,0,0,15995,7.2,19023,220,72,500,64,22.0,1599.5,12,3,0,2,4,1,2,1,1,0,15495,7.0,18959,234,68,-500,-64,23.4,1549.5
4477030195,0,13,3,0,4,6,6,0,0,0,0,15339,6.6,16302,221,43,-1861,-2532,22.1,1533.9,15,4,1,6,4,10,1,1,0,0,17200,7.0,18834,262,64,1861,2532,26.2,1720.0
4518705910,1,16,3,0,13,3,16,2,1,1,1,20125,7.4,20117,226,43,5900,5188,22.6,2012.5,16,2,1,3,13,8,0,0,0,0,14225,6.2,14929,179,45,-5900,-5188,17.9,1422.5
4515791931,1,16,0,1,12,6,12,2,1,1,0,18661,6.8,18012,197,60,2479,1210,19.7,1866.1,22,2,0,6,12,6,0,0,0,0,16182,6.6,16802,203,44,-2479,-1210,20.3,1618.2
4520873803,1,15,1,0,3,7,5,1,0,1,1,16886,7.0,17965,244,53,75,616,24.4,1688.6,18,0,1,7,3,14,1,1,0,0,16811,7.0,17349,195,60,-75,-616,19.5,1681.1
4488711535,1,17,5,1,7,6,10,0,0,0,0,17013,7.4,19131,230,48,447,1096,23.0,1701.3,123,0,0,6,7,5,1,1,0,0,16566,7.0,18035,228,44,-447,-1096,22.8,1656.6
4520597204,1,14,1,1,7,9,5,1,0,1,1,16730,6.8,17556,180,41,-1237,753,18.0,1673.0,13,2,0,9,7,10,1,1,0,0,17967,6.8,16803,196,57,1237,-753,19.6,1796.7
4456743513,0,17,1,0,5,4,10,1,1,0,0,15976,6.8,17352,232,37,609,-609,23.2,1597.6,14,2,1,4,5,5,1,0,1,0,15367,7.0,17961,235,49,-609,609,23.5,1536.7
4468778049,0,21,6,0,5,2,4,0,0,0,0,15796,7.0,18152,221,58,453,1426,22.1,1579.6,17,2,1,2,5,4,1,1,0,0,15343,6.4,16726,256,55,-453,-1426,25.6,1534.3
4511146118,1,76,3,1,6,4,9,1,1,0,0,17620,7.0,19434,233,64,2387,1411,23.3,1762.0,18,1,0,4,6,7,0,0,0,0,15233,6.8,18023,201,67,-2387,-1411,20.1,1523.3
4502122880,0,17,5,0,6,9,8,0,0,0,0,15890,6.6,15649,199,48,-2039,-2297,19.9,1589.0,59,4,1,9,6,11,1,1,0,0,17929,6.8,17946,223,36,2039,2297,22.3,1792.9
4495641349,0,19,1,0,5,4,6,0,0,0,0,16400,6.8,17409,222,40,492,-1509,22.2,1640.0,13,3,1,4,5,6,1,1,0,0,15908,7.2,18918,220,58,-492,1509,22.0,1590.8
4521748513,0,15,5,1,5,6,5,0,0,0,0,15948,6.8,17169,222,54,-947,-1040,22.2,1594.8,23,3,0,6,5,10,2,1,1,0,16895,6.8,18209,248,51,947,1040,24.8,1689.5
4518889488,1,13,3,1,9,3,13,0,0,0,0,18633,7.0,18698,246,50,2910,856,24.6,1863.3,13,2,0,3,9,4,1,1,0,0,15723,6.8,17842,226,56,-2910,-856,22.6,1572.3
4471271254,1,14,2,1,8,4,9,0,0,0,0,18051,7.2,19471,247,64,2563,2910,24.7,1805.1,15,1,0,4,8,4,0,0,0,0,15488,6.6,16561,233,40,-2563,-2910,23.3,1548.8
4513856068,1,18,3,1,8,7,14,1,1,0,0,17031,6.6,16530,181,54,-36,-641,18.1,1703.1,15,2,0,7,8,8,1,0,1,0,17067,6.8,17171,224,44,36,641,22.4,1706.7
4526338952,1,18,3,1,7,10,11,1,1,0,0,16057,6.8,17123,187,60,-2259,-898,18.7,1605.7,14,1,0,10,7,14,0,0,0,0,18316,6.8,18021,227,32,2259,898,22.7,1831.6
4506951089,0,18,2,0,2,4,2,2,1,1,0,14689,6.8,18046,241,44,-1724,-262,24.1,1468.9,26,4,1,4,2,4,0,0,0,0,16413,7.0,18308,260,52,1724,262,26.0,1641.3
4526693928,0,13,4,0,3,12,2,0,0,0,0,15001,6.8,17600,228,51,-4625,-1892,22.8,1500.1,11,1,1,12,3,16,1,1,0,0,19626,7.2,19492,247,47,4625,1892,24.7,1962.6
4505146259,1,16,4,0,6,8,9,0,0,0,0,15476,6.6,16323,192,40,-963,-546,19.2,1547.6,17,0,1,8,6,7,1,1,0,0,16439,6.6,16869,164,64,963,546,16.4,1643.9
4517636777,1,23,6,1,10,6,13,0,0,0,0,18680,7.2,19206,220,61,2013,1022,22.0,1868.0,20,2,0,6,10,8,2,1,1,0,16667,6.8,18184,210,43,-2013,-1022,21.0,1666.7
4526100030,1,12,3,1,7,4,8,2,1,1,0,17865,7.4,19417,251,48,2871,1581,25.1,1786.5,13,0,0,4,7,4,0,0,0,0,14994,7.2,17836,215,51,-2871,-1581,21.5,1499.4
4521484039,0,11,1,1,4,2,3,0,0,0,0,15270,6.8,17913,225,44,-375,-1283,22.5,1527.0,9,1,0,2,4,1,1,1,0,0,15645,7.4,19196,207,88,375,1283,20.7,1564.5
4477176627,1,17,0,0,4,8,6,1,0,1,0,15891,7.0,18304,222,68,-2132,-484,22.2,1589.1,15,2,1,8,4,13,1,1,0,0,18023,7.0,18788,230,47,2132,484,23.0,1802.3
4515483383,0,12,3,0,2,8,1,0,0,0,0,14183,7.0,17123,221,51,-4625,-1753,22.1,1418.3,15,2,1,8,2,12,1,1,0,0,18808,7.0,18876,248,56,4625,1753,24.8,1880.8
4527216897,0,22,7,1,8,8,10,2,1,1,0,17875,7.2,18665,205,53,984,1142,20.5,1787.5,21,1,0,8,8,8,0,0,0,0,16891,7.0,17523,227,27,-984,-1142,22.7,1689.1
4495787574,1,15,2,0,12,5,16,2,1,1,1,19572,7.0,18020,213,40,3987,1169,21.3,1957.2,14,1,1,5,12,6,0,0,0,0,15585,6.6,16851,193,40,-3987,-1169,19.3,1558.5
4462548167,0,14,2,1,5,9,7,1,1,0,0,15530,6.8,17375,220,60,-2141,-52,22.0,1553.0,40,7,0,9,5,12,1,0,1,0,17671,6.8,17427,236,35,2141,52,23.6,1767.1
4507384593,1,17,3,1,8,7,15,0,0,0,0,17885,6.8,17553,216,47,2071,1096,21.6,1788.5,28,3,0,7,8,10,1,1,0,0,15814,6.6,16457,188,36,-2071,-1096,18.8,1581.4
4474578405,1,15,2,1,2,4,1,2,1,1,0,15131,7.0,18134,239,64,-318,86,23.9,1513.1,17,3,0,4,2,5,0,0,0,0,15449,6.8,18048,216,44,318,-86,21.6,1544.9
4508498519,0,23,4,1,5,11,6,1,1,0,0,14998,6.4,15823,199,60,-4011,-3207,19.9,1499.8,18,1,0,11,5,19,0,0,0,0,19009,7.2,19030,233,64,4011,3207,23.3,1900.9
4464934797,0,50,2,0,6,8,7,0,0,0,0,15270,6.4,17079,181,49,-2630,-2204,18.1,1527.0,18,4,1,8,6,6,1,1,0,0,17900,7.2,19283,238,50,2630,2204,23.8,1790.0
4487705166,1,59,2,0,3,6,6,1,1,0,0,15442,6.8,17518,238,51,-1090,-1499,23.8,1544.2,11,17,1,6,3,6,0,0,0,0,16532,6.8,19017,233,56,1090,1499,23.3,1653.2
4479796051,1,18,4,0,7,4,11,0,0,0,0,17321,7.2,18397,233,41,2091,2518,23.3,1732.1,19,4,1,4,7,6,1,1,0,0,15230,6.6,15879,204,60,-2091,-2518,20.4,1523.0
4434070887,1,16,3,0,14,3,18,1,1,0,0,18413,7.2,19646,196,61,3994,3953,19.6,1841.3,15,1,1,3,14,2,0,0,0,0,14419,6.2,15693,213,40,-3994,-3953,21.3,1441.9
4515508152,0,12,2,0,3,8,4,1,1,0,0,14580,6.6,16446,203,55,-4591,-1620,20.3,1458.0,14,1,1,8,3,6,0,0,0,1,19171,6.8,18066,241,45,4591,1620,24.1,1917.1
4513277280,0,37,3,0,1,3,1,1,0,1,0,15373,7.0,18233,264,80,599,754,26.4,1537.3,43,3,1,3,1,3,0,0,0,0,14774,6.8,17479,212,48,-599,-754,21.2,1477.4
4526131231,0,15,3,1,9,6,9,1,1,0,0,17004,6.4,17216,185,44,2253,772,18.5,1700.4,14,1,0,6,9,3,0,0,0,0,14751,6.6,16444,163,44,-2253,-772,16.3,1475.1
4432016778,0,14,3,0,12,8,13,0,0,0,0,19306,7.4,19792,218,32,1087,340,21.8,1930.6,18,0,1,8,12,8,2,1,1,0,18219,7.4,19452,222,60,-1087,-340,22.2,1821.9
4475220338,0,35,1,0,3,10,1,1,0,1,0,15084,6.8,17618,188,54,-3847,-933,18.8,1508.4,13,1,1,10,3,11,1,1,0,1,18931,6.8,18551,232,37,3847,933,23.2,1893.1
4485610478,1,14,5,1,5,9,8,0,0,0,0,14927,6.6,15638,196,25,-2614,-1880,19.6,1492.7,17,3,0,9,5,16,1,1,0,0,17541,6.8,17518,214,47,2614,1880,21.4,1754.1
4522089965,1,16,2,0,6,7,3,0,0,0,0,16370,6.6,16868,231,48,-129,-726,23.1,1637.0,42,3,1,7,6,8,0,0,0,0,16499,7.0,17594,182,44,129,726,18.2,1649.9
4522419408,0,16,4,0,2,2,0,1,0,1,0,13742,6.8,17269,208,52,-2296,-1213,20.8,1374.2,15,2,1,2,2,1,1,1,0,0,16038,6.8,18482,250,52,2296,1213,25.0,1603.8
4465315065,0,21,4,0,2,9,1,0,0,0,0,13709,6.4,15514,199,40,-4681,-2497,19.9,1370.9,18,4,1,9,2,18,1,1,0,0,18390,7.0,18011,230,51,4681,2497,23.0,1839.0
4519911562,0,16,3,0,1,3,1,0,0,0,0,14988,7.2,18065,256,44,428,-36,25.6,1498.8,19,3,1,3,1,1,1,1,0,0,14560,7.0,18101,220,56,-428,36,22.0,1456.0
4518760937,1,38,6,1,6,2,6,2,1,1,0,16149,6.8,18239,220,45,1819,1262,22.0,1614.9,17,0,0,2,6,1,0,0,0,0,14330,6.6,16977,206,54,-1819,-1262,20.6,1433.0
4525248629,1,34,3,1,8,5,9,1,1,0,0,16840,7.2,18289,185,74,1015,1543,18.5,1684.0,79,3,0,5,8,7,1,0,1,0,15825,6.6,16746,195,38,-1015,-1543,19.5,1582.5
4526352878,1,18,3,0,9,11,16,0,0,0,0,17174,6.8,16698,186,33,-1682,-2102,18.6,1717.4,20,3,1,11,9,15,1,1,0,0,18856,7.2,18800,221,81,1682,2102,22.1,1885.6
4481738259,1,15,2,1,4,1,7,0,0,0,0,16327,7.4,19683,240,73,2246,2898,24.0,1632.7,15,1,0,1,4,2,0,0,0,0,14081,7.0,16785,235,42,-2246,-2898,23.5,1408.1
4492894390,1,11,3,0,11,4,15,1,1,0,0,18565,7.4,19562,216,58,1719,1703,21.6,1856.5,11,2,1,4,11,5,0,0,0,0,16846,7.0,17859,242,57,-1719,-1703,24.2,1684.6
4415420855,0,13,3,0,5,5,7,0,0,0,0,15903,6.8,17896,206,55,811,241,20.6,1590.3,15,2,1,5,5,2,0,0,0,0,15092,7.0,17655,199,52,-811,-241,19.9,1509.2
4496026567,0,20,13,0,5,8,6,0,0,0,0,15356,6.8,16700,207,36,-2416,-3217,20.7,1535.6,42,3,1,8,5,8,0,0,0,0,17772,7.4,19917,239,62,2416,3217,23.9,1777.2
4523821481,1,15,6,1,14,3,17,1,1,0,0,20005,7.4,20561,222,68,5201,4398,22.2,2000.5,71,1,0,3,14,3,0,0,0,0,14804,6.6,16163,211,44,-5201,-4398,21.1,1480.4
4518499489,0,16,2,0,2,11,2,0,0,0,0,13494,5.8,14660,213,24,-5020,-4792,21.3,1349.4,14,3,1,11,2,9,1,1,0,0,18514,7.4,19452,246,57,5020,4792,24.6,1851.4
4525790014,1,11,3,1,5,3,2,0,0,0,0,15934,7.0,18258,251,52,943,505,25.1,1593.4,16,0,0,3,5,2,1,1,0,0,14991,7.0,17753,231,56,-943,-505,23.1,1499.1
4503463273,1,14,0,1,10,10,14,1,1,0,1,19177,7.0,17889,197,60,759,-221,19.7,1917.7,14,2,0,10,10,11,1,0,1,1,18418,7.0,18110,178,43,-759,221,17.8,1841.8
4500702023,1,26,7,1,2,3,6,0,0,0,0,15439,7.0,18214,250,55,567,1168,25.0,1543.9,45,7,0,3,2,6,1,0,1,0,14872,6.6,17046,225,40,-567,-1168,22.5,1487.2
4492726394,0,9,8,1,5,5,5,1,1,0,0,15103,6.6,17162,198,39,-1328,-317,19.8,1510.3,18,2,0,5,5,7,1,0,1,0,16431,7.0,17479,227,36,1328,317,22.7,1643.1
4487090574,1,16,2,1,9,4,11,0,0,0,0,17312,7.0,19125,217,44,2344,1517,21.7,1731.2,39,4,0,4,9,4,0,0,0,0,14968,6.8,17608,201,59,-2344,-1517,20.1,1496.8
4481561513,0,23,4,0,5,5,6,1,1,0,0,16270,7.2,18195,223,54,748,-77,22.3,1627.0,39,7,1,5,5,5,0,0,0,0,15522,6.8,18272,208,55,-748,77,20.8,1552.2
4511150138,1,40,5,0,3,4,3,1,1,0,0,15458,7.2,19132,219,64,98,984,21.9,1545.8,16,3,1,4,3,2,0,0,0,0,15360,7.0,18148,240,48,-98,-984,24.0,1536.0
4519754998,1,27,1,1,6,5,4,0,0,0,0,16789,7.0,19024,218,72,959,917,21.8,1678.9,17,3,0,5,6,5,1,1,0,0,15830,7.0,18107,213,52,-959,-917,21.3,1583.0
4456255419,0,18,4,0,2,7,3,0,0,0,0,14613,6.6,16611,219,44,-3238,-4114,21.9,1461.3,16,4,1,7,2,8,1,1,0,0,17851,7.6,20725,255,64,3238,4114,25.5,1785.1
4519715253,0,50,1,1,7,1,5,0,0,0,1,18193,7.0,18289,225,52,4939,2073,22.5,1819.3,193,0,0,1,7,0,0,0,0,0,13254,6.6,16216,175,66,-4939,-2073,17.5,1325.4
4509828570,1,15,1,1,7,4,7,0,0,0,0,16985,7.2,18420,248,32,992,393,24.8,1698.5,14,1,0,4,7,5,1,1,0,0,15993,6.6,18027,229,65,-992,-393,22.9,1599.3
4467893176,1,13,2,1,8,5,9,1,1,0,0,17643,6.6,17308,226,48,2331,25,22.6,1764.3,14,5,0,5,8,4,0,0,0,0,15312,6.8,17283,193,36,-2331,-25,19.3,1531.2
4478653874,0,10,2,0,1,6,0,1,0,1,0,14059,6.8,17446,213,48,-2160,-88,21.3,1405.9,16,3,1,6,1,10,1,1,0,0,16219,6.8,17534,204,43,2160,88,20.4,1621.9
4486836964,0,12,2,0,3,8,4,0,0,0,0,15330,6.4,16378,205,66,-3277,-1680,20.5,1533.0,16,1,1,8,3,12,2,1,1,1,18607,6.8,18058,220,56,3277,1680,22.0,1860.7
4526160406,1,14,1,0,10,4,12,0,0,0,0,19621,7.6,20681,261,60,4091,2830,26.1,1962.1,15,1,1,4,10,6,1,1,0,0,15530,6.8,17851,202,68,-4091,-2830,20.2,1553.0
4500995168,1,15,2,0,8,9,11,1,1,0,0,17592,6.8,17635,214,52,-134,-565,21.4,1759.2,18,3,1,9,8,10,0,0,0,0,17726,7.0,18200,221,45,134,565,22.1,1772.6
4510116594,1,18,2,1,10,5,9,1,0,1,1,19204,7.2,20182,228,59,4424,4969,22.8,1920.4,12,1,0,5,10,8,1,1,0,0,14780,6.4,15213,187,36,-4424,-4969,18.7,1478.0
4472532304,0,16,3,0,4,9,5,1,0,1,0,14354,6.4,15677,173,49,-4324,-2979,17.3,1435.4,30,3,1,9,4,13,1,1,0,0,18678,7.0,18656,213,55,4324,2979,21.3,1867.8
4469891121,1,15,3,0,7,3,5,1,0,1,0,17060,7.2,19600,242,61,2207,2836,24.2,1706.0,15,3,1,3,7,3,1,1,0,0,14853,6.6,16764,219,68,-2207,-2836,21.9,1485.3
4508960855,1,37,5,1,10,7,12,1,1,0,0,17176,6.8,17299,188,57,99,277,18.8,1717.6,22,1,0,7,10,8,0,0,0,1,17077,6.6,17022,203,38,-99,-277,20.3,1707.7
4527179448,0,54,4,0,3,5,2,1,1,0,0,15630,7.2,18026,236,57,-1655,-881,23.6,1563.0,15,3,1,5,3,6,0,0,0,0,17285,7.0,18907,257,56,1655,881,25.7,1728.5
4522025457,0,12,1,1,13,6,14,0,0,0,1,20317,7.0,18795,199,42,3899,2300,19.9,2031.7,14,2,0,6,13,9,1,1,0,0,16418,6.4,16495,197,56,-3899,-2300,19.7,1641.8
4471458377,0,17,3,0,5,9,7,1,0,1,0,16096,7.0,17359,224,45,-581,146,22.4,1609.6,16,2,1,9,5,8,0,0,0,0,16677,6.8,17213,204,43,581,-146,20.4,1667.7
4512033848,1,16,4,1,7,5,7,1,0,1,0,17271,7.0,18144,246,51,2369,2245,24.6,1727.1,20,4,0,5,7,4,1,1,0,0,14902,6.4,15899,190,56,-2369,-2245,19.0,1490.2
4477995331,0,66,2,1,8,8,13,0,0,0,0,17191,6.8,17401,188,56,654,478,18.8,1719.1,15,1,0,8,8,9,1,1,0,0,16537,6.6,16923,191,57,-654,-478,19.1,1653.7
4519369420,0,39,7,1,6,6,10,0,0,0,0,16889,6.8,17536,240,28,505,-255,24.0,1688.9,17,3,0,6,6,6,1,1,0,0,16384,7.0,17791,230,53,-505,255,23.0,1638.4
4459776671,0,13,4,1,4,8,8,0,0,0,0,15720,6.4,15834,212,44,-2510,-4246,21.2,1572.0,43,2,0,8,4,5,2,1,1,0,18230,7.2,20080,249,75,2510,4246,24.9,1823.0
4463214221,0,20,1,0,5,5,10,1,1,0,0,15847,6.8,17480,203,68,-1015,-1395,20.3,1584.7,13,6,1,5,5,9,1,0,1,0,16862,7.2,18875,256,52,1015,1395,25.6,1686.2
4494477882,1,17,3,1,8,6,8,1,1,0,0,16563,7.2,18469,199,46,498,244,19.9,1656.3,14,2,0,6,8,2,0,0,0,0,16065,7.0,18225,209,41,-498,-244,20.9,1606.5
4522502603,1,15,7,1,11,7,6,1,0,1,0,18317,7.2,19636,229,59,2214,1305,22.9,1831.7,20,2,0,7,11,8,0,0,0,0,16103,7.0,18331,204,48,-2214,-1305,20.4,1610.3
4502741131,0,17,1,1,10,7,13,0,0,0,0,18446,7.2,19075,195,44,1918,1638,19.5,1844.6,11,2,0,7,10,8,2,1,1,0,16528,7.0,17437,191,48,-1918,-1638,19.1,1652.8
4474911318,1,21,2,1,3,2,3,2,1,1,0,14992,6.8,17212,217,48,499,-2,21.7,1499.2,16,3,0,2,3,3,0,0,0,0,14493,7.0,17214,230,31,-499,2,23.0,1449.3
4525623661,1,13,2,1,4,1,1,1,1,0,0,16070,7.0,18706,251,56,2422,1766,25.1,1607.0,13,1,0,1,4,3,0,0,0,0,13648,6.6,16940,199,52,-2422,-1766,19.9,1364.8
4520943763,1,13,16,1,9,8,13,1,1,0,0,17060,6.8,17673,207,64,143,845,20.7,1706.0,39,3,0,8,9,7,0,0,0,0,16917,6.6,16828,212,48,-143,-845,21.2,1691.7
4527328418,0,15,4,1,8,10,11,0,0,0,0,16671,7.0,17530,181,39,-1141,-630,18.1,1667.1,16,2,0,10,8,5,1,0,1,0,17812,6.8,18160,216,48,1141,630,21.6,1781.2
4511605459,1,16,3,1,6,2,8,1,1,0,0,17368,7.2,18140,252,56,3524,2086,25.2,1736.8,14,2,0,2,6,2,0,0,0,0,13844,6.4,16054,195,54,-3524,-2086,19.5,1384.4
4527381514,0,15,3,0,2,8,1,1,1,0,0,14426,6.6,17051,210,60,-2709,-1468,21.0,1442.6,12,4,1,8,2,9,0,0,0,0,17135,7.0,18519,239,48,2709,1468,23.9,1713.5
4455452551,1,24,5,0,8,10,5,0,0,0,0,17538,7.0,18073,224,41,238,840,22.4,1753.8,16,4,1,10,8,10,1,1,0,0,17300,6.8,17233,191,46,-238,-840,19.1,1730.0
4420650746,1,17,11,0,6,6,6,1,1,0,0,16538,7.4,18750,231,52,-626,239,23.1,1653.8,42,4,1,6,6,10,1,0,1,0,17164,6.8,18511,230,43,626,-239,23.0,1716.4
4527127761,1,17,3,1,4,4,3,0,0,0,0,15812,7.0,17970,241,42,650,128,24.1,1581.2,11,0,0,4,4,4,1,1,0,0,15162,6.8,17842,198,67,-650,-128,19.8,1516.2
4524604603,1,19,3,1,8,6,7,0,0,0,0,17394,6.8,17390,199,68,1377,-221,19.9,1739.4,13,2,0,6,8,5,2,1,1,0,16017,6.8,17611,218,55,-1377,221,21.8,1601.7
4524898178,0,11,2,0,4,10,4,0,0,0,0,15028,6.8,17417,207,52,-3472,-2256,20.7,1502.8,19,1,1,10,4,5,1,1,0,0,18500,7.4,19673,230,52,3472,2256,23.0,1850.0
4517892829,0,8,3,0,2,4,1,0,0,0,0,14856,6.8,18155,240,51,-1129,-1348,24.0,1485.6,34,0,1,4,2,4,1,1,0,0,15985,7.4,19503,225,51,1129,1348,22.5,1598.5
4508892173,1,13,2,1,11,4,10,1,0,1,0,18706,7.2,19465,243,55,3787,2856,24.3,1870.6,15,0,0,4,11,4,0,0,0,0,14919,6.8,16609,202,48,-3787,-2856,20.2,1491.9
4505788319,0,19,1,1,7,6,8,1,1,0,0,17575,6.4,17019,209,41,961,-973,20.9,1757.5,16,2,0,6,7,8,0,0,0,0,16614,7.0,17992,208,54,-961,973,20.8,1661.4
4503545828,1,52,3,1,8,7,8,0,0,0,0,18078,7.0,18614,261,48,1204,306,26.1,1807.8,37,2,0,7,8,7,1,1,0,0,16874,6.8,18308,204,52,-1204,-306,20.4,1687.4
4513468208,1,15,4,0,5,11,6,0,0,0,0,14813,6.8,16945,182,43,-3707,-1742,18.2,1481.3,19,3,1,11,5,10,2,1,1,0,18520,7.2,18687,225,60,3707,1742,22.5,1852.0
4483620406,0,19,2,0,3,6,1,1,0,1,0,14499,7.0,18406,201,68,-3079,-1816,20.1,1449.9,13,4,1,6,3,4,1,1,0,0,17578,7.2,20222,245,63,3079,1816,24.5,1757.8
4465050280,0,143,5,1,10,7,10,1,1,0,0,17665,7.4,18125,213,37,625,-1035,21.3,1766.5,15,2,0,7,10,4,0,0,0,0,17040,7.2,19160,228,71,-625,1035,22.8,1704.0
4526466522,0,16,3,0,4,8,3,0,0,0,0,14756,6.8,17655,184,56,-4105,-2279,18.4,1475.6,16,2,1,8,4,8,1,1,0,0,18861,7.4,19934,229,63,4105,2279,22.9,1886.1
4527154540,0,167,1,1,5,8,6,0,0,0,0,16007,6.8,17474,206,52,-1729,-2105,20.6,1600.7,18,2,0,8,5,8,2,1,1,0,17736,7.4,19579,209,64,1729,2105,20.9,1773.6
4525088163,0,14,2,0,6,7,8,0,0,0,0,15532,6.8,17908,190,48,-1779,-354,19.0,1553.2,16,1,1,7,6,4,0,0,0,0,17311,7.0,18262,242,48,1779,354,24.2,1731.1
4502255242,0,16,2,1,6,4,7,1,1,0,0,16643,7.0,18300,215,51,1515,590,21.5,1664.3,25,2,0,4,6,4,0,0,0,0,15128,6.8,17710,207,56,-1515,-590,20.7,1512.8
4498628249,1,20,4,1,8,8,12,1,1,0,0,16796,6.6,16424,185,48,700,1221,18.5,1679.6,15,3,0,8,8,14,0,0,0,0,16096,6.2,15203,175,28,-700,-1221,17.5,1609.6
4451379938,1,40,0,0,6,6,3,0,0,0,0,17001,7.2,19154,230,68,344,1270,23.0,1700.1,17,2,1,6,6,5,0,0,0,0,16657,7.0,17884,255,32,-344,-1270,25.5,1665.7
4525945422,1,16,4,1,4,7,4,0,0,0,0,15613,6.6,18046,244,46,-1002,-498,24.4,1561.3,59,2,0,7,4,9,2,1,1,0,16615,7.0,18544,181,60,1002,498,18.1,1661.5
4519411417,1,14,1,0,9,6,12,0,0,0,0,17359,7.2,18731,225,34,887,346,22.5,1735.9,14,1,1,6,9,2,0,0,0,0,16472,6.8,18385,237,54,-887,-346,23.7,1647.2
4493134944,0,15,2,0,5,8,5,0,0,0,0,16221,7.0,17699,216,64,-1437,-1656,21.6,1622.1,39,2,1,8,5,4,2,1,1,0,17658,7.2,19355,227,68,1437,1656,22.7,1765.8
4524608366,0,16,7,0,6,7,6,1,1,0,0,17273,7.2,18685,226,64,292,760,22.6,1727.3,21,1,1,7,6,10,0,0,0,0,16981,6.8,17925,225,47,-292,-760,22.5,1698.1
4527078331,1,8,1,1,8,4,7,1,1,0,0,18257,7.0,19371,246,60,3149,1513,24.6,1825.7,15,1,0,4,8,1,0,0,0,0,15108,6.8,17858,227,61,-3149,-1513,22.7,1510.8
4512485280,1,16,3,0,8,2,10,0,0,0,0,17917,7.0,17502,239,48,3201,276,23.9,1791.7,14,2,1,2,8,3,1,1,0,0,14716,6.8,17226,197,72,-3201,-276,19.7,1471.6
4516913135,0,15,2,0,5,14,3,0,0,0,0,15424,6.8,17248,191,35,-4585,-3125,19.1,1542.4,15,4,1,14,5,13,2,1,1,0,20009,7.4,20373,228,56,4585,3125,22.8,2000.9
4526235126,1,15,2,1,5,3,9,0,0,0,0,16952,7.2,19223,239,52,790,83,23.9,1695.2,14,4,0,3,5,3,0,0,0,0,16162,7.2,19140,251,76,-790,-83,25.1,1616.2
4527332360,1,56,4,0,2,5,3,0,0,0,0,14732,6.8,17531,210,52,-1461,-799,21.0,1473.2,13,10,1,5,2,6,1,1,0,0,16193,7.2,18330,240,55,1461,799,24.0,1619.3
4469401946,0,13,7,1,11,10,20,1,0,1,0,17949,6.6,16183,172,41,-431,-1022,17.2,1794.9,45,1,0,10,11,10,1,1,0,0,18380,6.6,17205,207,48,431,1022,20.7,1838.0
4518900099,0,19,3,0,6,10,12,1,1,0,0,15693,6.6,16140,177,36,-2794,-2688,17.7,1569.3,16,2,1,10,6,17,0,0,0,0,18487,7.2,18828,237,57,2794,2688,23.7,1848.7
4519816052,0,16,4,0,7,11,6,1,0,1,0,16446,7.0,18130,218,50,-3620,-282,21.8,1644.6,13,3,1,11,7,16,0,0,0,1,20066,6.8,18412,229,34,3620,282,22.9,2006.6
4523481420,0,38,5,0,4,5,3,1,0,1,0,16147,7.0,18863,222,55,482,914,22.2,1614.7,19,2,1,5,4,4,1,1,0,0,15665,7.0,17949,199,54,-482,-914,19.9,1566.5
4505220147,0,17,3,0,4,11,7,0,0,0,0,15224,6.8,16862,189,43,-3595,-1973,18.9,1522.4,19,4,1,11,4,11,1,1,0,0,18819,7.0,18835,221,68,3595,1973,22.1,1881.9
4520529176,1,17,3,1,9,5,10,2,1,1,0,18283,7.2,18731,226,59,2684,1191,22.6,1828.3,41,3,0,5,9,4,0,0,0,0,15599,7.0,17540,211,37,-2684,-1191,21.1,1559.9
4458543967,1,14,2,1,8,4,14,1,1,0,0,16924,6.6,17168,194,59,1258,-124,19.4,1692.4,13,0,0,4,8,5,0,0,0,0,15666,6.8,17292,220,52,-1258,124,22.0,1566.6
4426644547,1,14,4,1,7,7,6,0,0,0,1,19229,7.2,18820,257,62,3545,2162,25.7,1922.9,19,3,0,7,7,10,1,1,0,0,15684,6.6,16658,145,36,-3545,-2162,14.5,1568.4
4516924172,1,14,2,1,8,10,3,1,0,1,0,16674,6.8,18357,223,40,-1577,-716,22.3,1667.4,81,1,0,10,8,11,0,0,0,0,18251,7.0,19073,209,50,1577,716,20.9,1825.1
4523902957,0,15,3,1,7,3,10,1,1,0,0,16578,7.0,18139,200,62,1159,1510,20.0,1657.8,14,2,0,3,7,3,0,0,0,0,15419,6.6,16629,250,41,-1159,-1510,25.0,1541.9
4515724067,0,15,2,0,5,7,5,0,0,0,0,16394,7.0,18234,251,42,-127,515,25.1,1639.4,29,4,1,7,5,12,1,1,0,0,16521,7.0,17719,194,60,127,-515,19.4,1652.1
4467732013,0,16,2,0,4,10,4,1,0,1,0,15651,7.0,17696,224,53,-2699,-2749,22.4,1565.1,30,2,1,10,4,11,1,1,0,0,18350,7.4,20445,201,54,2699,2749,20.1,1835.0
4457404294,1,16,5,1,17,10,25,0,0,0,1,23335,7.6,20839,239,52,6790,5348,23.9,2333.5,14,0,0,10,17,11,0,0,0,0,16545,6.4,15491,129,26,-6790,-5348,12.9,1654.5
4523806048,0,16,2,1,5,3,6,1,1,0,0,15946,7.0,18587,223,51,1433,1278,22.3,1594.6,46,4,0,3,5,2,0,0,0,0,14513,7.0,17309,183,54,-1433,-1278,18.3,1451.3
4518401885,0,13,3,1,2,7,1,1,1,0,0,13828,6.6,16629,204,38,-2622,-1136,20.4,1382.8,12,0,0,7,2,7,0,0,0,0,16450,6.8,17765,192,36,2622,1136,19.2,1645.0
4438792518,1,17,2,1,5,2,5,1,1,0,0,16326,7.0,18135,217,60,1697,293,21.7,1632.6,11,1,0,2,5,2,1,0,1,0,14629,6.6,17842,246,40,-1697,-293,24.6,1462.9
4468727943,0,12,0,1,3,7,4,1,1,0,0,14688,6.8,16866,199,52,-2193,-1574,19.9,1468.8,11,2,0,7,3,10,0,0,0,0,16881,7.0,18440,217,44,2193,1574,21.7,1688.1
4510779224,0,14,2,1,3,7,1,0,0,0,0,15023,7.0,17982,222,60,-2942,-2574,22.2,1502.3,16,4,0,7,3,8,1,1,0,0,17965,7.6,20556,228,72,2942,2574,22.8,1796.5
4488507163,0,17,2,0,7,11,13,1,1,0,0,16225,6.6,17213,206,56,-2463,-2163,20.6,1622.5,17,3,1,11,7,13,0,0,0,0,18688,7.4,19376,224,36,2463,2163,22.4,1868.8
4520937414,0,15,1,1,1,8,0,0,0,0,0,13415,6.4,16177,215,43,-5048,-4231,21.5,1341.5,17,6,0,8,1,8,1,1,0,0,18463,7.6,20408,264,51,5048,4231,26.4,1846.3
4519687023,1,18,1,0,2,6,2,0,0,0,0,14071,6.8,16114,231,47,-2633,-1640,23.1,1407.1,13,4,1,6,2,6,1,1,0,0,16704,6.8,17754,238,52,2633,1640,23.8,1670.4
4520543348,1,20,4,1,5,2,4,2,1,1,0,16071,6.8,17618,224,44,1723,1090,22.4,1607.1,19,2,0,2,5,3,0,0,0,0,14348,6.6,16528,210,47,-1723,-1090,21.0,1434.8
4495217197,1,19,5,1,5,0,4,1,1,0,0,16797,7.2,19788,268,55,2234,1897,26.8,1679.7,19,5,0,0,5,0,0,0,0,0,14563,6.8,17891,273,57,-2234,-1897,27.3,1456.3
4526307631,1,14,2,0,6,4,8,1,1,0,0,17081,7.2,18350,226,58,2061,924,22.6,1708.1,18,2,1,4,6,3,0,0,0,0,15020,6.8,17426,218,44,-2061,-924,21.8,1502.0
4490472819,0,15,2,1,8,8,5,0,0,0,0,16795,6.8,18159,235,48,-507,-790,23.5,1679.5,17,2,0,8,8,9,1,0,1,0,17302,7.2,18949,203,56,507,790,20.3,1730.2
4503692429,0,13,2,0,1,9,1,0,0,0,0,13508,6.6,15474,186,50,-5373,-4474,18.6,1350.8,15,4,1,9,1,11,2,1,1,0,18881,7.2,19948,241,49,5373,4474,24.1,1888.1
4496397328,1,42,4,1,8,5,10,1,1,0,0,17886,7.4,20099,229,59,1824,1409,22.9,1788.6,14,1,0,5,8,5,0,0,0,0,16062,7.2,18690,222,60,-1824,-1409,22.2,1606.2
4516768081,0,17,2,0,4,5,4,0,0,0,0,15714,6.8,17852,243,63,-46,-458,24.3,1571.4,13,3,1,5,4,4,2,1,1,0,15760,7.2,18310,193,56,46,458,19.3,1576.0
4453662166,0,13,3,0,8,7,9,0,0,0,0,16973,7.0,18421,204,46,929,1800,20.4,1697.3,17,4,1,7,8,4,0,0,0,0,16044,6.8,16621,203,48,-929,-1800,20.3,1604.4
4526999717,0,17,2,0,5,6,8,0,0,0,0,15259,6.6,15471,180,52,-3967,-3114,18.0,1525.9,12,1,1,6,5,8,0,0,0,2,19226,7.0,18585,247,60,3967,3114,24.7,1922.6
4463540440,0,34,2,1,5,8,3,0,0,0,0,16422,7.0,18934,247,52,-509,-196,24.7,1642.2,15,1,0,8,5,8,1,1,0,0,16931,6.8,19130,218,48,509,196,21.8,1693.1
4491740882,0,13,3,0,2,9,2,0,0,0,0,14663,6.4,15958,228,44,-3148,-2856,22.8,1466.3,17,2,1,9,2,13,1,1,0,0,17811,7.2,18814,215,64,3148,2856,21.5,1781.1
4490211432,1,18,4,0,6,10,9,0,0,0,0,15445,6.4,16320,188,40,-3473,-1314,18.8,1544.5,15,2,1,10,6,11,0,0,0,0,18918,6.8,17634,217,40,3473,1314,21.7,1891.8
4518026363,1,17,0,1,15,7,15,1,1,0,1,21755,7.2,18071,191,48,5494,1987,19.1,2175.5,10,2,0,7,15,7,0,0,0,0,16261,6.4,16084,168,44,-5494,-1987,16.8,1626.1
4512250515,1,18,4,1,6,0,8,1,1,0,0,16583,7.0,18572,244,64,2532,1722,24.4,1658.3,17,1,0,0,6,0,0,0,0,0,14051,6.6,16850,223,56,-2532,-1722,22.3,1405.1
4527613932,0,12,2,1,6,3,5,0,0,0,0,16007,6.8,17907,221,40,1201,695,22.1,1600.7,12,0,0,3,6,3,1,1,0,0,14806,6.8,17212,209,40,-1201,-695,20.9,1480.6
4455416243,1,18,1,1,7,6,6,0,0,0,1,17462,7.0,18011,210,52,1323,1994,21.0,1746.2,15,4,0,6,7,8,0,0,0,0,16139,6.4,16017,215,54,-1323,-1994,21.5,1613.9
4525999060,0,46,2,0,3,6,0,1,0,1,0,14984,7.0,18050,235,64,-1287,-746,23.5,1498.4,19,3,1,6,3,3,1,1,0,0,16271,7.0,18796,237,58,1287,746,23.7,1627.1
4524476319,0,44,9,1,7,5,5,0,0,0,0,16858,7.0,18305,241,44,1153,930,24.1,1685.8,25,13,0,5,7,11,1,1,0,0,15705,7.0,17375,211,46,-1153,-930,21.1,1570.5
4459239621,0,14,4,1,5,10,4,0,0,0,0,15917,6.8,17246,200,60,-1971,-2626,20.0,1591.7,16,2,0,10,5,13,2,1,1,0,17888,7.2,19872,200,56,1971,2626,20.0,1788.8
4492356958,1,18,3,1,12,12,13,1,1,0,0,19131,7.0,18354,209,38,-1025,-1860,20.9,1913.1,17,2,0,12,12,9,1,0,1,1,20156,7.6,20214,220,52,1025,1860,22.0,2015.6
4512935450,0,12,2,0,6,13,10,1,0,1,0,16083,6.6,16509,218,52,-2772,-2957,21.8,1608.3,15,5,1,13,6,11,1,1,0,0,18855,7.2,19466,207,52,2772,2957,20.7,1885.5
4521341731,0,103,2,1,5,5,8,0,0,0,0,15473,6.8,17268,219,36,-130,-423,21.9,1547.3,17,1,0,5,5,7,0,0,0,0,15603,7.0,17691,221,51,130,423,22.1,1560.3
4480049039,0,14,3,0,6,7,8,1,1,0,0,15390,6.8,17104,194,47,-1423,-1150,19.4,1539.0,19,0,1,7,6,3,0,0,0,0,16813,7.2,18254,218,56,1423,1150,21.8,1681.3
4524429073,0,15,0,0,9,7,10,0,0,0,0,17352,6.6,17764,220,45,612,678,22.0,1735.2,16,1,1,7,9,3,1,1,0,0,16740,6.8,17086,223,48,-612,-678,22.3,1674.0
4523322393,1,16,2,0,4,4,3,0,0,0,0,15502,6.6,17035,221,53,631,1404,22.1,1550.2,21,2,1,4,4,5,1,1,0,0,14871,6.4,15631,207,48,-631,-1404,20.7,1487.1
4518805877,1,14,3,1,8,10,10,1,1,0,0,17766,7.2,18700,229,54,-680,-703,22.9,1776.6,15,2,0,10,8,12,0,0,0,0,18446,7.0,19403,243,41,680,703,24.3,1844.6
4521767127,1,17,5,1,9,3,7,0,0,0,0,17990,7.0,19289,226,51,2964,2253,22.6,1799.0,17,1,0,3,9,4,1,1,0,0,15026,6.4,17036,232,41,-2964,-2253,23.2,1502.6
4467297984,1,13,2,1,8,10,5,1,1,0,0,17136,6.8,18329,224,60,-506,-700,22.4,1713.6,14,3,0,10,8,7,0,0,0,0,17642,7.2,19029,218,34,506,700,21.8,1764.2
4480568800,1,15,5,0,7,5,6,1,0,1,0,17323,7.2,18801,240,49,1248,-243,24.0,1732.3,21,2,1,5,7,4,1,1,0,0,16075,7.2,19044,222,58,-1248,243,22.2,1607.5
4521186750,0,13,3,1,4,4,5,0,0,0,0,15801,7.2,18475,206,65,-187,-361,20.6,1580.1,17,2,0,4,4,3,1,1,0,0,15988,7.2,18836,251,66,187,361,25.1,1598.8
4451815027,0,13,5,0,5,4,8,0,0,0,0,16059,7.0,18553,216,48,-1694,-1,21.6,1605.9,22,6,1,4,5,5,2,1,1,1,17753,7.2,18554,231,52,1694,1,23.1,1775.3
4501002561,1,15,2,1,7,3,5,1,0,1,0,16178,7.2,18656,216,47,381,203,21.6,1617.8,16,1,0,3,7,3,1,1,0,0,15797,7.0,18453,253,52,-381,-203,25.3,1579.7
4497452611,0,19,7,0,3,4,5,0,0,0,0,15347,6.8,17612,243,48,-704,-193,24.3,1534.7,14,2,1,4,3,3,1,1,0,0,16051,6.8,17805,220,60,704,193,22.0,1605.1
4462059327,0,13,2,0,5,6,5,0,0,0,0,16084,6.8,17317,219,46,-859,-2114,21.9,1608.4,17,1,1,6,5,5,1,1,0,0,16943,7.4,19431,244,60,859,2114,24.4,1694.3
4524114538,1,43,5,0,4,7,11,0,0,0,0,14657,6.2,15612,194,48,-2710,-2319,19.4,1465.7,14,2,1,7,4,9,1,1,0,0,17367,7.0,17931,227,60,2710,2319,22.7,1736.7
4524572866,1,21,5,1,7,2,8,0,0,0,0,17314,7.2,18785,207,47,3307,1705,20.7,1731.4,18,1,0,2,7,3,2,1,1,0,14007,7.0,17080,195,48,-3307,-1705,19.5,1400.7
4522165708,1,14,2,1,6,8,5,0,0,0,0,15913,6.8,16789,197,45,-483,320,19.7,1591.3,16,2,0,8,6,7,1,0,1,0,16396,6.6,16469,187,44,483,-320,18.7,1639.6
4451728013,0,15,7,0,11,3,14,0,0,0,0,18754,7.6,20402,202,52,4074,3921,20.2,1875.4,34,1,1,3,11,6,1,1,0,0,14680,6.8,16481,200,44,-4074,-3921,20.0,1468.0
4469829210,1,34,1,1,9,4,10,2,1,1,0,18303,7.2,19140,263,58,2642,366,26.3,1830.3,16,0,0,4,9,2,0,0,0,0,15661,7.0,18774,231,49,-2642,-366,23.1,1566.1
4479288028,1,27,5,1,4,6,3,2,1,1,0,16485,7.2,19097,250,68,-264,315,25.0,1648.5,38,3,0,6,4,9,0,0,0,0,16749,7.2,18782,233,49,264,-315,23.3,1674.9
4488824515,0,16,3,1,7,9,4,1,1,0,0,16808,6.8,17370,231,38,-361,1686,23.1,1680.8,18,2,0,9,7,13,0,0,0,0,17169,6.4,15684,214,35,361,-1686,21.4,1716.9
4526831999,1,12,3,0,4,7,3,1,0,1,1,16359,6.8,17785,229,43,-1112,-41,22.9,1635.9,27,4,1,7,4,7,1,1,0,0,17471,6.8,17826,208,56,1112,41,20.8,1747.1
4525020504,1,16,3,1,7,6,7,0,0,0,0,17568,6.8,18166,236,64,1308,544,23.6,1756.8,26,2,0,6,7,6,0,0,0,0,16260,7.0,17622,207,40,-1308,-544,20.7,1626.0
4506444095,1,17,3,1,9,2,7,1,0,1,0,17017,7.0,19023,204,50,2350,2705,20.4,1701.7,13,3,0,2,9,3,1,1,0,0,14667,6.6,16318,220,72,-2350,-2705,22.0,1466.7
4527528419,0,13,6,1,9,2,12,0,0,0,0,17440,7.0,18112,213,36,3422,1091,21.3,1744.0,44,1,0,2,9,1,0,0,0,0,14018,6.8,17021,216,56,-3422,-1091,21.6,1401.8
4502966435,1,16,3,1,4,4,1,1,0,1,0,16516,7.4,19168,259,60,1234,1855,25.9,1651.6,9,2,0,4,4,5,0,0,0,0,15282,6.8,17313,229,44,-1234,-1855,22.9,1528.2
4523704801,0,38,0,1,5,5,3,2,1,1,0,15548,7.4,18820,229,56,-826,38,22.9,1554.8,10,20,0,5,5,6,0,0,0,0,16374,7.2,18782,225,66,826,-38,22.5,1637.4
4526114014,0,15,1,0,1,5,2,0,0,0,0,13383,6.4,15553,193,46,-4079,-2994,19.3,1338.3,17,1,1,5,1,5,1,1,0,0,17462,7.0,18547,245,53,4079,2994,24.5,1746.2
4464579175,0,15,3,1,6,4,7,1,1,0,0,16279,7.0,18119,227,44,1079,784,22.7,1627.9,16,2,0,4,6,4,0,0,0,0,15200,6.6,17335,223,55,-1079,-784,22.3,1520.0
4513306375,0,10,3,0,5,10,7,1,1,0,0,14885,6.4,15463,170,41,-3695,-4018,17.0,1488.5,19,1,1,10,5,8,1,0,1,0,18580,7.2,19481,241,59,3695,4018,24.1,1858.0
4514193601,1,11,3,0,7,3,7,0,0,0,0,16464,7.2,18030,209,36,1474,963,20.9,1646.4,14,3,1,3,7,3,0,0,0,0,14990,6.6,17067,225,45,-1474,-963,22.5,1499.0
4515879923,0,14,4,1,5,11,7,1,0,1,0,15285,6.6,15530,185,44,-2302,-1871,18.5,1528.5,44,2,0,11,5,14,1,1,0,0,17587,6.8,17401,165,44,2302,1871,16.5,1758.7
4477299853,1,18,4,1,3,3,4,0,0,0,0,15332,7.0,17832,229,55,359,-386,22.9,1533.2,39,2,0,3,3,0,1,1,0,0,14973,7.0,18218,242,48,-359,386,24.2,1497.3
4441887841,1,13,0,1,5,2,3,1,1,0,0,15397,6.8,18585,204,68,1516,709,20.4,1539.7,36,0,0,2,5,1,0,0,0,0,13881,7.0,17876,196,44,-1516,-709,19.6,1388.1
4512891613,0,18,1,1,8,3,10,0,0,0,0,17818,7.2,19558,238,44,2534,1730,23.8,1781.8,11,3,0,3,8,2,0,0,0,0,15284,7.0,17828,223,60,-2534,-1730,22.3,1528.4
4513432258,1,14,2,1,8,2,9,1,0,1,0,17274,7.0,18134,233,39,3640,2348,23.3,1727.4,12,5,0,2,8,0,0,0,0,0,13634,6.4,15786,202,44,-3640,-2348,20.2,1363.4
4466967958,1,16,3,0,7,4,5,1,1,0,0,16283,7.2,19282,206,63,-30,1427,20.6,1628.3,15,1,1,4,7,5,0,0,0,0,16313,7.0,17855,217,48,30,-1427,21.7,1631.3
4472468602,0,18,4,1,5,3,10,0,0,0,0,15496,6.6,16654,184,47,-157,-269,18.4,1549.6,17,3,0,3,5,4,1,1,0,0,15653,6.6,16923,229,55,157,269,22.9,1565.3
4495708706,0,18,2,1,3,10,4,0,0,0,0,14557,6.4,15128,200,48,-3582,-5395,20.0,1455.7,16,0,0,10,3,10,2,1,1,0,18139,7.6,20523,246,63,3582,5395,24.6,1813.9
4487406430,1,18,5,0,10,4,14,1,1,0,0,18541,7.0,18196,210,48,4362,2989,21.0,1854.1,43,3,1,4,10,2,0,0,0,0,14179,6.4,15207,176,30,-4362,-2989,17.6,1417.9
4477545606,0,14,2,0,10,14,6,0,0,0,0,16665,6.8,17063,189,26,-3701,-2739,18.9,1666.5,12,1,1,14,10,11,1,1,0,0,20366,7.4,19802,220,54,3701,2739,22.0,2036.6
4473969390,0,16,6,1,4,16,5,0,0,0,0,14813,6.0,14354,198,20,-5062,-5699,19.8,1481.3,21,7,0,16,4,22,2,1,1,0,19875,7.4,20053,250,45,5062,5699,25.0,1987.5
4515594785,1,18,1,1,7,1,11,1,1,0,0,17865,7.4,19102,238,53,3274,1659,23.8,1786.5,12,1,0,1,7,1,0,0,0,0,14591,6.8,17443,240,50,-3274,-1659,24.0,1459.1
4500100836,0,21,2,0,8,8,3,0,0,0,0,16214,6.8,17234,203,48,94,-445,20.3,1621.4,17,4,1,8,8,6,0,0,0,0,16120,7.0,17679,168,48,-94,445,16.8,1612.0
4480429854,1,13,1,1,7,4,6,1,1,0,0,16988,7.2,18623,196,56,1575,-516,19.6,1698.8,12,0,0,4,7,1,0,0,0,0,15413,7.2,19139,224,76,-1575,516,22.4,1541.3
4472715891,1,14,1,0,13,7,11,0,0,0,0,19253,7.2,19378,212,48,3044,1261,21.2,1925.3,11,0,1,7,13,5,1,1,0,0,16209,7.2,18117,212,55,-3044,-1261,21.2,1620.9
4506588820,1,17,2,0,6,8,6,1,0,1,1,16914,6.4,16785,184,42,302,-1958,18.4,1691.4,52,4,1,8,6,6,1,1,0,0,16612,7.2,18743,208,60,-302,1958,20.8,1661.2
4489550843,1,16,2,1,6,3,5,1,1,0,0,16931,7.0,18085,225,54,2443,1566,22.5,1693.1,15,2,0,3,6,4,0,0,0,0,14488,6.4,16519,201,61,-2443,-1566,20.1,1448.8
4474969616,1,20,3,0,11,5,9,1,1,0,1,20245,7.2,18815,245,47,4733,1669,24.5,2024.5,124,1,1,5,11,8,0,0,0,0,15512,6.8,17146,182,52,-4733,-1669,18.2,1551.2
4488784073,1,37,4,0,6,10,6,0,0,0,0,16413,7.0,17648,204,49,-2461,-1828,20.4,1641.3,16,4,1,10,6,13,1,1,0,0,18874,7.4,19476,223,64,2461,1828,22.3,1887.4
4447660498,1,14,0,0,4,4,3,0,0,0,0,15548,6.8,17592,221,54,-112,398,22.1,1554.8,14,1,1,4,4,3,2,1,1,0,15660,6.8,17194,232,63,112,-398,23.2,1566.0
4524780505,1,18,3,1,6,2,6,1,1,0,0,16868,6.8,18060,245,52,1982,990,24.5,1686.8,16,2,0,2,6,6,0,0,0,0,14886,6.8,17070,227,60,-1982,-990,22.7,1488.6
4470267464,0,10,1,1,3,11,2,0,0,0,0,15059,6.8,17650,200,57,-3606,-1971,20.0,1505.9,12,1,0,11,3,18,1,1,0,0,18665,7.2,19621,208,46,3606,1971,20.8,1866.5
4467316184,1,13,0,0,7,6,4,1,1,0,1,17742,7.0,18795,203,64,2294,2616,20.3,1774.2,13,1,1,6,7,6,0,0,0,0,15448,6.6,16179,186,40,-2294,-2616,18.6,1544.8
4460351665,0,41,2,1,8,7,15,0,0,0,0,16867,6.8,17923,228,37,150,-446,22.8,1686.7,14,1,0,7,8,5,1,1,0,0,16717,7.2,18369,222,44,-150,446,22.2,1671.7
4525152197,1,13,3,0,3,7,3,1,0,1,1,16180,6.8,17570,229,45,-981,264,22.9,1618.0,12,1,1,7,3,11,1,1,0,0,17161,6.8,17306,230,48,981,-264,23.0,1716.1
4455125565,0,15,4,0,3,11,2,0,0,0,0,14377,6.4,15120,158,44,-5141,-4745,15.8,1437.7,20,3,1,11,3,12,1,1,0,1,19518,7.4,19865,241,59,5141,4745,24.1,1951.8
4481132902,0,13,0,0,6,12,4,0,0,0,0,16048,6.6,16740,209,40,-2954,-2865,20.9,1604.8,15,2,1,12,6,15,0,0,0,0,19002,7.2,19605,206,55,2954,2865,20.6,1900.2
4519991058,1,38,1,1,7,3,7,1,1,0,0,16674,7.2,18431,221,48,2176,1739,22.1,1667.4,14,1,0,3,7,3,0,0,0,0,14498,6.6,16692,212,35,-2176,-1739,21.2,1449.8
4516935258,1,18,0,0,3,4,6,1,1,0,0,14988,6.4,15830,214,52,-1093,-1958,21.4,1498.8,13,5,1,4,3,4,0,0,0,0,16081,6.8,17788,237,44,1093,1958,23.7,1608.1
4506382089,1,13,6,1,15,4,12,1,0,1,0,19987,7.2,19679,194,44,4805,3808,19.4,1998.7,16,1,0,4,15,4,1,1,0,0,15182,6.4,15871,194,45,-4805,-3808,19.4,1518.2
4464439713,1,17,2,1,8,4,7,1,0,1,0,16784,6.6,17242,212,40,1424,1060,21.2,1678.4,13,4,0,4,8,5,0,0,0,0,15360,6.4,16182,180,61,-1424,-1060,18.0,1536.0
4515376019,0,18,2,1,8,6,5,2,1,1,0,16650,6.8,17551,233,37,907,-411,23.3,1665.0,11,6,0,6,8,3,0,0,0,0,15743,6.6,17962,195,66,-907,411,19.5,1574.3
4522140067,0,13,1,0,6,8,10,1,1,0,0,15678,6.6,17592,181,44,-1859,-1340,18.1,1567.8,12,3,1,8,6,6,0,0,0,0,17537,7.2,18932,214,59,1859,1340,21.4,1753.7
4469179994,0,56,3,1,8,6,17,0,0,0,0,16731,6.4,16329,205,56,266,-912,20.5,1673.1,17,4,0,6,8,6,1,1,0,0,16465,6.6,17241,218,35,-266,912,21.8,1646.5
4486403546,0,14,3,0,6,4,6,0,0,0,0,15508,7.0,17029,193,42,-745,156,19.3,1550.8,13,6,1,4,6,3,1,1,0,0,16253,6.6,16873,250,40,745,-156,25.0,1625.3
4475586744,1,13,2,1,5,4,3,1,1,0,0,16261,7.2,19301,221,51,1320,839,22.1,1626.1,15,1,0,4,5,6,0,0,0,0,14941,7.0,18462,204,60,-1320,-839,20.4,1494.1
4519775314,1,24,2,0,3,3,4,0,0,0,0,14979,7.0,17553,237,48,-1171,-496,23.7,1497.9,13,2,1,3,3,3,0,0,0,0,16150,7.0,18049,251,52,1171,496,25.1,1615.0
4477654399,0,20,4,0,4,6,4,1,0,1,0,15888,7.4,18421,234,65,-205,1064,23.4,1588.8,18,2,1,6,4,7,0,0,0,0,16093,7.0,17357,217,32,205,-1064,21.7,1609.3
4463154481,0,38,3,0,5,6,6,0,0,0,0,15590,7.2,18314,211,36,-816,332,21.1,1559.0,14,1,1,6,5,4,0,0,0,0,16406,7.0,17982,227,60,816,-332,22.7,1640.6
4520554639,0,19,2,1,7,8,5,1,1,0,0,17125,7.2,18785,240,52,449,1210,24.0,1712.5,16,3,0,8,7,13,0,0,0,0,16676,7.0,17575,177,48,-449,-1210,17.7,1667.6
4525085113,0,16,1,0,1,9,1,0,0,0,0,13797,6.2,15622,173,60,-5533,-4951,17.3,1379.7,35,2,1,9,1,10,2,1,1,0,19330,7.4,20573,256,59,5533,4951,25.6,1933.0
4481697328,0,20,5,1,9,4,2,2,1,1,0,16730,7.0,19072,198,68,178,424,19.8,1673.0,22,9,0,4,9,3,0,0,0,0,16552,7.2,18648,245,56,-178,-424,24.5,1655.2
4445314635,0,13,2,0,5,14,6,1,1,0,0,15120,6.6,16713,167,48,-4767,-5061,16.7,1512.0,15,1,1,14,5,9,0,0,0,0,19887,7.8,21774,238,44,4767,5061,23.8,1988.7
4505058404,0,14,3,0,2,5,1,0,0,0,0,14815,7.0,17728,226,59,-2116,-2156,22.6,1481.5,16,5,1,5,2,6,1,0,1,0,16931,7.2,19884,237,80,2116,2156,23.7,1693.1
4519077677,0,15,2,1,10,8,9,0,0,0,0,17047,6.8,17725,192,38,-537,29,19.2,1704.7,15,2,0,8,10,8,0,0,0,0,17584,7.0,17696,207,44,537,-29,20.7,1758.4
4483417316,1,36,3,1,7,4,4,1,1,0,0,16849,7.6,20518,234,68,1116,2834,23.4,1684.9,13,1,0,4,7,6,0,0,0,0,15733,6.8,17684,237,48,-1116,-2834,23.7,1573.3
4465268169,0,31,2,1,5,5,6,0,0,0,0,16256,7.2,17524,217,51,329,-994,21.7,1625.6,15,5,0,5,5,5,0,0,0,0,15927,7.2,18518,224,53,-329,994,22.4,1592.7
4520801311,0,13,13,1,8,7,12,1,1,0,0,17018,7.0,17105,190,56,1096,120,19.0,1701.8,41,2,0,7,8,4,0,0,0,0,15922,6.8,16985,196,47,-1096,-120,19.6,1592.2
4523578015,1,14,1,0,7,3,6,0,0,0,0,16060,7.0,18431,228,44,794,577,22.8,1606.0,16,1,1,3,7,4,0,0,0,0,15266,7.0,17854,213,44,-794,-577,21.3,1526.6
4507962860,1,58,2,1,8,4,7,1,1,0,0,17446,7.0,19285,223,61,2322,1048,22.3,1744.6,14,0,0,4,8,1,0,0,0,0,15124,6.8,18237,222,56,-2322,-1048,22.2,1512.4
4468897827,1,43,3,1,2,4,1,1,1,0,0,15377,7.0,17617,229,56,-166,-712,22.9,1537.7,79,7,0,4,2,2,0,0,0,0,15543,7.0,18329,214,47,166,712,21.4,1554.3
4523617002,0,13,1,0,11,11,13,0,0,0,0,18592,6.8,17780,213,44,981,42,21.3,1859.2,14,1,1,11,11,13,1,1,0,0,17611,7.0,17738,197,42,-981,-42,19.7,1761.1
4519585226,1,36,4,1,3,7,3,0,0,0,0,15040,6.6,16582,205,48,-952,-1268,20.5,1504.0,16,2,0,7,3,4,2,1,1,0,15992,7.0,17850,205,44,952,1268,20.5,1599.2
4465323789,0,19,1,0,5,11,8,1,1,0,0,15838,7.0,17892,236,33,-2279,-2155,23.6,1583.8,18,4,1,11,5,7,0,0,0,0,18117,7.4,20047,235,52,2279,2155,23.5,1811.7
4500946527,0,17,3,0,2,8,4,0,0,0,0,14845,6.4,16713,236,49,-3193,-2101,23.6,1484.5,120,3,1,8,2,14,1,1,0,0,18038,7.2,18814,207,61,3193,2101,20.7,1803.8
4515511619,1,12,4,0,7,2,9,1,1,0,0,16664,7.2,18875,244,49,2543,965,24.4,1666.4,17,2,1,2,7,0,0,0,0,0,14121,7.0,17910,204,59,-2543,-965,20.4,1412.1
4522587256,1,15,3,0,4,11,3,0,0,0,0,14927,6.4,16195,195,44,-2597,-1718,19.5,1492.7,20,3,1,11,4,10,1,1,0,0,17524,7.0,17913,221,46,2597,1718,22.1,1752.4
4476985915,0,40,5,0,3,5,4,0,0,0,0,14710,6.8,16797,227,34,-1799,-1942,22.7,1471.0,19,4,1,5,3,8,1,1,0,0,16509,7.0,18739,204,75,1799,1942,20.4,1650.9
4457086177,1,65,2,1,9,2,12,2,1,1,0,18890,7.2,19533,236,48,4237,2338,23.6,1889.0,20,3,0,2,9,4,0,0,0,0,14653,6.6,17195,226,59,-4237,-2338,22.6,1465.3
4470543217,1,38,5,0,14,8,17,1,1,0,0,20305,7.4,19846,239,55,3072,3561,23.9,2030.5,17,4,1,8,14,9,0,0,0,0,17233,6.8,16285,189,40,-3072,-3561,18.9,1723.3
4523826752,1,18,3,1,9,5,9,0,0,0,0,16988,6.6,17774,213,40,1605,755,21.3,1698.8,15,2,0,5,9,4,2,1,1,0,15383,6.6,17019,203,48,-1605,-755,20.3,1538.3
4525204773,0,18,5,1,6,5,8,1,1,0,0,16660,6.8,17964,241,44,850,-98,24.1,1666.0,14,5,0,5,6,4,0,0,0,0,15810,7.0,18062,215,39,-850,98,21.5,1581.0
4487201030,0,22,1,0,7,6,4,1,0,1,0,16680,6.8,17712,196,43,-72,-118,19.6,1668.0,16,5,1,6,7,5,0,0,0,0,16752,7.0,17830,223,44,72,118,22.3,1675.2
4526101033,0,19,2,1,4,7,10,0,0,0,0,14929,6.2,15842,223,34,-3291,-2502,22.3,1492.9,19,3,0,7,4,8,2,1,1,1,18220,7.2,18344,248,56,3291,2502,24.8,1822.0
4515717672,0,14,2,0,4,7,5,0,0,0,0,16176,7.0,18293,254,59,-992,-804,25.4,1617.6,50,4,1,7,4,6,1,1,0,0,17168,6.8,19097,262,48,992,804,26.2,1716.8
4525858898,1,18,1,1,6,7,7,0,0,0,0,16592,7.0,18393,221,44,813,1232,22.1,1659.2,19,4,0,7,6,8,0,0,0,0,15779,7.0,17161,195,47,-813,-1232,19.5,1577.9
4445960695,1,15,1,1,5,3,5,2,1,1,0,16030,7.2,19449,240,52,970,748,24.0,1603.0,52,0,0,3,5,4,0,0,0,0,15060,7.0,18701,218,52,-970,-748,21.8,1506.0
4469649522,0,53,5,0,4,11,3,0,0,0,0,15440,6.8,16864,207,44,-3368,-3384,20.7,1544.0,17,1,1,11,4,17,0,0,0,0,18808,7.4,20248,216,68,3368,3384,21.6,1880.8
4486208789,1,18,3,0,3,7,4,0,0,0,0,13991,6.4,16073,203,21,-3756,-3280,20.3,1399.1,48,8,1,7,3,4,0,0,0,0,17747,7.2,19353,256,53,3756,3280,25.6,1774.7
4501126526,1,14,0,1,6,4,12,2,1,1,0,16939,7.0,17733,211,56,1419,731,21.1,1693.9,18,3,0,4,6,6,0,0,0,0,15520,6.6,17002,227,54,-1419,-731,22.7,1552.0
4519799499,0,19,4,1,5,5,6,0,0,0,0,16780,7.0,19102,253,63,774,1187,25.3,1678.0,17,6,0,5,5,7,1,1,0,0,16006,7.0,17915,233,52,-774,-1187,23.3,1600.6
4499721373,0,18,4,1,6,5,5,1,1,0,1,17639,7.0,17826,247,48,1181,-683,24.7,1763.9,14,3,0,5,6,6,1,0,1,0,16458,7.2,18509,240,55,-1181,683,24.0,1645.8
4506887349,1,14,7,0,3,2,3,1,1,0,0,16075,7.2,19032,251,63,597,559,25.1,1607.5,15,4,1,2,3,3,0,0,0,0,15478,7.0,18473,244,44,-597,-559,24.4,1547.8
4527238809,0,14,3,1,5,8,6,0,0,0,0,14557,6.4,15691,169,52,-3666,-2993,16.9,1455.7,17,2,0,8,5,8,0,0,0,0,18223,7.2,18684,235,52,3666,2993,23.5,1822.3
4466034400,0,15,1,1,2,13,2,0,0,0,0,14712,6.2,15826,202,52,-4016,-3206,20.2,1471.2,17,2,0,13,2,17,1,1,0,0,18728,7.0,19032,253,48,4016,3206,25.3,1872.8
4435697365,1,17,2,1,5,2,5,2,1,1,0,17446,7.4,20350,255,63,3229,3548,25.5,1744.6,14,2,0,2,5,2,0,0,0,0,14217,6.6,16802,221,48,-3229,-3548,22.1,1421.7
4413141960,1,17,2,1,2,2,3,0,0,0,0,14619,6.6,16874,244,40,622,-1048,24.4,1461.9,41,3,0,2,2,1,1,1,0,0,13997,6.8,17922,198,51,-622,1048,19.8,1399.7
4522207483,1,31,1,1,11,9,8,0,0,0,0,18649,7.2,19509,207,57,1641,1386,20.7,1864.9,7,1,0,9,11,9,0,0,0,0,17008,7.0,18123,199,39,-1641,-1386,19.9,1700.8
4525597127,0,18,2,0,3,3,4,1,1,0,0,15008,7.0,18344,211,56,-37,1144,21.1,1500.8,17,3,1,3,3,3,0,0,0,0,15045,6.8,17200,221,47,37,-1144,22.1,1504.5
4520393840,0,18,3,1,9,7,13,1,1,0,0,17682,6.6,17214,195,51,724,241,19.5,1768.2,40,3,0,7,9,9,0,0,0,0,16958,6.6,16973,229,48,-724,-241,22.9,1695.8
4521204334,1,15,0,1,12,5,13,1,0,1,0,19201,7.2,18883,214,67,3982,3457,21.4,1920.1,12,2,0,5,12,7,0,0,0,0,15219,6.2,15426,182,47,-3982,-3457,18.2,1521.9
4492511838,1,15,3,1,10,3,8,1,0,1,0,17802,7.2,19007,222,34,3168,2910,22.2,1780.2,13,4,0,3,10,5,0,0,0,0,14634,6.6,16097,198,52,-3168,-2910,19.8,1463.4
4513796211,0,14,0,0,8,12,5,0,0,0,0,16024,7.0,17294,212,46,-2370,-2104,21.2,1602.4,18,3,1,12,8,10,1,1,0,0,18394,7.4,19398,194,61,2370,2104,19.4,1839.4
4470651076,1,12,3,1,13,4,11,1,1,0,0,19077,7.2,18861,215,63,3669,3030,21.5,1907.7,17,1,0,4,13,5,0,0,0,0,15408,6.4,15831,207,45,-3669,-3030,20.7,1540.8
4510122654,0,13,2,0,4,7,3,0,0,0,0,14156,6.6,16075,177,43,-3906,-2509,17.7,1415.6,13,0,1,7,4,7,0,0,0,1,18062,7.2,18584,233,48,3906,2509,23.3,1806.2
4524982969,0,17,1,1,8,9,7,0,0,0,0,16908,7.2,18246,208,59,383,1668,20.8,1690.8,39,3,0,9,8,14,1,1,0,0,16525,6.6,16578,182,30,-383,-1668,18.2,1652.5
4513290700,0,73,2,1,5,7,5,1,0,1,0,16425,7.0,18524,201,62,-1029,754,20.1,1642.5,108,1,0,7,5,11,1,1,0,0,17454,6.8,17770,225,44,1029,-754,22.5,1745.4
4522847421,0,9,3,1,6,9,6,1,1,0,0,17108,6.8,17877,211,59,-1394,-2258,21.1,1710.8,17,1,0,9,6,10,0,0,0,0,18502,7.6,20135,210,67,1394,2258,21.0,1850.2
4516555764,0,34,3,1,7,2,4,0,0,0,0,17294,7.4,19906,246,64,2480,3168,24.6,1729.4,9,3,0,2,7,2,0,0,0,0,14814,6.6,16738,218,48,-2480,-3168,21.8,1481.4
4514407181,0,17,1,1,6,7,8,1,1,0,0,16088,7.2,17857,205,62,-769,-217,20.5,1608.8,16,0,0,7,6,7,1,0,1,0,16857,7.0,18074,202,62,769,217,20.2,1685.7
4523961836,1,35,0,1,7,6,6,0,0,0,0,17135,7.0,18089,227,46,754,159,22.7,1713.5,16,11,0,6,7,9,0,0,0,0,16381,6.8,17930,195,38,-754,-159,19.5,1638.1
4516066047,1,18,5,1,5,1,3,1,1,0,0,16222,7.0,18746,241,60,1997,1560,24.1,1622.2,42,4,0,1,5,0,0,0,0,0,14225,7.0,17186,234,48,-1997,-1560,23.4,1422.5
4506375047,1,128,4,1,7,4,10,2,1,1,0,18223,7.2,18996,230,52,3399,2362,23.0,1822.3,97,2,0,4,7,1,0,0,0,0,14824,6.8,16634,200,39,-3399,-2362,20.0,1482.4
4511340293,1,14,3,1,10,2,15,1,1,0,0,18142,7.2,18432,224,53,3680,2530,22.4,1814.2,15,2,0,2,10,1,0,0,0,0,14462,6.6,15902,190,53,-3680,-2530,19.0,1446.2
4515460466,0,15,1,0,5,13,2,0,0,0,0,15118,6.6,16774,214,39,-3673,-3603,21.4,1511.8,12,1,1,13,5,11,2,1,1,0,18791,7.4,20377,206,50,3673,3603,20.6,1879.1
4471240919,1,18,7,1,7,2,5,0,0,0,0,16284,7.2,18617,216,49,1496,1758,21.6,1628.4,17,6,0,2,7,3,0,0,0,0,14788,6.8,16859,225,44,-1496,-1758,22.5,1478.8
4515863775,1,16,1,1,3,2,3,1,0,1,1,16385,6.6,17307,215,42,962,-1646,21.5,1638.5,14,1,0,2,3,3,1,1,0,0,15423,7.0,18953,261,65,-962,1646,26.1,1542.3
4526932906,0,21,3,1,5,9,6,0,0,0,0,16462,7.0,17215,223,52,-922,-1305,22.3,1646.2,12,2,0,9,5,11,2,1,1,0,17384,7.2,18520,227,49,922,1305,22.7,1738.4
4522675513,1,19,6,1,4,3,2,1,1,0,0,15834,7.0,19029,258,48,782,1642,25.8,1583.4,19,5,0,3,4,3,0,0,0,0,15052,6.6,17387,238,40,-782,-1642,23.8,1505.2
4524047354,0,45,1,0,4,10,3,0,0,0,0,14396,6.6,16065,203,40,-4339,-2857,20.3,1439.6,18,2,1,10,4,4,0,0,0,0,18735,7.0,18922,234,56,4339,2857,23.4,1873.5
4523857343,0,17,2,0,5,10,6,0,0,0,0,15794,6.6,16652,203,44,-3750,-1447,20.3,1579.4,13,3,1,10,5,13,1,1,0,1,19544,6.8,18099,212,54,3750,1447,21.2,1954.4
4510803003,1,22,3,1,10,2,7,2,1,1,1,20540,7.6,20655,256,55,6921,4411,25.6,2054.0,12,3,0,2,10,1,0,0,0,0,13619,6.6,16244,186,40,-6921,-4411,18.6,1361.9
4523082627,0,16,3,1,5,4,4,0,0,0,1,17305,7.2,18581,246,40,2319,135,24.6,1730.5,15,2,0,4,5,2,1,1,0,0,14986,7.0,18446,217,59,-2319,-135,21.7,1498.6
4525047411,1,19,1,1,5,2,6,0,0,0,0,16622,7.2,19176,235,61,2061,1314,23.5,1662.2,20,2,0,2,5,0,0,0,0,0,14561,7.0,17862,219,67,-2061,-1314,21.9,1456.1
4523555451,1,41,1,1,10,6,10,0,0,0,0,18688,7.2,18613,218,47,3424,3153,21.8,1868.8,15,2,0,6,10,7,0,0,0,0,15264,6.2,15460,170,40,-3424,-3153,17.0,1526.4
4524055982,0,36,4,0,5,6,4,1,1,0,0,15954,7.0,18014,228,52,26,693,22.8,1595.4,15,2,1,6,5,4,0,0,0,0,15928,6.8,17321,190,44,-26,-693,19.0,1592.8
4521342021,0,109,2,0,0,5,0,0,0,0,0,13557,6.6,16944,213,60,-2637,-1878,21.3,1355.7,36,6,1,5,0,8,1,1,0,0,16194,6.8,18822,248,52,2637,1878,24.8,1619.4
4527422917,0,15,5,0,8,8,8,0,0,0,0,17014,6.6,17257,221,33,-426,-1055,22.1,1701.4,17,2,1,8,8,8,0,0,0,0,17440,6.8,18312,204,46,426,1055,20.4,1744.0
4518777335,0,25,1,1,3,6,4,0,0,0,0,14564,6.6,16320,209,51,-1966,-1998,20.9,1456.4,15,1,0,6,3,8,1,1,0,0,16530,7.0,18318,220,64,1966,1998,22.0,1653.0
4496343427,1,15,3,0,3,6,2,2,1,1,0,15804,7.2,18768,222,75,-427,1475,22.2,1580.4,36,1,1,6,3,10,0,0,0,0,16231,6.6,17293,217,44,427,-1475,21.7,1623.1
4480234530,0,15,2,0,5,10,5,0,0,0,0,15351,6.6,16664,179,53,-2885,-3602,17.9,1535.1,14,3,1,10,5,8,2,1,1,0,18236,7.2,20266,222,80,2885,3602,22.2,1823.6
4527461738,0,39,2,0,3,11,3,0,0,0,0,15495,7.0,17144,231,40,-2609,-2248,23.1,1549.5,13,9,1,11,3,7,1,1,0,0,18104,7.0,19392,237,56,2609,2248,23.7,1810.4
4513836142,1,17,2,0,11,4,12,0,0,0,0,18173,7.0,18943,218,39,3036,1949,21.8,1817.3,10,1,1,4,11,4,0,0,0,0,15137,6.8,16994,203,40,-3036,-1949,20.3,1513.7
4511615760,1,22,2,0,6,3,10,0,0,0,0,17141,7.2,19142,232,54,2378,2190,23.2,1714.1,15,2,1,3,6,1,1,1,0,0,14763,6.8,16952,206,56,-2378,-2190,20.6,1476.3
4513147023,0,20,4,1,4,6,3,0,0,0,0,15119,6.8,18065,211,56,-542,-1235,21.1,1511.9,21,4,0,6,4,4,1,1,0,0,15661,7.4,19300,224,54,542,1235,22.4,1566.1
4527875317,0,12,1,0,9,12,12,1,1,0,0,16198,7.0,18249,165,33,-2121,-1038,16.5,1619.8,13,3,1,12,9,7,1,0,1,0,18319,7.4,19287,187,68,2121,1038,18.7,1831.9
4522886351,1,19,2,0,6,10,6,0,0,0,0,16093,6.4,16579,181,34,-1908,-1654,18.1,1609.3,11,4,1,10,6,9,1,0,1,0,18001,7.0,18233,220,60,1908,1654,22.0,1800.1
4519835303,0,14,3,0,0,5,0,0,0,0,0,13094,6.4,15865,205,44,-3915,-4094,20.5,1309.4,41,4,1,5,0,2,1,1,0,0,17009,7.4,19959,259,73,3915,4094,25.9,1700.9
4523583459,0,45,10,1,5,7,8,1,1,0,0,15897,7.2,17465,216,59,-503,-896,21.6,1589.7,23,9,0,7,5,7,0,0,0,0,16400,7.0,18361,225,44,503,896,22.5,1640.0
4521614053,1,11,1,0,10,8,8,1,1,0,0,18523,7.2,19699,229,42,2400,2600,22.9,1852.3,12,1,1,8,10,6,0,0,0,0,16123,6.8,17099,191,34,-2400,-2600,19.1,1612.3
4509589971,1,41,5,1,8,5,7,1,1,0,0,17209,7.2,18853,219,54,2481,1962,21.9,1720.9,18,3,0,5,8,3,0,0,0,0,14728,6.8,16891,195,46,-2481,-1962,19.5,1472.8
4497800773,0,19,3,1,4,7,6,1,1,0,0,14582,6.4,16375,214,37,-2298,-2281,21.4,1458.2,13,3,0,7,4,7,0,0,0,0,16880,7.0,18656,213,53,2298,2281,21.3,1688.0
4495272249,0,14,2,0,5,6,3,1,0,1,0,15432,6.6,16542,223,24,-1042,-2030,22.3,1543.2,20,1,1,6,5,8,1,1,0,0,16474,7.0,18572,221,64,1042,2030,22.1,1647.4
4458488872,1,15,0,1,8,6,11,1,1,0,0,16091,6.8,16748,200,44,-765,-492,20.0,1609.1,35,2,0,6,8,11,0,0,0,0,16856,7.0,17240,185,44,765,492,18.5,1685.6
4527122905,1,15,3,1,4,4,5,1,0,1,0,15971,7.2,18396,242,59,484,-614,24.2,1597.1,20,2,0,4,4,1,1,1,0,0,15487,7.2,19010,242,64,-484,614,24.2,1548.7
4519657611,0,12,1,0,3,12,2,0,0,0,0,15140,6.8,16118,217,60,-5458,-3613,21.7,1514.0,85,0,1,12,3,13,1,0,1,1,20598,7.4,19731,215,52,5458,3613,21.5,2059.8
4519058321,0,12,3,0,1,5,3,1,1,0,0,14766,7.0,18364,231,65,-1787,-1135,23.1,1476.6,17,3,1,5,1,4,0,0,0,0,16553,7.0,19499,235,61,1787,1135,23.5,1655.3
4505239658,0,15,2,0,4,5,2,1,0,1,0,14644,6.8,17550,222,48,-1367,-412,22.2,1464.4,19,2,1,5,4,6,0,0,0,0,16011,7.0,17962,201,56,1367,412,20.1,1601.1
4502456299,0,80,1,1,5,5,5,0,0,0,0,15161,6.6,17135,174,40,-106,-827,17.4,1516.1,19,1,0,5,5,5,1,1,0,0,15267,6.8,17962,207,51,106,827,20.7,1526.7
4472981807,0,17,5,0,6,12,8,0,0,0,0,16240,6.6,16610,209,52,-2156,-1052,20.9,1624.0,47,5,1,12,6,12,1,1,0,0,18396,7.0,17662,167,44,2156,1052,16.7,1839.6
4477594109,0,17,3,0,1,4,1,0,0,0,0,14049,6.6,16350,194,47,-2798,-3625,19.4,1404.9,48,3,1,4,1,5,2,1,1,0,16847,7.4,19975,248,68,2798,3625,24.8,1684.7
4518737622,0,29,5,1,4,3,7,0,0,0,0,15517,6.6,16917,231,35,653,-556,23.1,1551.7,15,2,0,3,4,1,1,1,0,0,14864,6.6,17473,226,48,-653,556,22.6,1486.4
4506182731,1,14,4,1,8,1,9,1,0,1,0,17887,7.2,19263,221,56,4590,3681,22.1,1788.7,19,3,0,1,8,1,0,0,0,0,13297,6.4,15582,213,40,-4590,-3681,21.3,1329.7
4497982653,1,18,0,0,5,5,6,0,0,0,0,15400,7.0,18242,197,56,-1255,-121,19.7,1540.0,14,3,1,5,5,8,1,1,0,0,16655,7.2,18363,250,48,1255,121,25.0,1665.5
4522142363,0,16,2,0,4,9,6,1,0,1,0,15707,6.6,16687,225,36,-1724,-1515,22.5,1570.7,61,3,1,9,4,12,1,1,0,0,17431,7.0,18202,202,39,1724,1515,20.2,1743.1
4518305583,0,18,4,1,11,10,16,0,0,0,0,18453,7.0,18299,204,34,466,-316,20.4,1845.3,14,4,0,10,11,14,0,0,0,0,17987,7.4,18615,186,46,-466,316,18.6,1798.7
4515841164,0,18,2,0,5,6,6,1,1,0,0,15167,7.0,17584,200,52,-1315,-1049,20.0,1516.7,45,4,1,6,5,8,0,0,0,0,16482,7.0,18633,222,46,1315,1049,22.2,1648.2
4520896282,1,35,1,1,8,7,9,1,1,0,0,17345,7.0,18944,236,52,928,-128,23.6,1734.5,16,3,0,7,8,7,0,0,0,0,16417,7.2,19072,198,64,-928,128,19.8,1641.7
4431984647,0,16,0,0,1,16,1,1,1,0,0,12798,5.8,13908,179,36,-7868,-5339,17.9,1279.8,13,2,1,16,1,16,0,0,0,1,20666,7.2,19247,223,44,7868,5339,22.3,2066.6
4523763219,1,17,3,1,7,2,9,1,0,1,0,17557,7.0,18193,209,64,3822,2980,20.9,1755.7,18,2,0,2,7,1,0,0,0,0,13735,6.0,15213,224,24,-3822,-2980,22.4,1373.5
4526832439,1,17,1,0,6,6,6,1,1,0,0,17476,7.0,18428,219,63,1408,957,21.9,1747.6,17,2,1,6,6,6,0,0,0,0,16068,6.8,17471,231,44,-1408,-957,23.1,1606.8
4490249135,0,15,3,1,6,10,5,0,0,0,0,15164,6.4,16581,190,41,-4055,-2248,19.0,1516.4,32,1,0,10,6,10,1,0,1,0,19219,7.2,18829,236,58,4055,2248,23.6,1921.9
4473134497,0,18,1,0,3,11,4,0,0,0,0,14268,6.4,15723,213,42,-4962,-2384,21.3,1426.8,16,1,1,11,3,14,0,0,0,0,19230,7.0,18107,216,56,4962,2384,21.6,1923.0
4526343162,1,14,3,1,7,3,9,0,0,0,0,16817,6.8,17790,228,54,2283,830,22.8,1681.7,15,2,0,3,7,6,1,1,0,0,14534,6.8,16960,202,53,-2283,-830,20.2,1453.4
4525089240,0,20,1,0,4,9,3,0,0,0,0,14695,6.8,18090,207,36,-2467,80,20.7,1469.5,77,6,1,9,4,10,1,1,0,0,17162,7.2,18010,187,56,2467,-80,18.7,1716.2
4519132891,1,39,2,0,13,10,13,0,0,0,0,18886,7.2,18539,188,56,845,1049,18.8,1888.6,13,1,1,10,13,7,0,0,0,0,18041,7.0,17490,214,39,-845,-1049,21.4,1804.1
4500545106,0,11,2,1,5,9,5,2,1,1,1,17231,6.8,17227,175,59,792,-474,17.5,1723.1,15,2,0,9,5,10,0,0,0,0,16439,7.0,17701,177,49,-792,474,17.7,1643.9
4510792748,0,18,3,0,3,6,3,0,0,0,0,14649,6.6,15693,200,48,-1945,-2496,20.0,1464.9,13,3,1,6,3,7,1,1,0,0,16594,7.0,18189,216,61,1945,2496,21.6,1659.4
4498236446,1,12,4,0,4,8,4,1,1,0,0,16193,7.4,19464,225,76,-420,1215,22.5,1619.3,15,2,1,8,4,8,0,0,0,0,16613,7.2,18249,207,32,420,-1215,20.7,1661.3
4508973225,0,14,2,0,5,19,4,0,0,0,0,14815,6.2,14755,183,48,-7866,-5377,18.3,1481.5,15,2,1,19,5,23,2,1,1,1,22681,7.4,20132,219,48,7866,5377,21.9,2268.1
4520615634,1,37,2,1,8,4,11,1,1,0,0,17903,7.2,19715,206,71,1970,1999,20.6,1790.3,14,2,0,4,8,4,0,0,0,0,15933,7.0,17716,234,43,-1970,-1999,23.4,1593.3
4522626149,0,15,1,1,4,4,6,1,1,0,0,15544,6.6,17440,217,56,201,-979,21.7,1554.4,46,3,0,4,4,3,0,0,0,0,15343,7.0,18419,214,49,-201,979,21.4,1534.3
4511067613,0,15,6,0,8,7,9,1,1,0,0,17163,7.2,18565,221,60,515,1691,22.1,1716.3,15,1,1,7,8,14,0,0,0,0,16648,6.6,16874,211,43,-515,-1691,21.1,1664.8
4525118904,1,15,2,1,7,2,8,1,1,0,0,18650,7.4,20329,248,60,3877,1762,24.8,1865.0,51,1,0,2,7,3,0,0,0,0,14773,7.2,18567,220,61,-3877,-1762,22.0,1477.3
4516676610,0,24,2,0,5,6,5,0,0,0,0,16452,7.0,17916,220,59,-445,141,22.0,1645.2,16,5,1,6,5,5,0,0,0,0,16897,7.0,17775,212,56,445,-141,21.2,1689.7
4514486964,1,13,0,1,7,5,5,0,0,0,0,16407,7.0,18954,189,62,1063,1501,18.9,1640.7,12,4,0,5,7,0,0,0,0,0,15344,6.8,17453,205,40,-1063,-1501,20.5,1534.4
4456827660,1,17,3,1,8,5,13,1,1,0,0,17355,6.8,17548,204,39,1890,1473,20.4,1735.5,70,3,0,5,8,5,0,0,0,0,15465,6.4,16075,177,48,-1890,-1473,17.7,1546.5
4499598970,0,24,2,1,3,2,6,1,1,0,0,15335,6.8,17847,239,47,187,-954,23.9,1533.5,19,2,0,2,3,1,0,0,0,0,15148,6.8,18801,248,63,-187,954,24.8,1514.8
4486227010,1,12,3,0,6,6,3,0,0,0,0,16072,7.0,18312,229,40,-346,316,22.9,1607.2,15,1,1,6,6,6,1,1,0,0,16418,6.8,17996,241,43,346,-316,24.1,1641.8
4494596077,1,40,5,1,7,9,6,1,0,1,1,18097,7.0,18058,243,39,811,426,24.3,1809.7,18,6,0,9,7,12,1,1,0,0,17286,6.6,17632,194,59,-811,-426,19.4,1728.6
4449308789,0,15,1,0,4,9,2,1,1,0,0,15230,6.6,17421,192,68,-2169,-1630,19.2,1523.0,16,1,1,9,4,7,0,0,0,0,17399,7.2,19051,218,26,2169,1630,21.8,1739.9
4511214856,1,15,0,1,9,7,13,0,0,0,0,18107,7.0,18643,210,70,1417,492,21.0,1810.7,37,2,0,7,9,8,0,0,0,0,16690,7.0,18151,199,45,-1417,-492,19.9,1669.0
4524065745,1,21,4,0,10,12,16,1,1,0,0,18676,7.0,18145,217,76,416,1133,21.7,1867.6,20,1,1,12,10,14,0,0,0,0,18260,6.6,17012,211,31,-416,-1133,21.1,1826.0
4525067275,0,13,2,0,2,5,2,1,0,1,0,15534,7.0,17975,252,51,-893,-213,25.2,1553.4,13,4,1,5,2,8,0,0,0,0,16427,7.0,18188,231,44,893,213,23.1,1642.7
4496972766,0,15,3,0,6,7,8,0,0,0,0,16564,7.0,18202,213,49,-443,-447,21.3,1656.4,14,2,1,7,6,4,0,0,0,0,17007,7.0,18649,216,46,443,447,21.6,1700.7
4474587492,0,12,1,0,5,11,3,0,0,0,0,16007,6.6,17004,206,64,-3397,-2492,20.6,1600.7,18,3,1,11,5,8,1,1,0,1,19404,7.2,19496,229,68,3397,2492,22.9,1940.4
4522569909,0,18,2,0,5,8,10,0,0,0,0,15979,6.8,17379,195,52,-583,360,19.5,1597.9,14,2,1,8,5,9,1,1,0,0,16562,6.6,17019,200,36,583,-360,20.0,1656.2
4506223983,1,18,2,1,11,7,9,1,1,0,0,18913,6.6,17351,229,38,3002,1582,22.9,1891.3,9,2,0,7,11,8,0,0,0,0,15911,6.4,15769,170,45,-3002,-1582,17.0,1591.1
4522097658,1,16,3,1,11,4,11,1,1,0,0,19165,7.4,20050,219,47,4297,2642,21.9,1916.5,16,2,0,4,11,4,0,0,0,0,14868,6.8,17408,177,55,-4297,-2642,17.7,1486.8
4517523977,0,13,0,0,8,10,5,1,0,1,0,16781,6.8,17736,180,42,-1611,-1624,18.0,1678.1,13,3,1,10,8,13,1,1,0,0,18392,7.4,19360,188,53,1611,1624,18.8,1839.2
4448275896,1,18,4,1,6,1,7,1,1,0,0,16894,7.2,19048,234,47,2647,1140,23.4,1689.4,13,3,0,1,6,1,0,0,0,0,14247,6.8,17908,217,64,-2647,-1140,21.7,1424.7
4510131144,0,14,3,0,6,7,10,1,1,0,0,15766,6.8,16285,197,40,-1089,-2134,19.7,1576.6,15,2,1,7,6,6,0,0,0,0,16855,7.0,18419,226,38,1089,2134,22.6,1685.5
4474676809,1,15,1,1,5,0,5,2,1,1,1,17806,7.0,18750,244,48,6304,5904,24.4,1780.6,25,0,0,0,5,0,0,0,0,0,11502,5.4,12846,155,40,-6304,-5904,15.5,1150.2
4498404672,1,8,1,1,7,3,6,0,0,0,0,17204,7.4,19558,255,48,2385,966,25.5,1720.4,37,0,0,3,7,4,1,1,0,0,14819,7.0,18592,215,52,-2385,-966,21.5,1481.9
4474786216,1,17,2,0,9,2,11,2,1,1,0,17259,7.0,18091,214,52,3146,2257,21.4,1725.9,14,2,1,2,9,1,0,0,0,0,14113,6.4,15834,221,33,-3146,-2257,22.1,1411.3
4502385665,0,12,5,1,8,3,6,0,0,0,0,16975,7.4,19639,238,64,1735,2029,23.8,1697.5,17,1,0,3,8,2,0,0,0,0,15240,6.6,17610,228,39,-1735,-2029,22.8,1524.0
4492694457,0,12,1,0,6,10,7,0,0,0,0,16186,6.6,17103,207,35,-2072,-1355,20.7,1618.6,15,1,1,10,6,10,2,1,1,0,18258,7.0,18458,211,51,2072,1355,21.1,1825.8
4518702917,0,25,3,1,5,4,7,0,0,0,0,15694,7.0,18079,209,53,-451,591,20.9,1569.4,24,4,0,4,5,5,1,1,0,0,16145,7.0,17488,241,63,451,-591,24.1,1614.5
4520990343,0,18,2,0,9,6,9,0,0,0,0,17854,7.2,18784,219,43,1762,2377,21.9,1785.4,16,2,1,6,9,7,1,0,1,0,16092,6.6,16407,202,40,-1762,-2377,20.2,1609.2
4500469260,0,12,2,0,4,7,3,0,0,0,0,15473,6.8,17491,215,61,-1093,-449,21.5,1547.3,14,0,1,7,4,7,1,1,0,0,16566,7.0,17940,236,39,1093,449,23.6,1656.6
4510569686,0,19,3,0,8,10,9,0,0,0,0,17139,6.6,16389,199,50,-201,-1063,19.9,1713.9,55,2,1,10,8,11,1,1,0,0,17340,6.8,17452,167,41,201,1063,16.7,1734.0
4482490476,0,21,1,0,7,5,6,2,1,1,0,16158,6.8,17789,224,46,1184,1807,22.4,1615.8,49,3,1,5,7,3,0,0,0,0,14974,6.6,15982,177,55,-1184,-1807,17.7,1497.4
4521321336,1,38,4,0,7,1,13,1,1,0,0,16795,7.2,19215,238,55,1715,1548,23.8,1679.5,17,21,1,1,7,1,1,0,1,0,15080,7.0,17667,254,55,-1715,-1548,25.4,1508.0
4514518973,0,36,6,0,1,10,1,0,0,0,0,13125,6.2,15273,167,59,-4596,-2815,16.7,1312.5,17,5,1,10,1,11,1,1,0,0,17721,7.2,18088,243,46,4596,2815,24.3,1772.1
4423897951,0,21,3,1,9,13,13,0,0,0,0,17163,6.6,17099,190,31,-2880,-2174,19.0,1716.3,15,4,0,13,9,11,0,0,0,0,20043,7.0,19273,213,48,2880,2174,21.3,2004.3
4514268953,0,14,1,1,5,9,6,0,0,0,0,15595,6.6,16171,208,33,-1780,-2942,20.8,1559.5,16,1,0,9,5,5,1,1,0,0,17375,7.0,19113,231,44,1780,2942,23.1,1737.5
4459114610,0,24,6,1,6,4,8,1,1,0,0,15645,6.8,17261,184,47,6,1023,18.4,1564.5,19,1,0,4,6,3,1,0,1,0,15639,6.6,16238,230,42,-6,-1023,23.0,1563.9
4514795179,0,13,7,0,4,3,4,0,0,0,0,15404,7.0,18235,236,51,163,1490,23.6,1540.4,18,3,1,3,4,3,1,1,0,0,15241,6.8,16745,238,43,-163,-1490,23.8,1524.1
4460122479,0,21,3,1,10,6,8,1,1,0,0,18280,7.4,19939,241,48,2171,1839,24.1,1828.0,37,5,0,6,10,4,0,0,0,0,16109,7.0,18100,196,48,-2171,-1839,19.6,1610.9
4519370242,0,10,1,0,9,8,8,1,1,0,0,16732,6.8,16963,208,32,-496,-1184,20.8,1673.2,14,0,1,8,9,9,0,0,0,0,17228,7.0,18147,186,51,496,1184,18.6,1722.8
4482930107,1,15,1,0,14,4,13,0,0,0,1,20319,7.2,18956,216,57,5774,2869,21.6,2031.9,17,2,1,4,14,1,0,0,0,0,14545,6.4,16087,218,34,-5774,-2869,21.8,1454.5
4503234599,0,13,0,0,5,15,6,0,0,0,0,15709,6.8,17397,216,49,-5900,-4872,21.6,1570.9,39,2,1,15,5,8,2,1,1,0,21609,7.8,22269,270,67,5900,4872,27.0,2160.9
4483425458,0,23,2,0,7,13,6,0,0,0,0,15898,5.8,14230,131,45,-2787,-4217,13.1,1589.8,19,2,1,13,7,10,2,1,1,0,18685,6.8,18447,224,50,2787,4217,22.4,1868.5
4514078470,0,25,1,1,6,8,9,1,0,1,1,16760,6.6,16615,186,40,-429,-1821,18.6,1676.0,13,3,0,8,6,10,0,0,0,0,17189,7.2,18436,242,43,429,1821,24.2,1718.9
4504386463,0,20,2,1,5,6,4,1,0,1,0,15665,6.8,17716,203,48,-1730,-1236,20.3,1566.5,40,4,0,6,5,6,1,1,0,0,17395,7.0,18952,214,67,1730,1236,21.4,1739.5
4525998328,0,18,1,0,3,5,2,0,0,0,0,14442,6.8,16949,209,47,-2402,-1269,20.9,1444.2,17,5,1,5,3,7,2,1,1,0,16844,7.0,18218,240,60,2402,1269,24.0,1684.4
4518585607,0,28,3,0,3,7,3,0,0,0,0,15423,7.2,18648,232,52,-2055,-860,23.2,1542.3,18,2,1,7,3,10,1,1,0,0,17478,7.2,19508,258,52,2055,860,25.8,1747.8
4462971469,1,17,4,1,8,5,8,1,1,0,0,17610,7.4,18827,221,55,1677,809,22.1,1761.0,15,3,0,5,8,5,0,0,0,0,15933,7.2,18018,212,64,-1677,-809,21.2,1593.3
4511813987,1,35,18,1,14,5,11,1,1,0,0,20070,7.2,20194,211,65,4235,3837,21.1,2007.0,42,3,0,5,14,8,0,0,0,0,15835,6.6,16357,188,34,-4235,-3837,18.8,1583.5
4490758389,1,22,1,0,6,8,8,0,0,0,1,18198,7.0,17647,220,52,1549,-554,22.0,1819.8,19,4,1,8,6,8,0,0,0,0,16649,7.0,18201,220,40,-1549,554,22.0,1664.9
4502563520,0,22,3,0,6,6,4,0,0,0,0,15629,6.8,17035,212,42,-317,-27,21.2,1562.9,17,3,1,6,6,11,1,1,0,0,15946,6.8,17062,200,54,317,27,20.0,1594.6
4527673599,1,16,3,0,3,5,2,0,0,0,0,15125,6.6,17843,197,80,-712,977,19.7,1512.5,15,4,1,5,3,9,1,1,0,0,15837,6.8,16866,216,42,712,-977,21.6,1583.7
4523790678,0,65,4,0,3,5,2,0,0,0,0,15692,6.6,17765,221,67,506,1580,22.1,1569.2,18,3,1,5,3,8,1,1,0,0,15186,6.8,16185,182,40,-506,-1580,18.2,1518.6
4495223559,1,17,3,0,10,7,7,1,0,1,1,19606,7.2,18619,220,45,3534,2345,22.0,1960.6,16,2,1,7,10,8,1,1,0,0,16072,6.6,16274,170,60,-3534,-2345,17.0,1607.2
4305726781,1,19,4,1,14,4,11,1,1,0,0,20351,7.4,19996,225,72,5057,3423,22.5,2035.1,23,1,0,4,14,3,0,0,0,0,15294,6.6,16573,197,43,-5057,-3423,19.7,1529.4
4450271730,1,14,2,0,5,8,3,1,1,0,0,15069,6.6,16824,198,46,-1974,-589,19.8,1506.9,25,1,1,8,5,12,0,0,0,0,17043,6.8,17413,216,40,1974,589,21.6,1704.3
4522848273,1,15,0,1,6,8,8,1,1,0,0,16956,7.0,18364,197,72,-506,-228,19.7,1695.6,12,4,0,8,6,9,0,0,0,0,17462,7.0,18592,234,48,506,228,23.4,1746.2
4504218581,1,17,2,0,8,3,10,1,1,0,0,17810,7.6,19743,248,57,3866,3496,24.8,1781.0,19,1,1,3,8,1,0,0,0,0,13944,6.4,16247,191,41,-3866,-3496,19.1,1394.4
4519675150,0,20,4,0,7,3,8,1,1,0,0,16628,6.8,17255,215,52,-105,1234,21.5,1662.8,18,2,1,3,7,5,1,0,1,1,16733,6.2,16021,213,46,105,-1234,21.3,1673.3
4526251344,0,12,0,1,8,9,9,0,0,0,0,17543,7.0,18113,190,56,304,-302,19.0,1754.3,15,1,0,9,8,3,1,1,0,0,17239,7.0,18415,196,59,-304,302,19.6,1723.9
4523611830,0,164,3,0,4,11,5,0,0,0,0,15373,6.6,16233,227,38,-2539,-1447,22.7,1537.3,11,9,1,11,4,20,1,1,0,0,17912,7.0,17680,174,56,2539,1447,17.4,1791.2
4506389635,1,15,3,1,6,7,5,0,0,0,0,16940,7.2,17909,246,38,566,-57,24.6,1694.0,16,4,0,7,6,11,0,0,0,0,16374,7.2,17966,219,37,-566,57,21.9,1637.4
4508174321,1,40,3,1,8,4,7,0,0,0,0,17264,7.0,18035,214,36,1811,875,21.4,1726.4,16,0,0,4,8,5,0,0,0,0,15453,6.6,17160,186,51,-1811,-875,18.6,1545.3
4521431219,0,19,4,0,3,4,9,1,1,0,0,15240,6.8,17456,243,45,-1279,-1122,24.3,1524.0,15,4,1,4,3,6,0,0,0,0,16519,7.2,18578,244,64,1279,1122,24.4,1651.9
4490921913,1,15,4,0,7,2,7,1,1,0,0,18477,7.2,19323,275,45,4458,3839,27.5,1847.7,12,4,1,2,7,4,0,0,0,0,14019,6.2,15484,188,50,-4458,-3839,18.8,1401.9
4423842693,1,19,5,0,7,6,7,1,0,1,0,17184,6.6,16943,206,43,1835,393,20.6,1718.4,17,1,1,6,7,5,1,1,0,0,15349,6.6,16550,217,47,-1835,-393,21.7,1534.9
4484950651,1,18,3,1,10,0,8,0,0,0,0,18408,7.4,19945,243,52,5041,3633,24.3,1840.8,15,3,0,0,10,0,0,0,0,0,13367,6.6,16312,202,57,-5041,-3633,20.2,1336.7
4525551314,0,11,2,1,10,4,10,0,0,0,1,19095,7.2,19444,219,44,2999,2184,21.9,1909.5,12,1,0,4,10,2,0,0,0,0,16096,6.6,17260,204,48,-2999,-2184,20.4,1609.6
4473219788,0,14,4,1,3,9,2,0,0,0,0,14624,6.6,16231,211,32,-4073,-2595,21.1,1462.4,21,2,0,9,3,7,1,0,1,0,18697,7.2,18826,226,60,4073,2595,22.6,1869.7
4512263036,1,21,17,1,11,6,14,2,1,1,0,18894,6.8,17315,201,51,3536,1244,20.1,1889.4,46,5,0,6,11,5,0,0,0,0,15358,6.6,16071,187,36,-3536,-1244,18.7,1535.8
4484202085,0,41,3,1,9,9,13,1,1,0,0,17641,6.8,16803,199,38,436,338,19.9,1764.1,18,5,0,9,9,11,0,0,0,0,17205,6.4,16465,207,33,-436,-338,20.7,1720.5
4518881897,1,16,1,1,7,6,5,0,0,0,0,16345,6.6,16530,204,47,-323,-992,20.4,1634.5,54,2,0,6,7,8,1,1,0,0,16668,7.0,17522,190,56,323,992,19.0,1666.8
4494758719,0,20,1,0,5,5,2,0,0,0,0,15790,6.6,16936,221,48,-175,-624,22.1,1579.0,13,2,1,5,5,5,2,1,1,0,15965,7.0,17560,205,59,175,624,20.5,1596.5
4494815274,1,12,0,1,12,6,12,0,0,0,0,18766,7.2,20059,231,45,2265,2656,23.1,1876.6,24,0,0,6,12,6,0,0,0,0,16501,6.8,17403,225,48,-2265,-2656,22.5,1650.1
4518436678,0,15,2,0,2,7,2,0,0,0,0,15114,6.8,17597,219,64,-1158,-1281,21.9,1511.4,15,3,1,7,2,6,2,1,1,0,16272,7.2,18878,231,44,1158,1281,23.1,1627.2
4511966451,0,13,2,0,2,5,3,0,0,0,0,15123,6.8,17214,232,60,-2105,-1094,23.2,1512.3,15,2,1,5,2,6,1,1,0,0,17228,6.8,18308,234,48,2105,1094,23.4,1722.8
4500313763,0,15,0,0,6,7,3,1,0,1,0,16132,7.0,18044,222,52,-1989,-735,22.2,1613.2,15,5,1,7,6,6,1,1,0,1,18121,7.4,18779,218,52,1989,735,21.8,1812.1
4524656242,0,18,5,1,8,6,11,1,0,1,0,17380,7.0,18220,211,64,1060,488,21.1,1738.0,23,4,0,6,8,9,1,1,0,0,16320,7.0,17732,215,56,-1060,-488,21.5,1632.0
4522867814,1,20,12,1,4,5,5,0,0,0,0,15463,7.2,18378,215,60,25,327,21.5,1546.3,50,7,0,5,4,5,0,0,0,0,15438,7.0,18051,215,44,-25,-327,21.5,1543.8
4519068942,1,35,2,1,6,6,2,2,1,1,0,17085,7.2,18329,229,80,411,-493,22.9,1708.5,8,1,0,6,6,9,0,0,0,0,16674,7.2,18822,213,47,-411,493,21.3,1667.4
4523544390,0,73,3,1,10,7,10,0,0,0,0,16818,6.8,16676,183,42,283,165,18.3,1681.8,14,0,0,7,10,9,1,1,0,0,16535,6.6,16511,219,38,-283,-165,21.9,1653.5
4526718003,1,13,1,0,3,9,3,1,1,0,0,15431,6.8,17257,237,48,-2844,-2533,23.7,1543.1,36,2,1,9,3,11,0,0,0,0,18275,7.2,19790,221,44,2844,2533,22.1,1827.5
4522456082,1,38,4,1,3,5,2,0,0,0,0,14935,7.2,17972,220,48,-792,-9,22.0,1493.5,13,5,0,5,3,6,0,0,0,0,15727,7.0,17981,221,49,792,9,22.1,1572.7
4465693546,1,17,1,0,10,9,9,2,1,1,0,17868,7.0,17858,177,56,-286,-916,17.7,1786.8,20,5,1,9,10,11,0,0,0,0,18154,7.0,18774,247,56,286,916,24.7,1815.4
4517942956,0,53,1,0,2,6,0,0,0,0,0,13888,6.4,15518,172,52,-3220,-4094,17.2,1388.8,14,3,1,6,2,6,1,0,1,0,17108,7.4,19612,242,52,3220,4094,24.2,1710.8
4523420672,0,22,4,1,4,7,6,0,0,0,0,16045,7.0,17984,229,56,-794,-1320,22.9,1604.5,16,2,0,7,4,6,0,0,0,0,16839,7.2,19304,228,56,794,1320,22.8,1683.9
4525084228,1,19,5,0,4,4,4,0,0,0,0,14892,6.8,17899,199,49,-1750,-628,19.9,1489.2,19,4,1,4,4,4,1,1,0,0,16642,7.2,18527,250,61,1750,628,25.0,1664.2
4525336028,1,15,3,1,2,6,2,1,1,0,0,14967,6.8,16756,221,54,-1513,-2959,22.1,1496.7,12,2,0,6,2,7,0,0,0,0,16480,7.2,19715,224,62,1513,2959,22.4,1648.0
4455694504,0,15,1,1,4,9,3,0,0,0,0,14731,6.4,16109,188,44,-3354,-2698,18.8,1473.1,17,3,0,9,4,10,1,1,0,0,18085,7.2,18807,241,44,3354,2698,24.1,1808.5
4520514832,1,20,2,0,8,12,7,2,1,1,0,17474,7.2,18038,226,54,-2112,-582,22.6,1747.4,18,4,1,12,8,14,0,0,0,0,19586,7.2,18620,223,34,2112,582,22.3,1958.6
4438230274,0,16,2,0,3,6,5,0,0,0,0,14448,6.4,15930,209,40,-1620,-1431,20.9,1444.8,17,2,1,6,3,10,1,0,1,0,16068,6.8,17361,204,51,1620,1431,20.4,1606.8
4518601095,1,20,5,1,10,4,11,1,0,1,0,18879,7.2,19552,222,68,4513,3883,22.2,1887.9,15,3,0,4,10,3,0,0,0,0,14366,6.4,15669,195,39,-4513,-3883,19.5,1436.6
4512949198,0,15,4,1,5,10,5,1,1,0,0,15714,6.8,17362,208,59,-3095,-2200,20.8,1571.4,16,3,0,10,5,12,0,0,0,0,18809,7.2,19562,244,40,3095,2200,24.4,1880.9
4444218395,1,15,3,1,9,2,21,1,1,0,0,18470,7.2,18925,263,51,3581,1578,26.3,1847.0,17,1,0,2,9,1,0,0,0,0,14889,6.8,17347,238,52,-3581,-1578,23.8,1488.9
4524619548,0,18,3,1,3,5,4,1,0,1,0,15410,6.8,17797,216,65,-234,-406,21.6,1541.0,29,5,0,5,3,2,1,1,0,0,15644,7.0,18203,236,40,234,406,23.6,1564.4
4516031571,0,15,5,0,8,5,6,0,0,0,0,17851,7.4,19947,257,44,1051,1224,25.7,1785.1,17,4,1,5,8,4,1,1,0,0,16800,7.2,18723,247,68,-1051,-1224,24.7,1680.0
4523629089,0,14,2,0,3,8,5,0,0,0,0,14425,6.6,16191,198,47,-2619,-1506,19.8,1442.5,17,3,1,8,3,9,1,1,0,0,17044,6.6,17697,212,49,2619,1506,21.2,1704.4
4518730681,0,13,1,0,7,6,8,2,1,1,0,16514,6.8,17281,216,50,-594,-1344,21.6,1651.4,9,2,1,6,7,11,0,0,0,0,17108,7.0,18625,242,55,594,1344,24.2,1710.8
4475540931,1,19,5,1,10,5,18,2,1,1,0,18682,7.4,19196,207,67,2733,2062,20.7,1868.2,17,4,0,5,10,6,0,0,0,0,15949,6.8,17134,216,49,-2733,-2062,21.6,1594.9
4520909280,0,15,3,0,4,11,2,1,1,0,0,15011,6.6,16617,183,60,-4396,-2703,18.3,1501.1,14,3,1,11,4,16,0,0,0,0,19407,7.2,19320,245,40,4396,2703,24.5,1940.7
4477266895,1,23,6,1,15,5,17,0,0,0,0,19074,6.6,17514,191,35,3941,2200,19.1,1907.4,19,5,0,5,15,3,0,0,0,0,15133,6.6,15314,199,40,-3941,-2200,19.9,1513.3
4487273871,0,17,1,0,2,6,0,0,0,0,0,13465,6.2,15462,191,43,-3179,-937,19.1,1346.5,15,2,1,6,2,6,1,1,0,0,16644,6.6,16399,226,43,3179,937,22.6,1664.4
4524068681,1,16,3,1,3,3,3,0,0,0,0,15045,6.6,16887,221,46,220,-284,22.1,1504.5,19,3,0,3,3,5,0,0,0,0,14825,6.8,17171,199,39,-220,284,19.9,1482.5
4526982264,0,40,2,1,6,3,4,0,0,0,0,17488,7.2,19282,243,65,2435,1239,24.3,1748.8,18,1,0,3,6,3,0,0,0,0,15053,7.0,18043,237,50,-2435,-1239,23.7,1505.3
4490720316,1,38,2,1,9,6,12,0,0,0,0,18869,7.0,18526,206,74,4242,2348,20.6,1886.9,15,1,0,6,9,6,0,0,0,0,14627,6.6,16178,164,51,-4242,-2348,16.4,1462.7
4440581251,0,18,4,0,6,9,8,1,1,0,0,17170,7.4,18831,237,54,-815,-699,23.7,1717.0,16,2,1,9,6,9,0,0,0,0,17985,7.2,19530,244,35,815,699,24.4,1798.5
4495748526,0,53,2,0,8,5,12,2,1,1,0,17008,6.6,16893,203,44,1280,370,20.3,1700.8,17,3,1,5,8,5,0,0,0,0,15728,6.4,16523,245,42,-1280,-370,24.5,1572.8
4434935044,1,21,1,0,3,5,3,1,1,0,0,15393,7.0,18185,243,56,-1101,-306,24.3,1539.3,12,5,1,5,3,7,0,0,0,0,16494,7.0,18491,267,48,1101,306,26.7,1649.4
4516816760,1,16,4,1,12,7,10,1,1,0,0,20471,7.6,20212,230,62,3941,3044,23.0,2047.1,16,3,0,7,12,6,0,0,0,0,16530,6.6,17168,198,39,-3941,-3044,19.8,1653.0
4488941406,1,12,1,1,7,6,5,1,1,0,0,17381,7.0,18938,232,57,1895,635,23.2,1738.1,13,1,0,6,7,5,0,0,0,0,15486,7.2,18303,211,46,-1895,-635,21.1,1548.6
4508293000,0,13,5,0,3,5,2,0,0,0,0,14761,7.0,17479,204,64,-907,414,20.4,1476.1,16,2,1,5,3,6,1,1,0,0,15668,6.6,17065,225,46,907,-414,22.5,1566.8
4491183408,0,17,0,0,8,10,8,1,0,1,0,18020,7.2,19285,214,63,-533,944,21.4,1802.0,86,1,1,10,8,14,0,0,0,0,18553,7.0,18341,198,52,533,-944,19.8,1855.3
4471157611,1,15,2,0,4,5,4,0,0,0,0,15761,7.0,17783,230,59,-802,-1243,23.0,1576.1,17,2,1,5,4,5,0,0,0,0,16563,7.4,19026,247,54,802,1243,24.7,1656.3
4514563057,0,15,2,0,7,9,6,0,0,0,0,16784,7.4,19211,196,64,-1270,1023,19.6,1678.4,15,3,1,9,7,10,0,0,0,0,18054,7.2,18188,210,47,1270,-1023,21.0,1805.4
4448423272,0,10,3,1,4,5,2,0,0,0,0,15515,7.2,18510,222,55,-44,673,22.2,1551.5,15,0,0,5,4,4,0,0,0,0,15559,6.8,17837,218,56,44,-673,21.8,1555.9
4496999459,1,18,5,0,0,3,0,0,0,0,0,13691,6.8,16957,229,54,-1148,-818,22.9,1369.1,17,4,1,3,0,2,0,0,0,0,14839,6.8,17775,221,51,1148,818,22.1,1483.9
4519220567,0,17,16,1,4,2,4,0,0,0,0,16598,7.0,18693,256,43,1937,1019,25.6,1659.8,46,8,0,2,4,1,1,1,0,0,14661,6.8,17674,239,41,-1937,-1019,23.9,1466.1
4505505523,0,18,2,1,11,16,19,0,0,0,0,17198,6.4,15293,156,32,-2830,-2212,15.6,1719.8,17,3,0,16,11,24,1,1,0,0,20028,6.8,17505,174,46,2830,2212,17.4,2002.8
4502817224,0,12,2,0,5,4,7,1,1,0,0,16383,7.2,19209,223,56,864,898,22.3,1638.3,15,2,1,4,5,2,0,0,0,0,15519,7.0,18311,246,45,-864,-898,24.6,1551.9
4506851562,0,19,0,0,8,8,4,1,1,0,0,16359,7.0,17830,204,56,-736,-226,20.4,1635.9,12,3,1,8,8,7,1,0,1,0,17095,7.2,18056,232,39,736,226,23.2,1709.5
4407710029,0,13,0,1,8,4,10,1,0,1,0,17938,7.0,18626,239,51,3117,1580,23.9,1793.8,13,0,0,4,8,1,1,1,0,0,14821,6.8,17046,196,44,-3117,-1580,19.6,1482.1
4476006621,0,17,4,1,3,5,2,0,0,0,0,15562,7.2,18590,236,73,-764,803,23.6,1556.2,33,4,0,5,3,6,2,1,1,0,16326,6.8,17787,233,46,764,-803,23.3,1632.6
4523524261,1,20,1,1,7,4,3,1,1,0,0,17120,6.8,18300,233,59,1936,1098,23.3,1712.0,12,4,0,4,7,4,0,0,0,0,15184,6.8,17202,206,50,-1936,-1098,20.6,1518.4
4495132329,1,14,2,1,3,4,3,1,1,0,0,15718,6.8,17585,256,57,86,-315,25.6,1571.8,19,1,0,4,3,6,0,0,0,0,15632,6.8,17900,220,42,-86,315,22.0,1563.2
4426693677,0,20,4,1,15,6,12,0,0,0,0,18863,7.2,18943,195,52,2789,585,19.5,1886.3,38,4,0,6,15,4,0,0,0,0,16074,7.0,18358,192,52,-2789,-585,19.2,1607.4
4493006116,0,15,3,0,7,16,6,0,0,0,0,15679,6.4,16096,172,42,-5377,-3249,17.2,1567.9,13,2,1,16,7,22,2,1,1,0,21056,7.2,19345,230,60,5377,3249,23.0,2105.6
4484693756,1,14,4,0,3,3,2,0,0,0,0,15751,6.8,17685,252,46,926,328,25.2,1575.1,46,4,1,3,3,3,0,0,0,0,14825,6.8,17357,215,49,-926,-328,21.5,1482.5
4522010330,1,11,2,1,9,3,8,0,0,0,1,18870,7.0,18880,232,57,5014,3238,23.2,1887.0,10,1,0,3,9,5,0,0,0,0,13856,6.2,15642,173,50,-5014,-3238,17.3,1385.6
4523781567,1,10,3,0,5,5,4,0,0,0,0,16368,7.0,18622,250,48,1079,1363,25.0,1636.8,14,3,1,5,5,7,1,1,0,0,15289,7.0,17259,206,56,-1079,-1363,20.6,1528.9
4520047610,1,16,2,0,6,6,7,0,0,0,0,16138,6.8,17204,211,31,-243,418,21.1,1613.8,11,3,1,6,6,13,1,0,1,0,16381,6.6,16786,188,52,243,-418,18.8,1638.1
4451696991,1,35,3,0,11,4,11,1,1,0,0,17596,7.2,19377,203,57,3252,3377,20.3,1759.6,15,4,1,4,11,2,0,0,0,0,14344,6.8,16000,171,54,-3252,-3377,17.1,1434.4
4516498052,1,16,2,0,9,9,10,0,0,0,1,18181,6.6,17078,202,36,1520,1110,20.2,1818.1,37,4,1,9,9,14,0,0,0,0,16661,6.6,15968,165,31,-1520,-1110,16.5,1666.1
4497569753,1,16,4,0,7,9,7,0,0,0,0,17569,7.2,18822,239,42,-72,529,23.9,1756.9,40,1,1,9,7,11,2,1,1,0,17641,7.0,18293,209,56,72,-529,20.9,1764.1
4515955272,1,16,11,0,9,7,5,0,0,0,0,18451,7.4,19111,226,60,1309,657,22.6,1845.1,43,2,1,7,9,5,0,0,0,0,17142,6.8,18454,206,44,-1309,-657,20.6,1714.2
4445701647,1,74,3,0,10,7,9,1,0,1,0,18209,7.2,18851,209,50,2343,2878,20.9,1820.9,17,3,1,7,10,8,1,1,0,0,15866,6.4,15973,170,54,-2343,-2878,17.0,1586.6
4444418743,0,17,2,0,3,5,3,1,1,0,0,14799,6.6,17594,227,48,-1302,-611,22.7,1479.9,16,0,1,5,3,6,0,0,0,0,16101,6.8,18205,201,56,1302,611,20.1,1610.1
4464704394,0,18,3,0,2,4,2,1,1,0,0,14353,6.4,16624,215,53,-874,-1635,21.5,1435.3,23,4,1,4,2,5,0,0,0,0,15227,7.0,18259,216,62,874,1635,21.6,1522.7
4499846213,0,94,3,1,6,9,9,1,1,0,0,16447,6.6,16299,208,48,-1942,-2662,20.8,1644.7,14,5,0,9,6,14,0,0,0,0,18389,7.0,18961,239,52,1942,2662,23.9,1838.9
4524739257,1,16,5,1,6,2,6,1,1,0,1,18215,7.2,18418,256,52,4749,3580,25.6,1821.5,15,2,0,2,6,1,0,0,0,0,13466,6.2,14838,207,40,-4749,-3580,20.7,1346.6
4477371609,0,19,5,1,10,12,11,0,0,0,0,17793,7.0,18074,199,48,-1761,37,19.9,1779.3,24,7,0,12,10,14,2,1,1,1,19554,7.0,18037,206,40,1761,-37,20.6,1955.4
4451080922,1,18,5,0,5,4,3,0,0,0,0,16373,7.2,19296,247,62,317,639,24.7,1637.3,35,5,1,4,5,1,1,1,0,0,16056,7.2,18657,254,52,-317,-639,25.4,1605.6
4498239413,0,15,2,0,4,7,3,1,1,0,0,16028,7.4,19000,249,56,-2863,-875,24.9,1602.8,13,3,1,7,4,6,0,0,0,0,18891,7.4,19875,242,52,2863,875,24.2,1889.1
4521177221,0,11,3,1,7,4,9,2,1,1,0,17012,7.2,19316,230,57,1456,1433,23.0,1701.2,15,2,0,4,7,4,0,0,0,0,15556,7.0,17883,220,60,-1456,-1433,22.0,1555.6
4489679008,1,16,2,0,3,4,0,0,0,0,0,15139,6.8,17354,240,48,-243,799,24.0,1513.9,17,1,1,4,3,10,1,1,0,0,15382,6.6,16555,206,52,243,-799,20.6,1538.2
4527207692,1,18,5,1,5,5,7,0,0,0,0,15843,7.0,17530,233,35,380,-245,23.3,1584.3,17,7,0,5,5,5,1,1,0,0,15463,7.0,17775,221,51,-380,245,22.1,1546.3
4524510632,1,13,1,1,7,9,7,0,0,0,0,16581,6.8,17538,197,48,-172,-21,19.7,1658.1,14,4,0,9,7,9,1,1,0,0,16753,7.0,17559,196,48,172,21,19.6,1675.3
4527796790,1,11,2,0,6,6,7,1,1,0,0,15950,6.8,17303,196,55,175,-234,19.6,1595.0,84,2,1,6,6,4,0,0,0,0,15775,6.8,17537,221,28,-175,234,22.1,1577.5
4455131016,1,17,1,1,6,8,4,1,1,0,0,16999,7.2,18661,232,66,-647,543,23.2,1699.9,14,3,0,8,6,11,0,0,0,0,17646,6.8,18118,226,46,647,-543,22.6,1764.6
4471426578,1,42,4,0,8,6,9,0,0,0,0,17026,7.2,18824,212,51,843,1776,21.2,1702.6,19,4,1,6,8,2,1,1,0,0,16183,7.0,17048,220,36,-843,-1776,22.0,1618.3
4518527027,1,41,4,0,7,7,11,1,1,0,0,16787,7.2,18466,201,55,-471,870,20.1,1678.7,39,3,1,7,7,9,0,0,0,0,17258,6.6,17596,229,38,471,-870,22.9,1725.8
4484008724,1,28,1,1,12,7,13,0,0,0,0,19146,7.4,19236,214,55,2994,2952,21.4,1914.6,11,3,0,7,12,7,1,1,0,0,16152,6.6,16284,175,50,-2994,-2952,17.5,1615.2
4505843833,1,15,5,1,11,9,8,0,0,0,0,17528,7.0,18271,191,48,171,618,19.1,1752.8,37,3,0,9,11,10,0,0,0,0,17357,6.6,17653,209,32,-171,-618,20.9,1735.7
4526739859,1,15,2,1,4,4,8,0,0,0,0,16530,7.0,18713,243,60,837,1199,24.3,1653.0,12,2,0,4,4,3,1,1,0,0,15693,6.6,17514,233,56,-837,-1199,23.3,1569.3
4467164835,1,18,5,0,14,4,21,1,1,0,0,19948,7.4,20064,220,56,4301,3444,22.0,1994.8,66,2,1,4,14,4,0,0,0,0,15647,6.6,16620,205,60,-4301,-3444,20.5,1564.7
4481977173,0,11,5,1,6,9,8,0,0,0,0,17025,7.0,18038,231,40,-1314,-1942,23.1,1702.5,17,2,0,9,6,9,1,1,0,0,18339,7.4,19980,232,57,1314,1942,23.2,1833.9
4516589637,1,14,1,0,9,8,8,0,0,0,0,16676,7.2,18316,201,47,-978,-1076,20.1,1667.6,31,2,1,8,9,11,0,0,0,0,17654,7.4,19392,203,59,978,1076,20.3,1765.4
4522502236,0,13,4,1,2,5,2,0,0,0,0,14672,6.6,16400,229,55,-1209,-2033,22.9,1467.2,19,5,0,5,2,2,1,1,0,0,15881,7.0,18433,252,53,1209,2033,25.2,1588.1
4500454645,1,17,2,1,9,4,5,1,1,0,0,18130,7.2,19017,206,75,3154,1720,20.6,1813.0,13,1,0,4,9,1,1,0,1,0,14976,6.6,17297,194,52,-3154,-1720,19.4,1497.6
4490200078,1,15,6,1,3,5,3,1,1,0,0,15295,6.8,17054,210,48,98,976,21.0,1529.5,16,2,0,5,3,6,0,0,0,0,15197,6.4,16078,213,42,-98,-976,21.3,1519.7
4527544639,0,50,1,0,8,9,8,0,0,0,0,15372,6.8,16833,161,40,-3616,-3352,16.1,1537.2,12,2,1,9,8,4,1,1,0,0,18988,7.6,20185,248,64,3616,3352,24.8,1898.8
4465222745,1,14,2,0,4,6,9,0,0,0,0,15858,7.0,17780,215,54,-1050,522,21.5,1585.8,13,0,1,6,4,10,0,0,0,0,16908,6.8,17258,213,52,1050,-522,21.3,1690.8
4523808167,0,12,4,1,8,6,10,1,0,1,0,17012,7.0,17507,225,38,872,-215,22.5,1701.2,74,1,0,6,8,6,1,1,0,0,16140,6.8,17722,214,48,-872,215,21.4,1614.0
4507786946,1,16,2,1,7,6,7,2,1,1,0,17453,7.0,17851,237,49,1478,483,23.7,1745.3,36,2,0,6,7,8,0,0,0,0,15975,7.0,17368,199,62,-1478,-483,19.9,1597.5
4525935490,0,30,4,1,6,13,6,1,1,0,0,16540,7.0,18158,235,66,-2145,-917,23.5,1654.0,14,3,0,13,6,15,1,0,1,0,18685,7.2,19075,193,48,2145,917,19.3,1868.5
4500727933,0,17,2,1,2,2,1,1,0,1,0,14687,6.8,17701,234,53,-668,-300,23.4,1468.7,32,5,0,2,2,2,0,0,0,0,15355,6.8,18001,255,48,668,300,25.5,1535.5
4527355531,0,13,1,0,6,3,5,2,1,1,0,16807,7.2,19662,232,60,2052,2845,23.2,1680.7,75,1,1,3,6,1,0,0,0,0,14755,6.8,16817,216,48,-2052,-2845,21.6,1475.5
4483322661,1,16,6,1,10,11,8,0,0,0,0,18472,7.2,19144,228,47,1041,1187,22.8,1847.2,17,3,0,11,10,8,1,1,0,0,17431,6.8,17957,175,50,-1041,-1187,17.5,1743.1
4519324641,1,34,0,1,13,5,12,1,1,0,0,19535,7.4,19835,231,53,4778,4324,23.1,1953.5,17,2,0,5,13,5,0,0,0,0,14757,6.2,15511,173,51,-4778,-4324,17.3,1475.7
4502676809,0,68,2,1,13,3,19,1,0,1,0,17529,6.8,17038,138,40,1530,-1195,13.8,1752.9,17,5,0,3,13,2,1,1,0,0,15999,6.8,18233,243,63,-1530,1195,24.3,1599.9
4498399527,1,20,2,1,11,5,11,1,0,1,0,18474,7.0,18239,217,43,2680,1517,21.7,1847.4,15,3,0,5,11,4,0,0,0,0,15794,6.4,16722,219,51,-2680,-1517,21.9,1579.4
4524977658,1,16,2,0,9,8,9,0,0,0,0,17652,7.4,18869,225,50,775,1702,22.5,1765.2,17,2,1,8,9,3,1,0,1,0,16877,6.6,17167,210,44,-775,-1702,21.0,1687.7
4498511846,1,20,5,1,8,2,9,2,1,1,0,18323,7.4,20458,262,52,4011,2732,26.2,1832.3,16,7,0,2,8,0,0,0,0,0,14312,6.6,17726,208,58,-4011,-2732,20.8,1431.2
4451821740,0,13,4,0,5,6,7,1,1,0,0,15880,7.2,18313,219,64,-1891,263,21.9,1588.0,14,3,1,6,5,4,0,0,0,1,17771,7.0,18050,236,56,1891,-263,23.6,1777.1
4519375393,1,13,3,0,7,4,5,0,0,0,0,16650,7.0,18854,233,48,-612,549,23.3,1665.0,19,1,1,4,7,5,2,1,1,1,17262,7.0,18305,232,59,612,-549,23.2,1726.2
4461785475,1,11,1,0,5,8,2,2,1,1,0,16101,7.2,18784,230,68,-2069,-242,23.0,1610.1,13,1,1,8,5,6,0,0,0,0,18170,7.0,19026,239,52,2069,242,23.9,1817.0
4480246258,1,15,1,0,2,8,1,1,0,1,0,15041,6.8,17616,229,58,-3259,-1311,22.9,1504.1,19,3,1,8,2,13,1,1,0,0,18300,7.0,18927,249,56,3259,1311,24.9,1830.0
4523383339,0,12,2,0,1,10,0,0,0,0,0,14058,6.6,16535,214,64,-5327,-4636,21.4,1405.8,14,2,1,10,1,10,2,1,1,1,19385,7.6,21171,234,57,5327,4636,23.4,1938.5
4490735415,1,17,3,0,7,4,5,1,1,0,0,16819,7.2,18725,239,60,707,1960,23.9,1681.9,37,2,1,4,7,3,0,0,0,0,16112,6.8,16765,198,52,-707,-1960,19.8,1611.2
4523395238,1,23,5,1,9,2,8,1,1,0,0,17194,7.4,19161,221,40,2410,1034,22.1,1719.4,12,2,0,2,9,0,0,0,0,0,14784,6.8,18127,235,55,-2410,-1034,23.5,1478.4
4510202032,0,18,4,0,6,8,5,0,0,0,0,15476,6.8,17206,187,36,-2403,-2787,18.7,1547.6,139,5,1,8,6,9,1,1,0,0,17879,7.4,19993,243,53,2403,2787,24.3,1787.9
4523752057,0,30,4,0,6,11,8,0,0,0,0,15376,6.6,16758,196,28,-4264,-3932,19.6,1537.6,16,4,1,11,6,6,2,1,1,0,19640,7.4,20690,262,72,4264,3932,26.2,1964.0
4513302428,0,18,3,1,8,9,9,1,1,0,0,16789,6.8,17799,205,40,-898,-1077,20.5,1678.9,14,5,0,9,8,13,0,0,0,0,17687,7.2,18876,199,68,898,1077,19.9,1768.7
4511747596,0,15,2,1,12,8,18,0,0,0,0,18238,6.8,16827,189,32,1797,-723,18.9,1823.8,18,4,0,8,12,5,1,1,0,0,16441,6.8,17550,190,47,-1797,723,19.0,1644.1
4516101575,1,18,4,1,16,4,13,0,0,0,0,20827,7.4,19657,215,50,5491,4640,21.5,2082.7,18,2,0,4,16,4,0,0,0,0,15336,6.4,15017,183,54,-5491,-4640,18.3,1533.6
4523938841,0,27,7,0,6,6,11,0,0,0,0,16319,6.6,17353,214,39,52,554,21.4,1631.9,18,8,1,6,6,6,1,0,1,0,16267,6.6,16799,235,36,-52,-554,23.5,1626.7
4523747667,1,14,1,0,6,6,6,0,0,0,0,17077,7.0,19128,242,61,-162,177,24.2,1707.7,15,2,1,6,6,9,0,0,0,0,17239,7.0,18951,245,66,162,-177,24.5,1723.9
4489894297,1,20,5,0,6,2,4,1,0,1,0,17528,7.2,20077,257,64,2605,2260,25.7,1752.8,16,4,1,2,6,3,1,1,0,0,14923,6.8,17817,254,51,-2605,-2260,25.4,1492.3
4503866171,0,17,2,0,4,9,2,2,1,1,0,14997,6.6,16588,217,48,-2566,-2224,21.7,1499.7,14,4,1,9,4,9,0,0,0,0,17563,7.2,18812,216,48,2566,2224,21.6,1756.3
4523427985,0,14,4,1,5,5,4,1,1,0,0,16755,7.2,18596,261,56,1470,498,26.1,1675.5,13,4,0,5,5,3,0,0,0,0,15285,7.0,18098,217,46,-1470,-498,21.7,1528.5
4519350434,1,16,1,1,7,2,6,1,0,1,0,17082,7.0,18373,221,40,2216,1580,22.1,1708.2,13,2,0,2,7,3,1,1,0,0,14866,6.6,16793,208,64,-2216,-1580,20.8,1486.6
4494238237,1,15,3,1,9,6,9,0,0,0,0,18287,7.4,19617,226,44,1863,2270,22.6,1828.7,16,3,0,6,9,6,0,0,0,0,16424,6.8,17347,232,49,-1863,-2270,23.2,1642.4
4486463961,1,15,1,1,4,2,2,0,0,0,0,16127,7.2,18510,225,63,1439,755,22.5,1612.7,11,2,0,2,4,1,1,1,0,0,14688,6.8,17755,210,72,-1439,-755,21.0,1468.8
4524325797,1,17,1,0,5,2,2,0,0,0,0,16655,7.2,19541,238,59,2089,1675,23.8,1665.5,12,3,1,2,5,3,1,1,0,0,14566,6.8,17866,224,57,-2089,-1675,22.4,1456.6
4527908858,0,14,2,0,1,3,0,1,0,1,0,13836,6.6,17114,213,59,-1798,-674,21.3,1383.6,14,3,1,3,1,4,1,1,0,0,15634,6.8,17788,251,46,1798,674,25.1,1563.4
4502309990,0,53,2,1,5,1,8,2,1,1,0,16165,6.8,18233,215,67,1321,1735,21.5,1616.5,14,2,0,1,5,2,0,0,0,0,14844,6.6,16498,245,56,-1321,-1735,24.5,1484.4
4439674846,0,41,2,1,5,6,3,1,0,1,1,17389,7.4,19074,224,53,760,120,22.4,1738.9,13,3,0,6,5,6,1,1,0,0,16629,7.2,18954,235,57,-760,-120,23.5,1662.9
4514482057,0,11,1,0,2,19,0,0,0,0,0,12403,5.2,11921,152,28,-10329,-8531,15.2,1240.3,13,1,1,19,2,16,1,1,0,1,22732,7.6,20452,232,71,10329,8531,23.2,2273.2
4508149513,0,23,1,0,10,6,5,1,1,0,0,17151,7.0,18598,195,43,267,553,19.5,1715.1,15,4,1,6,10,5,0,0,0,0,16884,6.8,18045,234,32,-267,-553,23.4,1688.4
4523303530,1,18,3,1,14,5,12,1,1,0,0,20294,6.8,18459,230,48,5805,4777,23.0,2029.4,17,1,0,5,14,6,0,0,0,0,14489,5.8,13682,178,28,-5805,-4777,17.8,1448.9
4477434796,0,17,3,0,8,2,15,0,0,0,0,16393,7.2,18783,196,48,1131,1370,19.6,1639.3,17,3,1,2,8,3,1,1,0,0,15262,6.8,17413,253,50,-1131,-1370,25.3,1526.2
4515211180,1,15,2,1,5,4,1,2,1,1,0,15917,7.0,18370,211,64,805,691,21.1,1591.7,13,3,0,4,5,4,0,0,0,0,15112,6.8,17679,187,60,-805,-691,18.7,1511.2
4437580789,0,16,5,0,5,6,4,0,0,0,0,16258,7.0,18533,255,47,585,570,25.5,1625.8,39,3,1,6,5,9,0,0,0,0,15673,6.8,17963,180,52,-585,-570,18.0,1567.3
4458069984,0,23,3,1,3,6,3,1,0,1,1,16970,6.8,17789,252,64,381,108,25.2,1697.0,11,3,0,6,3,9,1,1,0,0,16589,7.0,17681,199,62,-381,-108,19.9,1658.9
4448485009,0,14,4,0,0,15,0,0,0,0,0,12971,6.4,14675,181,56,-6850,-6210,18.1,1297.1,18,3,1,15,0,16,1,1,0,0,19821,7.6,20885,236,40,6850,6210,23.6,1982.1
4523655915,0,118,2,1,3,12,2,1,1,0,0,14299,6.4,15937,207,38,-4376,-3665,20.7,1429.9,48,1,0,12,3,14,1,0,1,0,18675,7.4,19602,206,55,4376,3665,20.6,1867.5
4526035454,0,16,3,0,5,8,6,0,0,0,0,15432,7.0,17869,225,46,-2228,-745,22.5,1543.2,17,2,1,8,5,8,1,1,0,0,17660,7.0,18614,247,56,2228,745,24.7,1766.0
4526376483,0,17,2,0,5,7,9,0,0,0,0,14690,6.4,15168,188,40,-5426,-3115,18.8,1469.0,14,0,1,7,5,9,1,1,0,2,20116,7.0,18283,245,43,5426,3115,24.5,2011.6
4492250541,0,10,2,1,6,8,7,1,1,0,0,14779,6.2,15595,137,44,-2932,-2570,13.7,1477.9,13,2,0,8,6,5,1,0,1,0,17711,7.2,18165,219,52,2932,2570,21.9,1771.1
4526553053,0,16,19,0,9,8,9,1,1,0,0,17617,7.0,18621,245,42,-642,311,24.5,1761.7,35,1,1,8,9,11,0,0,0,0,18259,6.8,18310,236,44,642,-311,23.6,1825.9
4523304225,0,15,0,1,7,8,15,1,1,0,0,15381,6.2,14805,167,39,-1611,-1901,16.7,1538.1,13,2,0,8,7,8,0,0,0,0,16992,6.6,16706,201,53,1611,1901,20.1,1699.2
4500666491,1,13,1,1,13,6,13,1,1,0,1,20103,6.8,17668,220,32,4688,983,22.0,2010.3,12,1,0,6,13,4,0,0,0,0,15415,6.8,16685,172,44,-4688,-983,17.2,1541.5
4505441890,0,42,4,1,7,3,5,2,1,1,0,16820,7.2,18804,222,50,1968,1923,22.2,1682.0,15,3,0,3,7,4,0,0,0,0,14852,6.8,16881,205,56,-1968,-1923,20.5,1485.2
4493176140,0,39,2,0,1,6,0,0,0,0,0,14266,7.2,18401,223,68,-1659,-874,22.3,1426.6,16,1,1,6,1,4,1,1,0,0,15925,7.2,19275,236,48,1659,874,23.6,1592.5
4521285475,0,16,3,1,11,8,11,1,1,0,0,19239,7.6,19698,209,47,2587,1759,20.9,1923.9,14,2,0,8,11,4,0,0,0,0,16652,6.8,17939,195,44,-2587,-1759,19.5,1665.2
4523647003,1,15,3,0,6,8,5,0,0,0,0,16530,6.8,17332,226,47,-673,-1416,22.6,1653.0,15,3,1,8,6,6,0,0,0,0,17203,7.2,18748,198,44,673,1416,19.8,1720.3
4521428251,0,13,1,0,2,14,3,0,0,0,0,14535,6.6,16907,195,67,-6147,-1215,19.5,1453.5,18,1,1,14,2,21,2,1,1,1,20682,7.0,18122,189,48,6147,1215,18.9,2068.2
4471072375,0,17,4,1,6,9,8,0,0,0,0,17157,7.0,17928,226,41,-702,-2110,22.6,1715.7,45,2,0,9,6,5,2,1,1,0,17859,7.6,20038,208,68,702,2110,20.8,1785.9
4524277533,1,89,4,1,10,3,16,1,1,0,0,18487,7.2,18183,211,49,3851,1574,21.1,1848.7,17,1,0,3,10,3,0,0,0,0,14636,6.4,16609,211,52,-3851,-1574,21.1,1463.6
4477250448,1,176,1,0,9,8,11,0,0,0,0,17426,7.0,17243,234,33,395,-504,23.4,1742.6,15,3,1,8,9,9,0,0,0,0,17031,6.8,17747,188,60,-395,504,18.8,1703.1
4526597273,1,89,2,1,11,7,14,0,0,0,0,19866,7.6,20339,202,53,3128,2919,20.2,1986.6,15,2,0,7,11,5,0,0,0,0,16738,6.8,17420,202,48,-3128,-2919,20.2,1673.8
4525767323,1,21,0,1,6,5,6,0,0,0,0,17467,7.0,18794,238,60,2135,1898,23.8,1746.7,18,0,0,5,6,6,0,0,0,0,15332,6.8,16896,194,56,-2135,-1898,19.4,1533.2
4459250324,1,18,1,1,7,1,13,0,0,0,0,18486,7.4,20095,264,68,5159,4916,26.4,1848.6,16,2,0,1,7,2,1,1,0,0,13327,6.4,15179,182,48,-5159,-4916,18.2,1332.7
4519606068,0,14,1,1,6,3,10,0,0,0,0,17772,7.2,19337,251,68,3401,2392,25.1,1777.2,52,1,0,3,6,2,1,1,0,0,14371,6.6,16945,204,53,-3401,-2392,20.4,1437.1
4465850018,1,18,2,1,7,8,5,1,1,0,0,17551,7.0,18910,244,49,-1018,1114,24.4,1755.1,25,3,0,8,7,10,0,0,0,1,18569,7.0,17796,204,49,1018,-1114,20.4,1856.9
4465074882,1,19,2,1,6,3,5,0,0,0,0,17837,7.2,19440,238,76,2970,2037,23.8,1783.7,50,4,0,3,6,4,0,0,0,0,14867,7.0,17403,217,52,-2970,-2037,21.7,1486.7
4494398674,1,15,5,0,4,3,4,0,0,0,0,15755,7.2,19845,225,64,951,2193,22.5,1575.5,17,2,1,3,4,2,2,1,1,0,14804,7.0,17652,197,48,-951,-2193,19.7,1480.4
4524697889,0,25,4,1,5,3,4,1,0,1,0,16788,7.2,19474,264,59,1346,919,26.4,1678.8,39,3,0,3,5,6,1,1,0,0,15442,7.2,18555,242,56,-1346,-919,24.2,1544.2
4524566324,0,23,1,0,8,9,8,1,0,1,0,17380,7.2,18665,220,60,-213,399,22.0,1738.0,14,1,1,9,8,14,0,0,0,0,17593,7.0,18266,215,36,213,-399,21.5,1759.3
4512198304,1,9,1,1,9,8,8,1,0,1,1,18731,6.8,18892,191,57,1601,459,19.1,1873.1,15,0,0,8,9,6,1,1,0,0,17130,7.2,18433,240,44,-1601,-459,24.0,1713.0
4522571135,1,42,5,1,8,6,11,1,1,0,0,17072,7.2,18825,205,42,-164,851,20.5,1707.2,13,6,0,6,8,8,1,0,1,0,17236,7.0,17974,244,45,164,-851,24.4,1723.6
4473770063,1,15,3,0,13,8,13,1,0,1,0,20711,7.6,20463,220,68,3673,1956,22.0,2071.1,15,2,1,8,13,4,1,1,0,0,17038,7.0,18507,209,44,-3673,-1956,20.9,1703.8
4514070165,0,12,0,0,10,7,11,0,0,0,1,20278,7.2,19575,236,58,4633,2269,23.6,2027.8,20,1,1,7,10,6,1,1,0,0,15645,6.6,17306,182,45,-4633,-2269,18.2,1564.5
4487367871,1,16,1,0,8,7,8,0,0,0,0,17404,7.0,18717,204,60,-882,-740,20.4,1740.4,25,3,1,7,8,9,1,1,0,0,18286,7.4,19457,253,63,882,740,25.3,1828.6
4487639972,1,21,3,1,12,1,14,1,1,0,0,18923,7.0,18586,236,44,5323,2352,23.6,1892.3,52,4,0,1,12,1,0,0,0,0,13600,6.4,16234,191,56,-5323,-2352,19.1,1360.0
4527576450,0,13,2,0,4,8,3,0,0,0,0,14668,6.6,16865,193,32,-2958,-1446,19.3,1466.8,15,2,1,8,4,9,1,1,0,0,17626,7.0,18311,232,43,2958,1446,23.2,1762.6
4499958470,1,12,3,1,8,7,7,1,1,0,0,16972,7.0,18007,184,44,891,1054,18.4,1697.2,14,1,0,7,8,7,0,0,0,0,16081,6.6,16953,196,51,-891,-1054,19.6,1608.1
4489264481,1,50,2,0,4,3,5,1,1,0,0,15120,6.8,16751,218,48,938,2052,21.8,1512.0,13,1,1,3,4,3,0,0,0,0,14182,5.8,14699,178,46,-938,-2052,17.8,1418.2
4477447831,1,19,4,0,6,5,8,1,1,0,0,15416,6.8,17061,199,55,-1342,-713,19.9,1541.6,34,4,1,5,6,7,0,0,0,0,16758,6.8,17774,248,50,1342,713,24.8,1675.8
4456404061,0,41,4,1,6,5,5,1,0,1,0,15510,7.0,17367,202,33,-264,550,20.2,1551.0,16,5,0,5,6,6,1,1,0,0,15774,6.6,16817,202,51,264,-550,20.2,1577.4
4526421447,0,23,1,0,6,8,3,0,0,0,0,16365,6.8,18280,195,71,94,1896,19.5,1636.5,18,3,1,8,6,8,1,1,0,0,16271,6.6,16384,191,50,-94,-1896,19.1,1627.1
4509704397,0,16,6,0,6,4,5,1,1,0,0,16249,6.8,18007,221,40,444,1056,22.1,1624.9,23,3,1,4,6,4,1,0,1,0,15805,7.0,16951,213,51,-444,-1056,21.3,1580.5
4521752199,0,20,1,0,1,5,1,1,1,0,0,14358,6.6,16468,203,56,-3071,-2267,20.3,1435.8,15,2,1,5,1,2,1,0,1,1,17429,7.0,18735,242,56,3071,2267,24.2,1742.9
4515450314,0,20,5,0,3,3,4,1,1,0,0,14771,6.8,17669,234,52,-916,190,23.4,1477.1,19,5,1,3,3,5,0,0,0,0,15687,6.8,17479,242,42,916,-190,24.2,1568.7
4474734161,0,11,3,0,6,10,10,0,0,0,0,14901,6.2,14483,170,38,-2834,-3402,17.0,1490.1,25,5,1,10,6,9,1,1,0,0,17735,7.0,17885,216,56,2834,3402,21.6,1773.5
4513334506,0,18,1,0,5,5,2,1,0,1,0,15795,7.2,18512,201,53,187,1356,20.1,1579.5,15,5,1,5,5,3,0,0,0,0,15608,7.0,17156,204,45,-187,-1356,20.4,1560.8
4446060203,0,14,3,0,5,7,7,0,0,0,0,15293,6.4,15389,202,44,-4408,-4522,20.2,1529.3,14,0,1,7,5,2,2,1,1,2,19701,7.4,19911,250,72,4408,4522,25.0,1970.1
4440187029,0,86,2,0,2,4,1,0,0,0,0,14291,7.0,18239,207,65,-2609,-1786,20.7,1429.1,15,4,1,4,2,3,1,1,0,0,16900,7.6,20025,259,76,2609,1786,25.9,1690.0
4487124026,1,21,4,0,7,7,9,0,0,0,0,17251,7.0,19522,225,60,-172,1613,22.5,1725.1,18,3,1,7,7,9,0,0,0,0,17423,6.8,17909,224,48,172,-1613,22.4,1742.3
4469156590,0,14,0,1,8,13,8,1,1,0,0,16797,6.8,17770,200,48,-3201,-3067,20.0,1679.7,55,1,0,13,8,16,0,0,0,0,19998,7.6,20837,232,47,3201,3067,23.2,1999.8
4525207447,1,49,4,0,4,3,6,0,0,0,0,15091,7.2,18237,215,39,-1516,-441,21.5,1509.1,16,7,1,3,4,3,1,1,0,0,16607,7.0,18678,267,54,1516,441,26.7,1660.7
4526981145,0,27,4,0,4,7,5,0,0,0,0,15398,6.8,17243,213,56,-1091,-617,21.3,1539.8,15,0,1,7,4,5,2,1,1,0,16489,6.8,17860,222,59,1091,617,22.2,1648.9
4468243911,0,13,0,1,6,7,2,0,0,0,0,16190,6.8,18041,234,54,-158,-67,23.4,1619.0,16,0,0,7,6,13,1,1,0,0,16348,7.0,18108,217,51,158,67,21.7,1634.8
4450742884,0,14,3,0,4,2,5,1,0,1,0,16247,7.4,19687,226,72,1032,1098,22.6,1624.7,16,0,1,2,4,2,1,1,0,0,15215,7.0,18589,243,68,-1032,-1098,24.3,1521.5
4502988804,0,14,5,0,2,8,2,0,0,0,0,14177,6.4,15427,196,54,-2115,-2872,19.6,1417.7,18,2,1,8,2,18,1,1,0,0,16292,7.0,18299,200,43,2115,2872,20.0,1629.2
4492541051,0,22,3,1,7,2,3,0,0,0,0,16729,7.2,19694,231,56,2248,3163,23.1,1672.9,14,2,0,2,7,1,0,0,0,0,14481,6.4,16531,206,53,-2248,-3163,20.6,1448.1
4516238539,1,15,1,1,8,2,10,1,1,0,0,19630,7.2,20181,246,64,5082,2398,24.6,1963.0,16,0,0,2,8,2,0,0,0,0,14548,6.8,17783,226,60,-5082,-2398,22.6,1454.8
4525929245,0,14,0,0,2,5,2,1,0,1,0,14115,6.8,16918,199,60,-1909,-1282,19.9,1411.5,14,2,1,5,2,5,1,1,0,0,16024,7.0,18200,229,52,1909,1282,22.9,1602.4
4517922938,0,15,1,0,7,12,8,1,0,1,0,15523,6.6,16556,179,46,-3825,-1386,17.9,1552.3,18,1,1,12,7,16,1,1,0,0,19348,7.2,17942,217,60,3825,1386,21.7,1934.8
4518123913,1,15,2,1,7,2,9,0,0,0,0,17773,7.6,20821,242,67,2421,3009,24.2,1777.3,38,2,0,2,7,2,0,0,0,0,15352,7.0,17812,221,64,-2421,-3009,22.1,1535.2
4457032161,1,16,4,0,2,3,5,1,1,0,0,14627,6.8,16759,214,64,-1113,-1417,21.4,1462.7,15,6,1,3,2,5,0,0,0,0,15740,7.0,18176,235,68,1113,1417,23.5,1574.0
4511790029,0,15,4,0,5,10,7,0,0,0,0,15381,6.4,16749,202,51,-2099,-1505,20.2,1538.1,19,4,1,10,5,15,1,1,0,0,17480,7.0,18254,206,52,2099,1505,20.6,1748.0
4510716037,1,44,1,1,8,3,9,1,1,0,0,17316,7.2,18689,227,68,3172,2797,22.7,1731.6,14,1,0,3,8,4,0,0,0,0,14144,6.2,15892,200,40,-3172,-2797,20.0,1414.4
4527662502,1,17,3,1,7,4,10,1,1,0,0,17197,7.2,18431,224,64,2348,1047,22.4,1719.7,19,2,0,4,7,4,0,0,0,0,14849,6.6,17384,206,49,-2348,-1047,20.6,1484.9
4422263673,0,11,3,1,4,9,4,1,1,0,0,15114,6.8,16890,193,56,-1210,-2064,19.3,1511.4,17,3,0,9,4,4,0,0,0,0,16324,7.2,18954,213,52,1210,2064,21.3,1632.4
4494748194,1,15,4,1,12,5,18,2,1,1,1,20176,7.0,18972,218,60,4634,2354,21.8,2017.6,16,0,0,5,12,3,0,0,0,0,15542,6.6,16618,217,43,-4634,-2354,21.7,1554.2
4527513607,0,27,4,0,6,8,10,0,0,0,0,17250,7.2,18763,206,60,86,467,20.6,1725.0,65,2,1,8,6,9,2,1,1,0,17164,7.0,18296,197,60,-86,-467,19.7,1716.4
4459277927,0,35,1,0,5,6,6,0,0,0,0,16230,7.4,19157,228,44,-839,-833,22.8,1623.0,16,4,1,6,5,3,2,1,1,0,17069,7.4,19990,239,88,839,833,23.9,1706.9
4527528512,1,17,2,1,16,3,15,1,1,0,1,22697,7.6,21092,254,51,8553,4873,25.4,2269.7,12,1,0,3,16,2,0,0,0,0,14144,6.4,16219,166,48,-8553,-4873,16.6,1414.4
4514249734,1,12,2,0,3,2,3,0,0,0,0,15484,6.8,18175,250,49,239,-709,25.0,1548.4,12,2,1,2,3,0,2,1,1,0,15245,7.2,18884,209,88,-239,709,20.9,1524.5
4503345780,1,12,3,1,4,2,5,0,0,0,0,16164,7.2,19020,246,46,956,-27,24.6,1616.4,59,1,0,2,4,3,1,1,0,0,15208,7.2,19047,242,73,-956,27,24.2,1520.8
4527448169,0,15,4,1,3,8,5,0,0,0,0,15259,6.6,17346,206,64,-2738,-1759,20.6,1525.9,20,4,0,8,3,10,1,1,0,0,17997,7.2,19105,251,56,2738,1759,25.1,1799.7
4527628313,0,14,4,1,2,3,3,1,1,0,0,14459,6.6,17229,224,48,-839,-1085,22.4,1445.9,66,4,0,3,2,1,0,0,0,0,15298,7.2,18314,247,40,839,1085,24.7,1529.8
4454238812,0,13,3,0,7,7,8,0,0,0,0,16164,6.8,18803,239,40,-1050,88,23.9,1616.4,14,2,1,7,7,8,1,1,0,0,17214,7.2,18715,237,47,1050,-88,23.7,1721.4
4480250709,1,18,4,1,15,4,16,1,1,0,1,21711,7.4,19183,247,48,7413,4895,24.7,2171.1,20,2,0,4,15,5,0,0,0,0,14298,5.8,14288,136,51,-7413,-4895,13.6,1429.8
4459608159,1,26,5,1,4,1,3,0,0,0,0,16210,6.8,19051,261,41,1169,564,26.1,1621.0,20,5,0,1,4,1,1,1,0,0,15041,7.0,18487,232,69,-1169,-564,23.2,1504.1
4525567739,1,15,1,0,4,3,5,0,0,0,0,15502,7.0,17716,223,56,243,-31,22.3,1550.2,17,2,1,3,4,5,1,1,0,0,15259,6.8,17747,214,49,-243,31,21.4,1525.9
4525637660,0,32,5,0,8,8,7,1,1,0,0,17942,7.2,18724,213,52,1171,918,21.3,1794.2,15,3,1,8,8,12,0,0,0,0,16771,7.0,17806,189,44,-1171,-918,18.9,1677.1
4427379345,1,15,5,1,10,1,9,1,1,0,0,19225,7.4,20071,253,43,4947,2051,25.3,1922.5,16,2,0,1,10,1,1,0,1,0,14278,6.8,18020,200,49,-4947,-2051,20.0,1427.8
4497851268,1,21,3,1,10,5,14,1,1,0,0,18459,7.0,17936,187,52,2955,1124,18.7,1845.9,40,3,0,5,10,7,0,0,0,0,15504,6.8,16812,196,36,-2955,-1124,19.6,1550.4
4477778320,0,14,4,1,7,11,5,0,0,0,0,16308,6.8,17166,195,42,-1903,-1398,19.5,1630.8,17,2,0,11,7,10,1,1,0,0,18211,7.2,18564,214,36,1903,1398,21.4,1821.1
4511560979,1,19,2,1,9,7,9,0,0,0,0,17498,7.0,17932,200,42,1023,19,20.0,1749.8,16,2,0,7,9,6,1,0,1,0,16475,6.8,17913,196,32,-1023,-19,19.6,1647.5
4459102512,1,15,1,1,9,6,12,0,0,0,0,17027,6.8,17004,175,49,573,48,17.5,1702.7,16,2,0,6,9,11,0,0,0,0,16454,7.0,16956,191,56,-573,-48,19.1,1645.4
4500140173,1,42,6,0,7,1,10,1,0,1,0,17696,7.2,19541,257,56,3518,2503,25.7,1769.6,20,12,1,1,7,1,1,1,0,0,14178,6.6,17038,239,47,-3518,-2503,23.9,1417.8
4524001627,0,16,2,0,5,3,7,0,0,0,0,16210,7.2,17888,226,36,766,-662,22.6,1621.0,36,2,1,3,5,2,0,0,0,0,15444,6.8,18550,202,72,-766,662,20.2,1544.4
4481808097,0,53,3,1,7,5,7,1,0,1,0,16851,7.2,18450,221,48,936,386,22.1,1685.1,16,5,0,5,7,2,1,1,0,0,15915,7.0,18064,253,59,-936,-386,25.3,1591.5
4492655929,0,13,2,0,6,14,4,0,0,0,0,15484,7.0,17528,188,46,-5634,-3787,18.8,1548.4,15,5,1,14,6,9,1,1,0,0,21118,7.8,21315,243,52,5634,3787,24.3,2111.8
4516247062,1,19,3,1,7,6,8,0,0,0,0,16135,6.8,17313,196,48,494,-1338,19.6,1613.5,16,3,0,6,7,2,0,0,0,0,15641,7.2,18651,214,64,-494,1338,21.4,1564.1
4500382908,0,23,5,0,6,7,10,0,0,0,0,16802,6.8,17626,243,44,-1599,-1890,24.3,1680.2,16,3,1,7,6,12,0,0,0,0,18401,7.2,19516,237,58,1599,1890,23.7,1840.1
4503514914,0,37,3,0,3,3,1,0,0,0,0,15311,7.0,17731,187,67,597,1596,18.7,1531.1,16,2,1,3,3,7,1,1,0,0,14714,6.4,16135,212,45,-597,-1596,21.2,1471.4
4513250819,0,16,1,1,11,11,6,2,1,1,0,17558,7.0,18661,174,64,-369,-379,17.4,1755.8,34,4,0,11,11,11,0,0,0,0,17927,7.4,19040,188,44,369,379,18.8,1792.7
4438463370,1,15,4,1,12,3,8,2,1,1,0,18821,7.4,20341,225,72,5301,5872,22.5,1882.1,14,1,0,3,12,3,0,0,0,0,13520,6.4,14469,167,48,-5301,-5872,16.7,1352.0
4494820088,0,13,0,1,3,8,2,0,0,0,0,14760,6.4,16005,183,53,-1964,-3710,18.3,1476.0,21,0,0,8,3,6,1,1,0,0,16724,7.4,19715,200,74,1964,3710,20.0,1672.4
4526845864,0,16,0,0,4,13,2,0,0,0,0,13337,6.0,14126,141,43,-6092,-4820,14.1,1333.7,21,2,1,13,4,9,1,1,0,0,19429,7.2,18946,216,53,6092,4820,21.6,1942.9
4521141192,0,41,2,1,5,8,3,0,0,0,0,16042,7.0,18424,238,56,-686,-893,23.8,1604.2,16,4,0,8,5,4,2,1,1,0,16728,7.2,19317,216,71,686,893,21.6,1672.8
4476326915,0,138,1,0,5,9,3,0,0,0,0,15108,6.8,17595,202,53,-3086,-1701,20.2,1510.8,18,1,1,9,5,8,1,1,0,0,18194,7.2,19296,222,47,3086,1701,22.2,1819.4
4520985137,0,18,3,0,1,7,1,0,0,0,0,13874,6.4,15799,219,33,-2933,-2159,21.9,1387.4,13,2,1,7,1,8,2,1,1,0,16807,7.0,17958,215,62,2933,2159,21.5,1680.7
4505913217,1,15,0,0,10,5,11,1,0,1,0,18972,7.2,19388,231,36,3559,2227,23.1,1897.2,9,4,1,5,10,4,0,0,0,0,15413,6.6,17161,189,55,-3559,-2227,18.9,1541.3
4464639816,0,48,3,0,3,7,0,0,0,0,0,14467,7.0,17728,220,58,-2287,-735,22.0,1446.7,16,3,1,7,3,6,1,1,0,0,16754,7.0,18463,218,40,2287,735,21.8,1675.4
4519753896,0,19,1,0,2,10,2,1,1,0,0,14020,6.4,15872,203,55,-4215,-1902,20.3,1402.0,14,4,1,10,2,11,1,0,1,0,18235,6.8,17774,229,48,4215,1902,22.9,1823.5
4522271198,1,15,2,1,6,5,3,1,1,0,0,15712,6.8,17676,216,48,267,745,21.6,1571.2,19,1,0,5,6,7,0,0,0,0,15445,6.8,16931,203,44,-267,-745,20.3,1544.5
4522394402,0,19,2,1,9,9,12,1,1,0,0,17187,7.0,17605,197,38,-1675,-1382,19.7,1718.7,16,1,0,9,9,11,1,0,1,0,18862,7.2,18987,206,40,1675,1382,20.6,1886.2
4454104215,1,14,2,0,9,8,10,1,1,0,0,17530,7.0,18299,192,43,-7,-231,19.2,1753.0,19,2,1,8,9,8,1,0,1,0,17537,7.2,18530,209,60,7,231,20.9,1753.7
4508759067,0,51,2,1,5,6,1,1,0,1,0,15332,7.0,18496,215,44,-1442,-1048,21.5,1533.2,18,0,0,6,5,9,1,1,0,0,16774,7.2,19544,220,68,1442,1048,22.0,1677.4
4477116393,0,14,2,0,4,6,5,0,0,0,0,16414,6.8,18297,247,62,-58,-1047,24.7,1641.4,16,3,1,6,4,2,1,1,0,0,16472,7.0,19344,244,60,58,1047,24.4,1647.2
4492355025,0,18,4,0,7,8,9,1,1,0,0,15718,6.6,16225,159,32,-1012,-316,15.9,1571.8,18,1,1,8,7,13,0,0,0,0,16730,6.6,16541,192,42,1012,316,19.2,1673.0
4521894738,1,20,4,0,9,8,11,2,1,1,0,17408,7.0,17809,207,48,360,97,20.7,1740.8,42,4,1,8,9,12,0,0,0,0,17048,7.0,17712,191,47,-360,-97,19.1,1704.8
4483811680,0,41,2,0,5,5,8,0,0,0,0,15675,6.4,16501,218,39,549,224,21.8,1567.5,12,2,1,5,5,7,1,1,0,0,15126,6.6,16277,170,36,-549,-224,17.0,1512.6
4506543397,1,16,2,0,9,7,11,1,0,1,0,17949,6.6,17918,234,40,1076,-845,23.4,1794.9,18,2,1,7,9,6,0,0,0,0,16873,7.2,18763,214,56,-1076,845,21.4,1687.3
4445410783,1,41,1,1,10,7,8,0,0,0,0,17183,7.0,17906,208,45,1100,170,20.8,1718.3,15,3,0,7,10,5,1,1,0,0,16083,7.0,17736,166,47,-1100,-170,16.6,1608.3
4518209107,1,13,3,0,13,9,12,1,1,0,0,20541,7.4,19687,260,60,2368,1767,26.0,2054.1,28,3,1,9,13,16,0,0,0,0,18173,6.8,17920,169,52,-2368,-1767,16.9,1817.3
4451562288,1,16,5,0,5,9,4,0,0,0,0,14980,6.8,17318,187,46,-3729,-3285,18.7,1498.0,21,3,1,9,5,7,1,1,0,0,18709,7.6,20603,257,56,3729,3285,25.7,1870.9
4523566320,1,87,4,1,4,9,4,1,0,1,0,16074,7.0,18077,237,55,-855,227,23.7,1607.4,31,5,0,9,4,10,1,1,0,0,16929,7.0,17850,211,48,855,-227,21.1,1692.9
4522681859,0,20,3,0,7,6,6,0,0,0,0,17421,7.2,19606,241,59,1053,1304,24.1,1742.1,14,5,1,6,7,4,2,1,1,0,16368,7.2,18302,223,60,-1053,-1304,22.3,1636.8
4512231954,0,19,2,0,5,6,2,2,1,1,0,15975,6.6,17545,222,60,-33,-559,22.2,1597.5,12,2,1,6,5,7,0,0,0,0,16008,7.0,18104,214,55,33,559,21.4,1600.8
4489658562,0,12,2,1,10,16,10,1,0,1,0,18145,6.6,17219,199,46,-3228,-2075,19.9,1814.5,14,4,0,16,10,13,1,1,0,0,21373,7.2,19294,237,38,3228,2075,23.7,2137.3
4460106105,0,15,3,0,4,6,2,0,0,0,0,15009,6.4,16571,211,44,-1806,-1419,21.1,1500.9,21,4,1,6,4,7,2,1,1,0,16815,7.0,17990,220,59,1806,1419,22.0,1681.5
4523312130,0,16,2,0,5,12,5,0,0,0,0,15871,6.6,16751,202,41,-2201,-2344,20.2,1587.1,39,2,1,12,5,9,1,1,0,0,18072,7.2,19095,221,28,2201,2344,22.1,1807.2
4507437151,0,13,4,0,11,6,13,1,1,0,0,18395,6.6,16701,206,31,2933,1905,20.6,1839.5,12,1,1,6,11,6,0,0,0,0,15462,6.2,14796,167,39,-2933,-1905,16.7,1546.2
4522030672,1,17,3,0,1,1,1,1,0,1,0,14969,6.8,17547,252,48,1089,33,25.2,1496.9,49,2,1,1,1,0,0,0,0,0,13880,6.8,17514,212,47,-1089,-33,21.2,1388.0
4518246546,0,14,1,0,3,8,4,0,0,0,0,14722,6.4,16433,218,48,-3784,-3051,21.8,1472.2,17,4,1,8,3,12,1,1,0,0,18506,7.2,19484,239,44,3784,3051,23.9,1850.6
4523877309,0,24,7,0,12,12,17,1,0,1,1,19272,6.8,16786,188,36,-967,-965,18.8,1927.2,18,3,1,12,12,23,0,0,0,1,20239,7.0,17751,222,56,967,965,22.2,2023.9
4495464440,1,15,2,0,3,8,4,0,0,0,0,14398,6.6,15990,194,42,-2919,-2318,19.4,1439.8,16,2,1,8,3,9,1,1,0,0,17317,7.0,18308,207,51,2919,2318,20.7,1731.7
4519875448,0,21,5,1,6,5,14,1,1,0,0,16986,7.0,17323,231,55,313,-1776,23.1,1698.6,16,8,0,5,6,3,1,0,1,0,16673,7.2,19099,236,56,-313,1776,23.6,1667.3
4518840459,0,15,2,1,4,6,4,1,1,0,0,14816,6.8,17070,204,46,-1631,-1140,20.4,1481.6,48,2,0,6,4,9,0,0,0,0,16447,6.8,18210,239,40,1631,1140,23.9,1644.7
4525181648,0,14,1,0,9,5,10,0,0,0,0,17605,7.2,19074,241,40,1132,778,24.1,1760.5,82,3,1,5,9,5,0,0,0,0,16473,7.0,18296,219,59,-1132,-778,21.9,1647.3
4501782812,0,16,4,0,5,3,5,0,0,0,0,15499,7.0,17516,225,47,-81,-1,22.5,1549.9,17,3,1,3,5,3,1,1,0,0,15580,6.8,17517,214,60,81,1,21.4,1558.0
4519742974,0,13,5,1,6,1,11,0,0,0,0,16933,7.2,18512,242,52,2836,448,24.2,1693.3,16,1,0,1,6,0,1,0,1,0,14097,6.8,18064,207,56,-2836,-448,20.7,1409.7
4522539833,0,70,11,0,6,5,5,1,0,1,0,16500,6.8,18497,202,47,496,1530,20.2,1650.0,47,1,1,5,6,6,1,1,0,0,16004,6.8,16967,222,40,-496,-1530,22.2,1600.4
4469595642,1,18,4,0,9,9,12,2,1,1,0,17732,7.2,19451,194,70,-532,298,19.4,1773.2,21,5,1,9,9,8,0,0,0,0,18264,7.2,19153,208,72,532,-298,20.8,1826.4
4439615787,0,15,0,1,4,7,3,0,0,0,0,15761,7.0,18196,253,32,-1454,-1205,25.3,1576.1,13,3,0,7,4,6,0,0,0,0,17215,7.2,19401,233,48,1454,1205,23.3,1721.5
4474680131,0,43,3,1,4,5,3,0,0,0,0,15710,6.8,17789,242,48,-682,-323,24.2,1571.0,16,1,0,5,4,4,1,1,0,0,16392,6.8,18112,227,56,682,323,22.7,1639.2
4518140055,1,15,2,1,11,4,7,1,1,0,1,20543,7.6,20964,233,57,6529,4484,23.3,2054.3,11,1,0,4,11,2,0,0,0,0,14014,6.8,16480,161,60,-6529,-4484,16.1,1401.4
4523350637,1,53,2,1,8,6,9,0,0,0,0,17154,7.0,18697,202,55,1933,2792,20.2,1715.4,17,3,0,6,8,6,0,0,0,0,15221,6.6,15905,174,44,-1933,-2792,17.4,1522.1
4501993937,1,59,3,1,12,5,19,1,1,0,0,19607,7.6,19804,221,44,3913,2948,22.1,1960.7,17,2,0,5,12,7,0,0,0,0,15694,6.6,16856,220,52,-3913,-2948,22.0,1569.4
4519026999,1,37,4,0,8,6,7,0,0,0,0,16894,7.0,17731,205,38,1797,1094,20.5,1689.4,49,3,1,6,8,5,1,1,0,0,15097,6.6,16637,190,42,-1797,-1094,19.0,1509.7
4526535381,0,12,2,0,4,7,3,1,0,1,0,15583,7.0,17671,210,56,-1108,-570,21.0,1558.3,19,4,1,7,4,13,1,1,0,0,16691,7.0,18241,215,56,1108,570,21.5,1669.1
4521349358,0,12,1,0,4,7,4,0,0,0,0,15139,7.0,18041,216,56,-2281,-42,21.6,1513.9,16,2,1,7,4,8,1,1,0,0,17420,7.0,18083,244,48,2281,42,24.4,1742.0
4506780804,1,21,2,1,16,5,18,2,1,1,0,19099,7.0,18143,183,40,3667,1610,18.3,1909.9,14,0,0,5,16,6,0,0,0,0,15432,6.4,16533,200,56,-3667,-1610,20.0,1543.2
4463542711,1,32,2,1,12,6,12,1,1,0,0,19058,7.2,19575,202,47,3413,2984,20.2,1905.8,16,2,0,6,12,7,0,0,0,0,15645,6.6,16591,210,39,-3413,-2984,21.0,1564.5
4521713895,0,13,1,0,4,9,5,0,0,0,0,14899,6.8,17420,232,32,-3099,-1695,23.2,1489.9,18,4,1,9,4,10,1,1,0,0,17998,7.2,19115,227,56,3099,1695,22.7,1799.8
4475880508,0,18,4,0,8,13,4,0,0,0,0,16735,7.0,17923,202,28,-2187,-2383,20.2,1673.5,49,5,1,13,8,15,1,1,0,0,18922,7.2,20306,208,46,2187,2383,20.8,1892.2
4523069328,1,17,3,1,5,3,9,1,1,0,0,16123,6.6,17197,204,50,593,-702,20.4,1612.3,12,3,0,3,5,2,0,0,0,0,15530,7.0,17899,238,60,-593,702,23.8,1553.0
4470291861,1,16,2,0,12,7,19,1,1,0,1,20721,7.0,18605,247,49,4453,1296,24.7,2072.1,15,3,1,7,12,13,0,0,0,0,16268,7.0,17309,206,48,-4453,-1296,20.6,1626.8
4450067073,0,46,1,0,4,10,3,0,0,0,0,15400,6.6,16607,188,45,-2552,-2052,18.8,1540.0,51,2,1,10,4,13,1,1,0,0,17952,6.8,18659,212,50,2552,2052,21.2,1795.2
4526194900,0,17,2,0,4,3,5,0,0,0,0,15793,6.8,17950,246,40,848,463,24.6,1579.3,49,2,1,3,4,3,1,1,0,0,14945,7.0,17487,210,52,-848,-463,21.0,1494.5
4437508160,0,12,2,0,2,6,3,0,0,0,0,14287,6.6,17457,225,43,-3045,-1380,22.5,1428.7,14,3,1,6,2,7,2,1,1,0,17332,7.2,18837,261,40,3045,1380,26.1,1733.2
4501108199,1,15,1,1,10,5,10,0,0,0,0,17878,7.0,18248,214,52,2301,603,21.4,1787.8,37,1,0,5,10,5,0,0,0,0,15577,6.8,17645,203,44,-2301,-603,20.3,1557.7
4461601408,0,57,2,1,7,6,7,0,0,0,0,16100,7.0,18918,223,45,-577,-679,22.3,1610.0,8,1,0,6,7,3,2,1,1,0,16677,7.0,19597,237,72,577,679,23.7,1667.7
4462815416,0,10,2,1,6,7,5,0,0,0,0,16806,6.8,17635,205,56,-210,-130,20.5,1680.6,14,1,0,7,6,7,1,0,1,0,17016,6.6,17765,230,45,210,130,23.0,1701.6
4524899991,1,17,2,1,12,6,11,1,1,0,0,19189,7.4,20302,227,49,3815,2726,22.7,1918.9,16,1,0,6,12,5,0,0,0,0,15374,6.6,17576,203,50,-3815,-2726,20.3,1537.4
4522358340,0,21,3,1,11,10,6,0,0,0,0,17183,7.0,18197,208,44,157,1673,20.8,1718.3,17,4,0,10,11,14,1,1,0,0,17026,6.8,16524,188,41,-157,-1673,18.8,1702.6
4478459964,1,21,3,1,5,3,11,1,0,1,0,16003,7.0,17277,216,56,145,-862,21.6,1600.3,16,5,0,3,5,4,0,0,0,0,15858,7.0,18139,246,59,-145,862,24.6,1585.8
4507927084,0,18,5,0,8,8,8,1,1,0,0,17305,7.0,18192,229,43,-576,-682,22.9,1730.5,18,3,1,8,8,6,1,0,1,0,17881,7.0,18874,198,66,576,682,19.8,1788.1
4517200256,0,18,5,0,7,8,6,0,0,0,0,16423,7.2,18901,212,60,-859,919,21.2,1642.3,17,3,1,8,7,6,0,0,0,0,17282,7.0,17982,226,43,859,-919,22.6,1728.2
4527399718,0,15,0,0,1,6,1,0,0,0,0,14417,7.0,17488,237,61,-2984,-1466,23.7,1441.7,13,1,1,6,1,10,1,1,0,0,17401,7.0,18954,248,54,2984,1466,24.8,1740.1
4467443224,1,18,3,0,6,12,6,0,0,0,0,16260,6.8,16989,211,42,-1791,-1671,21.1,1626.0,13,1,1,12,6,13,0,0,0,0,18051,7.0,18660,192,49,1791,1671,19.2,1805.1
4524620771,0,15,0,0,1,10,1,2,1,1,0,13815,6.8,16570,219,51,-4898,-3736,21.9,1381.5,20,2,1,10,1,13,0,0,0,0,18713,7.4,20306,261,40,4898,3736,26.1,1871.3
4527144840,0,12,3,0,3,11,3,0,0,0,0,14830,6.6,17313,221,48,-4299,-3010,22.1,1483.0,34,3,1,11,3,17,0,0,0,0,19129,7.4,20323,228,64,4299,3010,22.8,1912.9
4460577454,1,20,4,0,4,4,5,2,1,1,0,16486,7.2,18617,256,60,1118,871,25.6,1648.6,21,3,1,4,4,6,0,0,0,0,15368,6.8,17746,224,43,-1118,-871,22.4,1536.8
4477419321,0,16,3,1,7,6,6,0,0,0,0,16254,6.8,17374,200,47,-908,-1806,20.0,1625.4,21,3,0,6,7,8,0,0,0,0,17162,7.2,19180,227,52,908,1806,22.7,1716.2
4518191905,1,14,3,0,10,4,9,0,0,0,0,18129,7.4,20257,250,56,2915,3259,25.0,1812.9,14,1,1,4,10,4,1,1,0,0,15214,6.8,16998,193,48,-2915,-3259,19.3,1521.4
4520825684,1,19,3,0,4,5,7,0,0,0,0,15745,6.8,17654,236,40,-1300,-652,23.6,1574.5,18,3,1,5,4,10,1,1,0,0,17045,7.2,18306,252,55,1300,652,25.2,1704.5
4521761275,1,17,1,0,4,12,3,0,0,0,0,15716,6.8,16980,225,39,-3446,-3817,22.5,1571.6,15,0,1,12,4,10,2,1,1,0,19162,7.8,20797,239,59,3446,3817,23.9,1916.2
4522338858,1,52,3,0,4,7,5,1,1,0,0,15766,7.0,18750,232,60,-1035,582,23.2,1576.6,18,4,1,7,4,7,0,0,0,0,16801,7.0,18168,202,55,1035,-582,20.2,1680.1
4470078931,1,16,0,1,11,4,11,1,0,1,0,17583,7.2,18536,223,47,2858,2734,22.3,1758.3,12,1,0,4,11,2,0,0,0,0,14725,6.4,15802,190,44,-2858,-2734,19.0,1472.5
4488652229,1,19,2,1,9,1,9,1,1,0,0,18381,7.0,19201,249,56,3951,2490,24.9,1838.1,17,4,0,1,9,0,0,0,0,0,14430,6.6,16711,214,60,-3951,-2490,21.4,1443.0
4498562536,1,17,4,1,7,9,3,0,0,0,0,15609,6.8,16832,182,38,-2569,-2934,18.2,1560.9,15,1,0,9,7,9,0,0,0,0,18178,7.6,19766,212,70,2569,2934,21.2,1817.8
4525956484,0,12,2,1,5,5,8,0,0,0,0,15930,6.4,15779,210,56,-95,-1474,21.0,1593.0,18,1,0,5,5,9,1,1,0,0,16025,6.8,17253,195,52,95,1474,19.5,1602.5
4472174741,0,13,5,0,4,9,4,0,0,0,0,15102,6.8,17421,214,56,-2173,-2274,21.4,1510.2,16,7,1,9,4,9,1,1,0,0,17275,7.4,19695,212,59,2173,2274,21.2,1727.5
4519482984,0,15,6,0,3,8,2,1,1,0,0,14122,6.6,15708,188,40,-2968,-2159,18.8,1412.2,19,4,1,8,3,7,0,0,0,0,17090,7.0,17867,182,47,2968,2159,18.2,1709.0
4498673478,1,14,1,1,7,6,9,2,1,1,0,16574,6.8,17377,197,42,969,-42,19.7,1657.4,13,2,0,6,7,8,0,0,0,0,15605,6.6,17419,194,37,-969,42,19.4,1560.5
4513953505,1,26,5,0,2,2,2,1,1,0,0,14541,6.8,18354,240,48,-1345,-621,24.0,1454.1,15,2,1,2,2,2,0,0,0,0,15886,7.2,18975,260,61,1345,621,26.0,1588.6
4487058187,1,16,4,1,9,1,9,1,1,0,0,17239,7.2,19459,232,46,3497,3543,23.2,1723.9,16,1,0,1,9,2,0,0,0,0,13742,6.4,15916,223,53,-3497,-3543,22.3,1374.2
4492173417,0,16,2,1,4,6,7,1,1,0,0,15702,7.0,17467,230,64,-816,-1189,23.0,1570.2,64,1,0,6,4,7,0,0,0,0,16518,7.2,18656,224,52,816,1189,22.4,1651.8
4522641245,1,91,2,1,4,6,5,0,0,0,0,15986,6.8,17620,212,52,-46,-1226,21.2,1598.6,15,2,0,6,4,4,1,1,0,0,16032,7.2,18846,229,52,46,1226,22.9,1603.2
4525076026,0,16,2,1,5,7,2,0,0,0,0,16363,7.0,18270,225,63,244,-408,22.5,1636.3,15,1,0,7,5,7,2,1,1,0,16119,7.0,18678,197,60,-244,408,19.7,1611.9
4526803305,0,54,2,0,3,4,6,0,0,0,0,14725,6.8,17291,204,43,-1680,-1155,20.4,1472.5,21,3,1,4,3,3,2,1,1,0,16405,7.4,18446,258,56,1680,1155,25.8,1640.5
4521191385,1,13,4,1,8,2,10,0,0,0,0,17754,7.0,18653,239,39,3880,2784,23.9,1775.4,18,2,0,2,8,1,0,0,0,0,13874,6.4,15869,204,40,-3880,-2784,20.4,1387.4
4508447638,0,24,6,1,3,9,4,0,0,0,0,15700,7.0,17393,250,48,-2185,-2444,25.0,1570.0,21,6,0,9,3,9,0,0,0,0,17885,7.6,19837,216,60,2185,2444,21.6,1788.5
4520778338,1,14,3,1,5,3,7,1,0,1,1,17340,7.2,18431,215,51,2486,2148,21.5,1734.0,104,0,0,3,5,3,0,0,0,0,14854,6.6,16283,223,40,-2486,-2148,22.3,1485.4
4526047622,1,14,0,1,7,2,8,0,0,0,0,17474,7.4,19214,238,52,3295,2840,23.8,1747.4,14,3,0,2,7,3,0,0,0,0,14179,6.6,16374,229,36,-3295,-2840,22.9,1417.9
4520017267,0,10,2,1,8,12,8,0,0,0,0,17237,7.0,18392,213,41,-1133,-714,21.3,1723.7,57,0,0,12,8,12,1,1,0,0,18370,7.4,19106,196,46,1133,714,19.6,1837.0
4459506875,1,18,6,1,4,2,6,2,1,1,0,15837,7.0,18178,226,68,425,422,22.6,1583.7,17,7,0,2,4,1,0,0,0,0,15412,7.0,17756,255,38,-425,-422,25.5,1541.2
4502922066,0,12,0,0,3,5,3,1,0,1,0,15861,7.0,19121,270,52,-406,-14,27.0,1586.1,14,1,1,5,3,7,1,1,0,0,16267,7.0,19135,235,56,406,14,23.5,1626.7
4500668824,0,50,12,1,6,3,9,1,1,0,0,15958,6.6,17693,213,48,66,-446,21.3,1595.8,37,3,0,3,6,3,0,0,0,0,15892,6.8,18139,254,60,-66,446,25.4,1589.2
4439857049,1,15,0,1,2,4,4,1,1,0,0,13946,6.6,16402,211,44,-1896,-2216,21.1,1394.6,14,3,0,4,2,5,0,0,0,0,15842,7.0,18618,232,55,1896,2216,23.2,1584.2
4527439661,1,20,0,1,13,8,20,1,1,0,0,17564,6.6,15596,167,28,2032,1193,16.7,1756.4,18,2,0,8,13,10,0,0,0,0,15532,6.0,14403,170,34,-2032,-1193,17.0,1553.2
4522637791,1,13,5,0,7,9,6,1,0,1,0,17005,6.8,18098,216,56,274,1018,21.6,1700.5,20,2,1,9,7,10,1,1,0,0,16731,6.6,17080,200,44,-274,-1018,20.0,1673.1
4522160607,0,19,3,1,12,8,8,0,0,0,0,19525,7.6,20374,242,50,3224,2800,24.2,1952.5,60,7,0,8,12,10,0,0,0,0,16301,7.0,17574,181,32,-3224,-2800,18.1,1630.1
4526476556,1,15,3,1,7,6,6,0,0,0,0,16946,7.4,19649,221,76,714,1650,22.1,1694.6,12,5,0,6,7,7,0,0,0,0,16232,6.8,17999,215,58,-714,-1650,21.5,1623.2
4525318009,0,14,0,0,4,3,5,0,0,0,0,15568,6.8,17520,246,36,40,-731,24.6,1556.8,35,2,1,3,4,6,0,0,0,0,15528,6.8,18251,211,56,-40,731,21.1,1552.8
4527865649,0,17,2,0,7,8,9,1,0,1,0,17394,6.8,17904,261,32,188,-676,26.1,1739.4,29,4,1,8,7,7,0,0,0,0,17206,7.0,18580,212,56,-188,676,21.2,1720.6
4464656056,1,19,2,1,13,7,12,1,0,1,1,21783,7.6,20533,244,43,5638,3250,24.4,2178.3,38,2,0,7,13,7,0,0,0,0,16145,6.8,17283,167,47,-5638,-3250,16.7,1614.5
4465614811,1,17,2,1,6,3,5,1,1,0,0,16350,7.2,18813,233,44,1387,702,23.3,1635.0,14,1,0,3,6,3,0,0,0,0,14963,6.8,18111,217,56,-1387,-702,21.7,1496.3
4515286916,0,40,3,1,5,7,7,0,0,0,0,15799,6.4,16589,224,32,-1069,-1901,22.4,1579.9,20,4,0,7,5,5,0,0,0,0,16868,7.0,18490,215,53,1069,1901,21.5,1686.8
4503361762,1,16,3,1,9,3,6,1,1,0,0,17485,7.0,18330,234,58,3075,1798,23.4,1748.5,17,2,0,3,9,2,0,0,0,0,14410,6.6,16532,214,27,-3075,-1798,21.4,1441.0
4509900585,1,20,5,1,8,3,12,1,1,0,0,17562,7.0,17702,237,43,3575,1394,23.7,1756.2,42,2,0,3,8,1,1,0,1,0,13987,6.6,16308,176,45,-3575,-1394,17.6,1398.7
4472995795,1,11,2,1,5,3,7,0,0,0,0,17264,7.0,18301,248,44,3037,2561,24.8,1726.4,26,0,0,3,5,2,0,0,0,0,14227,6.4,15740,174,60,-3037,-2561,17.4,1422.7
4496807204,1,70,0,1,11,5,14,1,0,1,1,19557,6.8,18126,193,44,4238,1418,19.3,1955.7,82,3,0,5,11,4,1,1,0,0,15319,6.8,16708,206,36,-4238,-1418,20.6,1531.9
4515607398,1,19,2,0,8,3,7,1,1,0,0,18003,7.4,20207,248,77,3034,1983,24.8,1800.3,15,4,1,3,8,2,0,0,0,0,14969,7.0,18224,211,52,-3034,-1983,21.1,1496.9
4525330228,1,19,4,0,8,6,8,0,0,0,0,18093,7.0,18394,231,48,1882,1490,23.1,1809.3,15,3,1,6,8,8,0,0,0,0,16211,6.8,16904,203,44,-1882,-1490,20.3,1621.1
4464898838,1,16,1,0,5,3,7,1,1,0,0,16860,7.0,18682,264,45,1245,686,26.4,1686.0,15,2,1,3,5,2,0,0,0,0,15615,7.0,17996,248,63,-1245,-686,24.8,1561.5
4479706373,1,17,2,0,3,7,0,0,0,0,0,13958,6.6,17193,176,62,-4738,-2857,17.6,1395.8,13,6,1,7,3,4,2,1,1,0,18696,7.4,20050,264,66,4738,2857,26.4,1869.6
4509106172,0,15,3,0,5,10,5,0,0,0,0,15251,6.4,16852,210,31,-3232,-2573,21.0,1525.1,18,2,1,10,5,13,2,1,1,0,18483,7.4,19425,215,80,3232,2573,21.5,1848.3
4512833184,0,47,1,0,3,3,4,1,1,0,0,16206,7.0,18093,260,54,-795,-1185,26.0,1620.6,35,24,1,3,3,4,1,0,1,0,17001,7.2,19278,242,80,795,1185,24.2,1700.1
4472901696,0,18,3,0,8,8,12,1,1,0,0,17388,6.6,16792,214,40,1327,-741,21.4,1738.8,17,4,1,8,8,6,0,0,0,0,16061,6.6,17533,190,47,-1327,741,19.0,1606.1
4506975246,0,50,2,0,5,8,2,0,0,0,0,16304,7.0,18344,222,84,-890,-1261,22.2,1630.4,15,2,1,8,5,5,2,1,1,0,17194,7.4,19605,218,52,890,1261,21.8,1719.4
4439902649,0,30,13,1,4,2,7,0,0,0,0,15331,6.8,17540,182,61,676,-576,18.2,1533.1,64,4,0,2,4,1,1,1,0,0,14655,7.2,18116,216,54,-676,576,21.6,1465.5
4525072812,0,14,2,0,7,7,10,1,1,0,0,16972,7.2,19060,209,48,-1031,-394,20.9,1697.2,16,4,1,7,7,7,0,0,0,0,18003,7.4,19454,255,60,1031,394,25.5,1800.3
4522409502,1,21,2,0,10,7,15,1,1,0,0,19601,7.4,20002,227,76,3190,2346,22.7,1960.1,14,3,1,7,10,8,1,0,1,0,16411,6.8,17656,214,44,-3190,-2346,21.4,1641.1
4427497326,1,19,2,1,8,6,11,0,0,0,0,17483,7.2,18392,215,36,1232,-128,21.5,1748.3,16,6,0,6,8,7,0,0,0,0,16251,7.2,18520,233,48,-1232,128,23.3,1625.1
4470395952,0,15,5,1,5,4,8,0,0,0,0,16163,7.0,18437,242,41,1074,542,24.2,1616.3,40,5,0,4,5,8,1,0,1,0,15089,7.0,17895,224,39,-1074,-542,22.4,1508.9
4521563183,0,15,2,0,5,6,3,0,0,0,0,16495,7.0,18518,230,46,955,748,23.0,1649.5,36,3,1,6,5,6,0,0,0,0,15540,6.8,17770,164,58,-955,-748,16.4,1554.0
4442575242,0,14,2,0,2,11,4,0,0,0,0,13608,6.6,15291,178,45,-5040,-6118,17.8,1360.8,47,4,1,11,2,9,0,0,0,0,18648,7.6,21409,202,80,5040,6118,20.2,1864.8
4514010744,1,13,4,1,4,2,3,1,1,0,0,16162,6.8,17887,257,52,1766,719,25.7,1616.2,15,3,0,2,4,3,0,0,0,0,14396,6.6,17168,215,48,-1766,-719,21.5,1439.6
4500133992,0,17,19,0,3,11,2,0,0,0,0,15451,6.8,17544,243,57,-3380,-2659,24.3,1545.1,44,5,1,11,3,11,0,0,0,0,18831,7.4,20203,234,63,3380,2659,23.4,1883.1
4518551407,0,15,18,0,4,4,6,0,0,0,0,14839,6.6,17555,215,41,-1089,-782,21.5,1483.9,41,0,1,4,4,1,0,0,0,0,15928,7.0,18337,225,63,1089,782,22.5,1592.8
4513698132,1,14,1,1,8,4,8,1,1,0,0,17613,6.8,18689,225,45,2470,1917,22.5,1761.3,17,4,0,4,8,3,0,0,0,0,15143,6.4,16772,199,36,-2470,-1917,19.9,1514.3
4523609898,0,122,1,1,3,3,3,1,1,0,0,15474,6.8,17407,203,64,-347,-1134,20.3,1547.4,11,0,0,3,3,5,0,0,0,0,15821,7.2,18541,224,63,347,1134,22.4,1582.1
4515215762,1,17,3,0,8,3,8,2,1,1,0,17500,6.8,18340,229,55,3308,2114,22.9,1750.0,9,0,1,3,8,3,0,0,0,0,14192,6.6,16226,215,28,-3308,-2114,21.5,1419.2
4460033852,0,12,2,1,5,5,5,0,0,0,0,15646,6.6,16889,186,50,-201,-1702,18.6,1564.6,19,0,0,5,5,2,2,1,1,0,15847,7.2,18591,247,58,201,1702,24.7,1584.7
4472450080,1,15,4,1,6,3,7,0,0,0,0,17057,6.8,17917,243,50,2019,138,24.3,1705.7,15,1,0,3,6,6,0,0,0,0,15038,6.8,17779,209,61,-2019,-138,20.9,1503.8
4513995465,0,15,3,0,2,9,0,1,1,0,0,14814,7.0,17587,222,64,-3402,-1459,22.2,1481.4,23,2,1,9,2,11,0,0,0,0,18216,7.4,19046,229,59,3402,1459,22.9,1821.6
4464700538,1,14,3,0,1,4,1,0,0,0,0,13756,6.6,16900,238,36,-3750,-3108,23.8,1375.6,40,3,1,4,1,3,2,1,1,1,17506,7.2,20008,244,64,3750,3108,24.4,1750.6
4500568578,0,15,4,0,1,4,2,1,1,0,0,13925,7.0,18363,216,60,-3617,-1967,21.6,1392.5,78,1,1,4,1,5,0,0,0,0,17542,7.4,20330,260,80,3617,1967,26.0,1754.2
4513287361,1,17,1,1,4,3,5,0,0,0,0,15720,7.0,18012,224,50,1146,1440,22.4,1572.0,15,2,0,3,4,3,1,1,0,0,14574,6.8,16572,211,53,-1146,-1440,21.1,1457.4
4527484965,0,17,3,0,4,11,5,0,0,0,0,14702,6.6,16103,193,33,-3191,-1620,19.3,1470.2,27,4,1,11,4,17,1,1,0,0,17893,7.0,17723,219,48,3191,1620,21.9,1789.3
4520795867,0,14,1,0,7,3,9,2,1,1,0,17144,7.0,18638,230,56,1713,1673,23.0,1714.4,15,1,1,3,7,1,0,0,0,0,15431,6.6,16965,216,56,-1713,-1673,21.6,1543.1
4507431568,1,14,2,1,5,6,7,0,0,0,0,16503,7.0,18377,240,59,171,42,24.0,1650.3,48,1,0,6,5,10,1,1,0,0,16332,7.0,18335,232,54,-171,-42,23.2,1633.2
4501840328,0,15,0,1,2,3,2,0,0,0,0,14736,6.4,16670,235,50,-635,-1175,23.5,1473.6,17,1,0,3,2,4,0,0,0,0,15371,7.2,17845,235,47,635,1175,23.5,1537.1
4513522671,0,16,2,0,6,4,4,1,1,0,0,16505,6.8,18233,245,50,1110,-225,24.5,1650.5,16,2,1,4,6,3,0,0,0,0,15395,7.4,18458,212,58,-1110,225,21.2,1539.5
4516589560,0,14,1,1,6,8,6,0,0,0,0,16936,7.2,18023,219,64,-424,-630,21.9,1693.6,14,2,0,8,6,10,2,1,1,0,17360,7.0,18653,230,48,424,630,23.0,1736.0
4520513993,1,13,5,1,10,3,9,1,1,0,0,19013,7.4,20151,225,60,4817,3220,22.5,1901.3,14,4,0,3,10,3,1,0,1,0,14196,6.8,16931,184,48,-4817,-3220,18.4,1419.6
4522201400,1,20,1,1,13,5,14,1,0,1,1,20861,7.0,18819,213,45,5245,2754,21.3,2086.1,14,0,0,5,13,7,0,0,0,0,15616,6.4,16065,195,40,-5245,-2754,19.5,1561.6
4478560803,0,116,2,0,9,12,9,1,1,0,0,16218,6.0,15119,154,40,-3070,-3027,15.4,1621.8,16,4,1,12,9,12,1,0,1,0,19288,7.0,18146,194,42,3070,3027,19.4,1928.8
4521408413,1,15,1,1,10,8,14,2,1,1,0,18360,7.2,19276,222,44,793,475,22.2,1836.0,14,0,0,8,10,7,0,0,0,0,17567,7.4,18801,215,56,-793,-475,21.5,1756.7
4520723011,1,35,2,1,5,0,4,1,1,0,0,17434,7.2,18954,257,54,4612,3848,25.7,1743.4,11,1,0,0,5,0,0,0,0,0,12822,6.4,15106,203,44,-4612,-3848,20.3,1282.2
4526207203,1,24,4,1,8,5,6,0,0,0,0,17581,7.0,18639,243,45,1839,312,24.3,1758.1,122,1,0,5,8,2,1,1,0,0,15742,7.2,18327,221,45,-1839,-312,22.1,1574.2
4519645967,1,15,0,1,7,6,9,0,0,0,0,17537,7.0,18384,232,44,1752,830,23.2,1753.7,27,3,0,6,7,4,1,1,0,0,15785,6.8,17554,201,56,-1752,-830,20.1,1578.5
4513438195,1,15,1,1,9,4,11,1,1,0,0,18585,7.2,18660,216,51,3161,2079,21.6,1858.5,13,2,0,4,9,4,0,0,0,0,15424,6.8,16581,185,68,-3161,-2079,18.5,1542.4
4522656427,0,38,3,0,9,10,6,0,0,0,0,17346,7.4,19356,197,59,-220,1427,19.7,1734.6,14,0,1,10,9,9,0,0,0,0,17566,7.2,17929,186,63,220,-1427,18.6,1756.6
4523339040,1,18,5,1,9,2,8,2,1,1,0,18318,7.2,19194,228,46,4446,3448,22.8,1831.8,20,1,0,2,9,4,0,0,0,0,13872,6.4,15746,188,41,-4446,-3448,18.8,1387.2
4515997665,1,12,5,1,5,6,7,0,0,0,0,16688,7.0,18697,247,49,1008,-248,24.7,1668.8,44,3,0,6,5,5,1,1,0,0,15680,7.4,18945,199,51,-1008,248,19.9,1568.0
4520749944,1,13,2,0,10,4,6,1,1,0,0,16668,7.0,18055,192,43,1794,2647,19.2,1666.8,22,3,1,4,10,3,0,0,0,0,14874,6.4,15408,203,40,-1794,-2647,20.3,1487.4
4524391418,1,11,2,1,7,3,6,0,0,0,0,18351,7.4,19217,222,72,3827,3161,22.2,1835.1,15,1,0,3,7,3,1,1,0,0,14524,6.4,16056,201,53,-3827,-3161,20.1,1452.4
4518971056,0,29,2,1,5,2,5,0,0,0,0,16142,7.2,18818,245,49,534,634,24.5,1614.2,15,4,0,2,5,2,2,1,1,0,15608,6.8,18184,277,58,-534,-634,27.7,1560.8
4459200574,0,21,6,1,6,3,11,1,1,0,0,16409,6.6,16448,228,52,1642,-1085,22.8,1640.9,17,3,0,3,6,3,1,0,1,0,14767,6.8,17533,204,60,-1642,1085,20.4,1476.7
4484240174,1,36,2,1,8,2,10,2,1,1,0,17878,6.8,18056,216,52,4347,2472,21.6,1787.8,56,1,0,2,8,2,0,0,0,0,13531,6.2,15584,179,48,-4347,-2472,17.9,1353.1
4525227627,1,22,4,0,4,5,2,1,1,0,0,16302,7.2,18728,256,56,315,667,25.6,1630.2,15,1,1,5,4,3,1,0,1,0,15987,6.8,18061,224,52,-315,-667,22.4,1598.7
4475129478,0,19,2,0,4,6,6,0,0,0,0,15502,6.8,16609,227,42,-938,-729,22.7,1550.2,17,2,1,6,4,5,1,1,0,0,16440,6.8,17338,239,47,938,729,23.9,1644.0
4495755195,1,11,0,0,11,8,11,1,0,1,0,18817,7.0,17845,192,54,311,559,19.2,1881.7,16,1,1,8,11,6,0,0,0,1,18506,6.8,17286,228,36,-311,-559,22.8,1850.6
4521065168,0,13,3,1,8,8,4,0,0,0,0,16688,6.8,17926,216,44,704,-123,21.6,1668.8,16,0,0,8,8,4,1,1,0,0,15984,7.2,18049,190,56,-704,123,19.0,1598.4
4521182941,1,17,2,0,17,9,19,0,0,0,0,20619,7.4,18696,205,43,2828,1962,20.5,2061.9,17,2,1,9,17,7,1,1,0,0,17791,6.8,16734,198,38,-2828,-1962,19.8,1779.1
4513405592,1,16,3,0,6,3,9,1,1,0,0,15927,6.8,17735,198,49,1824,638,19.8,1592.7,16,2,1,3,6,1,0,0,0,0,14103,7.0,17097,202,46,-1824,-638,20.2,1410.3
4459482248,1,18,3,1,10,5,10,0,0,0,0,18538,7.4,19307,225,47,2832,2861,22.5,1853.8,18,0,0,5,10,7,0,0,0,0,15706,6.6,16446,214,52,-2832,-2861,21.4,1570.6
4489579352,0,13,5,1,5,3,5,0,0,0,0,15829,6.8,17771,237,45,968,715,23.7,1582.9,18,2,0,3,5,2,1,1,0,0,14861,6.8,17056,224,44,-968,-715,22.4,1486.1
4492283866,0,18,3,1,6,7,3,2,1,1,0,16778,6.8,18459,236,55,-74,-482,23.6,1677.8,34,3,0,7,6,10,0,0,0,0,16852,7.0,18941,212,60,74,482,21.2,1685.2
4525132026,0,36,1,0,3,8,5,1,1,0,0,15028,6.8,17228,232,40,-2254,-379,23.2,1502.8,18,3,1,8,3,8,0,0,0,0,17282,7.0,17607,232,48,2254,379,23.2,1728.2
4457008348,0,18,4,0,3,10,3,0,0,0,0,15130,6.6,16749,220,42,-2528,-1326,22.0,1513.0,52,7,1,10,3,13,0,0,0,0,17658,7.0,18075,218,41,2528,1326,21.8,1765.8
4474818952,1,14,1,0,9,3,12,2,1,1,0,18108,7.0,18738,218,45,2967,947,21.8,1810.8,12,4,1,3,9,1,0,0,0,0,15141,6.8,17791,228,76,-2967,-947,22.8,1514.1
4510185025,0,14,5,1,3,4,4,1,0,1,0,14759,6.6,17168,229,44,-929,-1819,22.9,1475.9,16,3,0,4,3,4,1,1,0,0,15688,7.0,18987,223,66,929,1819,22.3,1568.8
4519863035,1,17,2,0,4,5,6,0,0,0,0,15256,6.8,16513,210,41,-957,-2267,21.0,1525.6,21,3,1,5,4,5,1,1,0,0,16213,7.2,18780,235,64,957,2267,23.5,1621.3
4522846524,0,16,2,0,1,4,1,0,0,0,0,14588,7.0,18059,234,57,-1159,-73,23.4,1458.8,25,2,1,4,1,4,2,1,1,0,15747,7.2,18132,243,53,1159,73,24.3,1574.7
4496688229,1,12,5,1,5,3,5,1,1,0,0,16706,7.0,17948,231,48,1352,-81,23.1,1670.6,21,0,0,3,5,2,0,0,0,0,15354,7.0,18029,230,55,-1352,81,23.0,1535.4
4511365418,0,17,3,1,8,7,10,2,1,1,0,17429,7.0,17332,209,51,900,-802,20.9,1742.9,21,4,0,7,8,6,0,0,0,0,16529,7.0,18134,217,36,-900,802,21.7,1652.9
4514266490,0,15,1,1,6,6,8,1,0,1,0,16988,6.8,18153,223,45,37,-905,22.3,1698.8,20,2,0,6,6,5,1,1,0,0,16951,7.4,19058,216,59,-37,905,21.6,1695.1
4526260032,0,14,3,0,6,12,3,1,0,1,0,15488,6.8,17274,196,60,-4858,-1631,19.6,1548.8,19,5,1,12,6,15,1,1,0,1,20346,6.8,18905,214,70,4858,1631,21.4,2034.6
4464939561,1,20,0,0,3,6,1,0,0,0,0,13952,6.6,17089,197,44,-2729,-1427,19.7,1395.2,15,2,1,6,3,4,1,1,0,0,16681,7.0,18516,252,56,2729,1427,25.2,1668.1
4445986200,0,12,1,0,9,6,14,0,0,0,0,17385,7.0,18061,208,36,978,372,20.8,1738.5,18,3,1,6,9,7,1,0,1,0,16407,7.0,17689,226,54,-978,-372,22.6,1640.7
4499790153,1,13,5,1,5,7,7,0,0,0,0,15861,6.8,17523,182,60,-1340,-228,18.2,1586.1,15,3,0,7,5,7,2,1,1,0,17201,6.8,17751,204,56,1340,228,20.4,1720.1
4465904473,1,30,2,1,8,5,9,1,1,0,0,16729,6.8,17848,220,43,1204,349,22.0,1672.9,16,5,0,5,8,5,0,0,0,0,15525,7.0,17499,214,48,-1204,-349,21.4,1552.5
4507086578,1,41,1,1,6,9,8,1,0,1,0,15879,6.8,17163,187,48,-905,-709,18.7,1587.9,34,1,0,9,6,10,1,1,0,0,16784,7.0,17872,183,53,905,709,18.3,1678.4
4465798223,0,18,1,0,5,8,6,0,0,0,0,15958,6.6,16741,233,44,-84,-22,23.3,1595.8,37,4,1,8,5,9,0,0,0,0,16042,6.6,16763,190,36,84,22,19.0,1604.2
4490245782,1,16,0,0,7,5,6,0,0,0,0,17432,7.4,19324,224,56,993,593,22.4,1743.2,57,2,1,5,7,11,0,0,0,0,16439,7.4,18731,209,52,-993,-593,20.9,1643.9
4521490915,0,16,3,0,3,4,6,0,0,0,0,15608,7.2,18584,234,60,-233,20,23.4,1560.8,15,1,1,4,3,4,2,1,1,0,15841,7.2,18564,240,57,233,-20,24.0,1584.1
4524744736,0,16,4,0,2,3,3,0,0,0,0,14414,6.8,17356,226,60,-1731,-1585,22.6,1441.4,16,0,1,3,2,3,0,0,0,0,16145,7.0,18941,268,56,1731,1585,26.8,1614.5
4448316334,1,39,3,0,13,8,22,0,0,0,0,18721,7.4,18774,164,44,1721,1678,16.4,1872.1,13,2,1,8,13,9,2,1,1,0,17000,6.8,17096,195,43,-1721,-1678,19.5,1700.0
4501445520,1,13,3,0,8,3,7,1,1,0,0,17318,7.4,19714,244,54,2789,3223,24.4,1731.8,15,1,1,3,8,2,0,0,0,0,14529,6.4,16491,203,60,-2789,-3223,20.3,1452.9
4522586300,0,18,8,0,0,7,0,0,0,0,0,13358,6.2,15566,199,59,-4737,-3600,19.9,1335.8,17,6,1,7,0,7,1,1,0,0,18095,7.2,19166,253,58,4737,3600,25.3,1809.5
4526171046,1,15,3,0,8,3,9,0,0,0,0,18334,7.0,19209,232,40,3770,1556,23.2,1833.4,37,1,1,3,8,2,1,1,0,0,14564,6.8,17653,195,59,-3770,-1556,19.5,1456.4
4465308301,0,14,0,0,1,12,0,0,0,0,0,10730,4.8,10826,140,0,-10830,-9333,14.0,1073.0,18,7,1,12,1,14,0,0,0,2,21560,7.4,20159,241,72,10830,9333,24.1,2156.0
4508242433,1,84,3,1,7,2,9,1,1,0,0,16683,7.2,19168,223,60,1828,2134,22.3,1668.3,17,1,0,2,7,4,0,0,0,0,14855,6.8,17034,224,44,-1828,-2134,22.4,1485.5
4511683858,0,16,6,0,5,7,4,0,0,0,0,15437,7.0,17811,195,68,-2205,-1308,19.5,1543.7,17,4,1,7,5,6,1,1,0,0,17642,7.2,19119,270,40,2205,1308,27.0,1764.2
4454378934,0,19,3,1,9,8,12,0,0,0,0,17083,6.6,17538,183,33,67,-820,18.3,1708.3,16,2,0,8,9,5,1,1,0,0,17016,7.0,18358,225,44,-67,820,22.5,1701.6
4516718833,0,14,3,1,5,5,5,1,1,0,0,16267,7.0,17908,247,60,206,-364,24.7,1626.7,18,0,0,5,5,5,0,0,0,0,16061,6.8,18272,228,54,-206,364,22.8,1606.1
4515883864,1,15,4,1,8,4,9,1,1,0,0,16955,6.8,17434,191,56,1306,1039,19.1,1695.5,16,0,0,4,8,2,0,0,0,0,15649,6.6,16395,200,48,-1306,-1039,20.0,1564.9
4524917684,1,16,2,0,8,9,6,0,0,0,1,18363,7.2,18592,224,52,321,368,22.4,1836.3,17,3,1,9,8,12,0,0,0,0,18042,7.0,18224,215,44,-321,-368,21.5,1804.2
4527885240,1,34,1,0,4,7,1,0,0,0,0,15261,7.0,18671,223,60,-1461,-69,22.3,1526.1,15,0,1,7,4,8,1,1,0,0,16722,7.0,18740,215,56,1461,69,21.5,1672.2
4516499874,0,13,1,0,10,12,13,1,1,0,0,17842,6.8,18236,194,52,-1949,-1074,19.4,1784.2,15,3,1,12,10,12,0,0,0,0,19791,7.2,19310,228,46,1949,1074,22.8,1979.1
4519645138,1,19,1,0,5,6,4,1,1,0,0,17028,7.0,18519,235,60,1761,2297,23.5,1702.8,15,5,1,6,5,9,1,0,1,0,15267,6.6,16222,177,36,-1761,-2297,17.7,1526.7
4515894243,0,11,3,1,4,3,3,1,1,0,0,15762,7.2,19056,240,56,229,398,24.0,1576.2,13,0,0,3,4,4,0,0,0,0,15533,7.2,18658,239,60,-229,-398,23.9,1553.3
4502653498,1,16,4,0,6,6,12,1,1,0,0,16618,6.8,17463,192,54,1354,1326,19.2,1661.8,16,3,1,6,6,12,0,0,0,0,15264,6.6,16137,203,31,-1354,-1326,20.3,1526.4
4506557116,0,20,1,0,6,12,8,0,0,0,0,15511,6.4,15296,171,50,-4775,-4080,17.1,1551.1,13,4,1,12,6,12,1,1,0,0,20286,7.4,19376,237,52,4775,4080,23.7,2028.6
4485773420,1,38,3,0,4,5,4,1,1,0,0,15184,6.8,17545,199,48,-700,906,19.9,1518.4,16,0,1,5,4,5,1,0,1,0,15884,6.6,16639,215,38,700,-906,21.5,1588.4
4447096755,1,22,4,1,6,4,5,2,1,1,0,16697,7.2,19170,236,59,852,1553,23.6,1669.7,17,3,0,4,6,7,0,0,0,0,15845,7.0,17617,214,51,-852,-1553,21.4,1584.5
4502271212,1,15,2,1,10,4,9,1,1,0,0,18270,7.4,19486,238,59,3805,3162,23.8,1827.0,12,1,0,4,10,4,0,0,0,0,14465,6.6,16324,199,32,-3805,-3162,19.9,1446.5
4523612845,1,27,2,0,6,4,6,0,0,0,0,17591,7.2,18925,235,70,3208,3285,23.5,1759.1,15,4,1,4,6,2,0,0,0,0,14383,6.2,15640,186,52,-3208,-3285,18.6,1438.3
4495029898,0,15,6,1,5,2,9,0,0,0,0,16113,7.0,18642,236,53,1277,1357,23.6,1611.3,21,4,0,2,5,4,1,1,0,0,14836,6.8,17285,221,54,-1277,-1357,22.1,1483.6
4490673829,1,84,2,1,4,5,11,0,0,0,0,16316,6.6,17968,241,62,1193,1453,24.1,1631.6,14,3,0,5,4,5,0,0,0,0,15123,6.4,16515,208,44,-1193,-1453,20.8,1512.3
4492402947,1,51,0,1,11,4,4,1,1,0,0,18339,7.2,18855,216,53,4128,2704,21.6,1833.9,13,2,0,4,11,4,0,0,0,0,14211,6.4,16151,158,47,-4128,-2704,15.8,1421.1
4499876537,0,12,0,0,4,13,3,0,0,0,0,14349,6.6,16821,159,49,-6973,-3705,15.9,1434.9,19,0,1,13,4,11,1,1,0,1,21322,7.6,20526,263,60,6973,3705,26.3,2132.2
4511927788,0,26,2,0,2,7,1,0,0,0,0,14918,6.8,17605,221,53,-2442,-1427,22.1,1491.8,17,2,1,7,2,10,1,1,0,0,17360,7.2,19032,262,48,2442,1427,26.2,1736.0
4498702463,0,12,2,0,4,12,3,0,0,0,0,15202,6.6,16607,219,40,-6871,-5115,21.9,1520.2,34,2,1,12,4,11,1,1,0,1,22073,8.0,21722,253,80,6871,5115,25.3,2207.3
4436014488,1,15,3,1,6,6,12,0,0,0,0,17394,7.0,18668,233,55,285,-352,23.3,1739.4,16,1,0,6,6,9,0,0,0,0,17109,7.0,19020,228,61,-285,352,22.8,1710.9
4492809818,0,14,4,1,9,6,10,2,1,1,0,16851,6.6,17153,190,41,-1328,-1142,19.0,1685.1,37,4,0,6,9,6,0,0,0,1,18179,7.0,18295,227,41,1328,1142,22.7,1817.9
4452966828,0,23,6,1,6,7,9,0,0,0,0,16660,6.8,17061,210,56,99,-1609,21.0,1666.0,20,0,0,7,6,3,1,1,0,0,16561,7.0,18670,214,38,-99,1609,21.4,1656.1
4524342553,1,17,4,1,10,5,14,1,1,0,0,19052,7.2,19366,226,64,3754,2642,22.6,1905.2,16,3,0,5,10,7,0,0,0,0,15298,6.8,16724,215,47,-3754,-2642,21.5,1529.8
4459302014,1,13,4,1,10,5,10,0,0,0,0,18588,7.2,18890,229,48,2824,1346,22.9,1858.8,15,2,0,5,10,3,0,0,0,0,15764,6.8,17544,214,44,-2824,-1346,21.4,1576.4
4478232442,0,18,3,0,2,7,4,1,1,0,0,13870,6.4,15601,202,46,-2809,-2023,20.2,1387.0,20,7,1,7,2,7,0,0,0,0,16679,6.8,17624,221,50,2809,2023,22.1,1667.9
4464526673,0,17,1,1,5,11,4,0,0,0,0,15332,6.6,16368,187,52,-2398,-2326,18.7,1533.2,17,1,0,11,5,8,1,1,0,0,17730,7.2,18694,202,52,2398,2326,20.2,1773.0
4519464273,0,29,3,1,2,5,4,0,0,0,0,14735,6.6,16525,236,40,-1751,-2530,23.6,1473.5,31,5,0,5,2,6,0,0,0,0,16486,7.0,19055,223,68,1751,2530,22.3,1648.6
4525371439,1,15,3,1,8,6,12,1,1,0,0,18012,6.6,16748,210,53,2957,2549,21.0,1801.2,47,2,0,6,8,5,0,0,0,0,15055,6.0,14199,177,41,-2957,-2549,17.7,1505.5
4505132813,0,17,2,0,4,9,2,0,0,0,0,15201,7.0,16780,174,64,-2381,-461,17.4,1520.1,52,1,1,9,4,13,1,1,0,0,17582,6.6,17241,208,44,2381,461,20.8,1758.2
4518146165,0,13,2,0,7,14,11,0,0,0,0,14416,5.2,11286,90,30,-5253,-5281,9.0,1441.6,16,1,1,14,7,19,0,0,0,0,19669,6.6,16567,203,44,5253,5281,20.3,1966.9
4508109073,1,17,1,1,5,6,4,1,0,1,0,17146,7.0,19051,240,67,954,1154,24.0,1714.6,23,4,0,6,5,8,1,1,0,0,16192,7.0,17897,212,50,-954,-1154,21.2,1619.2
4519879315,1,53,3,1,8,8,4,0,0,0,0,17236,7.2,19937,235,64,-308,1739,23.5,1723.6,17,2,0,8,8,10,1,1,0,0,17544,6.8,18198,220,60,308,-1739,22.0,1754.4
4523386766,0,14,4,0,4,7,6,0,0,0,0,16354,7.0,18778,268,52,-1676,-1759,26.8,1635.4,13,4,1,7,4,8,1,1,0,0,18030,7.4,20537,244,84,1676,1759,24.4,1803.0
4497853195,1,17,5,1,9,3,11,0,0,0,0,19153,7.4,20631,262,51,4003,2755,26.2,1915.3,18,2,0,3,9,3,1,1,0,0,15150,7.2,17876,225,55,-4003,-2755,22.5,1515.0
4517558941,0,16,2,0,2,10,1,0,0,0,0,13550,6.8,16368,194,44,-4982,-3368,19.4,1355.0,16,3,1,10,2,5,2,1,1,0,18532,7.4,19736,258,48,4982,3368,25.8,1853.2
4491884142,0,13,2,0,8,3,9,0,0,0,0,16681,7.2,18901,216,42,1650,1230,21.6,1668.1,37,1,1,3,8,1,2,1,1,0,15031,7.0,17671,224,54,-1650,-1230,22.4,1503.1
4523475204,0,16,2,0,2,7,3,1,0,1,0,14487,7.0,17499,229,56,-2639,-953,22.9,1448.7,16,2,1,7,2,5,1,1,0,0,17126,7.0,18452,227,62,2639,953,22.7,1712.6
4505990555,1,15,3,1,6,3,12,0,0,0,0,16925,6.6,17065,212,40,784,-2929,21.2,1692.5,15,2,0,3,6,2,0,0,0,0,16141,7.2,19994,224,91,-784,2929,22.4,1614.1
4481919426,0,14,2,0,9,6,13,1,1,0,0,17235,6.8,17249,196,47,1177,-691,19.6,1723.5,16,4,1,6,9,7,0,0,0,0,16058,6.8,17940,232,37,-1177,691,23.2,1605.8
4420941972,1,25,3,1,6,5,7,1,0,1,1,17826,7.4,19427,225,67,1909,979,22.5,1782.6,16,3,0,5,6,3,0,0,0,0,15917,7.0,18448,220,48,-1909,-979,22.0,1591.7
4520833786,1,17,1,1,10,6,10,0,0,0,0,18559,7.0,18239,223,61,2606,964,22.3,1855.9,16,0,0,6,10,6,1,1,0,0,15953,6.8,17275,203,60,-2606,-964,20.3,1595.3
4527516499,0,15,1,0,8,10,8,0,0,0,0,17490,7.2,18680,198,52,-905,-29,19.8,1749.0,11,1,1,10,8,12,1,1,0,0,18395,7.2,18709,196,64,905,29,19.6,1839.5
4527318012,0,29,3,1,7,6,6,0,0,0,0,16714,7.4,19411,226,58,91,798,22.6,1671.4,15,3,0,6,7,5,0,0,0,0,16623,7.2,18613,252,46,-91,-798,25.2,1662.3
4521091433,0,19,3,0,10,10,15,0,0,0,0,18724,6.8,18411,221,33,622,319,22.1,1872.4,40,2,1,10,10,16,2,1,1,0,18102,7.0,18092,220,47,-622,-319,22.0,1810.2
4497643259,0,36,3,1,6,3,9,0,0,0,0,16991,6.8,18186,242,56,1116,1050,24.2,1699.1,17,2,0,3,6,5,0,0,0,0,15875,6.8,17136,248,45,-1116,-1050,24.8,1587.5
4522601125,1,19,1,1,7,3,12,2,1,1,0,17791,7.2,18557,250,48,2763,1017,25.0,1779.1,16,3,0,3,7,5,0,0,0,0,15028,6.8,17540,200,55,-2763,-1017,20.0,1502.8
4477392695,1,18,5,1,10,9,10,0,0,0,0,17335,6.6,16110,176,48,1287,-749,17.6,1733.5,16,3,0,9,10,11,1,1,0,0,16048,6.6,16859,198,40,-1287,749,19.8,1604.8
4486701879,0,37,2,0,8,8,15,1,1,0,0,17192,7.0,17774,190,59,203,557,19.0,1719.2,21,3,1,8,8,14,0,0,0,0,16989,6.8,17217,235,44,-203,-557,23.5,1698.9
4495147066,0,13,1,0,2,9,2,0,0,0,0,13267,6.2,14831,185,40,-5292,-4922,18.5,1326.7,14,3,1,9,2,12,1,1,0,0,18559,7.2,19753,237,64,5292,4922,23.7,1855.9
4483489256,0,16,2,0,8,4,5,0,0,0,0,16840,7.0,18528,209,51,793,461,20.9,1684.0,19,2,1,4,8,5,1,1,0,0,16047,7.0,18067,232,48,-793,-461,23.2,1604.7
4511428769,1,13,0,0,9,6,10,1,0,1,0,17491,7.0,18181,194,74,616,43,19.4,1749.1,15,2,1,6,9,5,1,1,0,0,16875,6.8,18138,253,36,-616,-43,25.3,1687.5
4502459201,0,15,1,1,3,12,2,0,0,0,0,15853,7.0,18223,220,68,-2388,-1978,22.0,1585.3,18,1,0,12,3,8,2,1,1,0,18241,7.6,20201,205,56,2388,1978,20.5,1824.1
4476068972,0,17,1,1,3,4,4,0,0,0,0,15478,6.8,17551,233,59,-1003,-1571,23.3,1547.8,16,0,0,4,3,4,0,0,0,0,16481,7.2,19122,236,64,1003,1571,23.6,1648.1
4493955025,0,19,3,1,4,9,5,1,1,0,0,15123,6.8,17144,210,45,-3204,-779,21.0,1512.3,10,5,0,9,4,16,1,0,1,0,18327,7.0,17923,216,36,3204,779,21.6,1832.7
4465742706,1,20,2,1,10,2,12,2,1,1,0,18212,7.2,18905,196,54,4429,3004,19.6,1821.2,14,4,0,2,10,1,0,0,0,0,13783,6.6,15901,180,48,-4429,-3004,18.0,1378.3
4524779712,1,17,0,1,7,5,11,1,0,1,0,16977,7.0,17852,201,44,1753,847,20.1,1697.7,9,5,0,5,7,9,1,1,0,0,15224,6.6,17005,186,49,-1753,-847,18.6,1522.4
4521738539,1,15,4,1,16,6,16,0,0,0,0,21442,7.6,20440,232,48,5956,4568,23.2,2144.2,18,0,0,6,16,5,0,0,0,0,15486,6.4,15872,185,40,-5956,-4568,18.5,1548.6
4525171151,0,14,3,0,4,6,4,1,1,0,0,15433,7.2,18889,218,66,-1629,-287,21.8,1543.3,16,1,1,6,4,4,0,0,0,0,17062,7.4,19176,249,42,1629,287,24.9,1706.2
4525011437,1,17,3,0,9,11,12,0,0,0,0,16899,6.8,16675,180,39,-1507,-1389,18.0,1689.9,14,3,1,11,9,14,2,1,1,0,18406,7.0,18064,217,48,1507,1389,21.7,1840.6
4524330916,0,20,4,0,5,6,6,0,0,0,0,15242,6.6,16792,198,45,-3024,-1285,19.8,1524.2,40,3,1,6,5,3,0,0,0,1,18266,7.0,18077,236,48,3024,1285,23.6,1826.6
4523330702,0,17,2,0,5,5,6,1,1,0,0,15104,6.6,17002,186,51,-2130,-2032,18.6,1510.4,17,1,1,5,5,3,0,0,0,0,17234,7.2,19034,259,60,2130,2032,25.9,1723.4
4487326778,0,15,3,0,3,11,3,0,0,0,0,14579,6.6,15951,227,35,-3603,-3793,22.7,1457.9,16,3,1,11,3,9,0,0,0,0,18182,7.2,19744,232,49,3603,3793,23.2,1818.2
4525932869,0,19,4,1,8,14,9,1,1,0,0,16227,6.6,16987,197,48,-3055,-2672,19.7,1622.7,19,2,0,14,8,15,0,0,0,0,19282,7.2,19659,214,44,3055,2672,21.4,1928.2
4489502517,0,15,0,0,4,9,5,0,0,0,0,16377,6.8,18575,213,67,-2218,-1083,21.3,1637.7,21,4,1,9,4,7,2,1,1,1,18595,7.2,19658,222,60,2218,1083,22.2,1859.5
4517828246,1,17,3,0,6,8,4,1,1,0,0,16047,6.8,18407,214,58,-1495,330,21.4,1604.7,15,2,1,8,6,11,0,0,0,0,17542,6.8,18077,205,54,1495,-330,20.5,1754.2
4479922611,1,14,1,0,7,3,13,0,0,0,0,17800,7.0,19085,223,52,2460,1934,22.3,1780.0,13,1,1,3,7,5,1,1,0,0,15340,6.6,17151,205,60,-2460,-1934,20.5,1534.0
4517488676,1,52,2,1,11,6,16,1,1,0,0,18003,7.0,18657,213,51,2647,2948,21.3,1800.3,14,0,0,6,11,7,0,0,0,0,15356,6.6,15709,187,40,-2647,-2948,18.7,1535.6
4486111513,1,16,4,0,5,7,6,0,0,0,0,16402,7.0,17710,223,68,194,-220,22.3,1640.2,14,5,1,7,5,8,0,0,0,0,16208,7.0,17930,195,56,-194,220,19.5,1620.8
4508499882,1,40,0,1,7,5,7,1,0,1,0,16232,7.0,18631,200,52,319,1559,20.0,1623.2,14,12,0,5,7,4,1,1,0,0,15913,6.8,17072,224,51,-319,-1559,22.4,1591.3
4518569254,1,38,4,1,5,7,6,1,1,0,0,15671,6.8,17411,205,44,-981,-994,20.5,1567.1,15,4,0,7,5,8,0,0,0,0,16652,6.8,18405,219,53,981,994,21.9,1665.2
4481718331,0,18,6,1,9,6,6,1,1,0,0,17828,6.8,17917,218,54,1767,709,21.8,1782.8,19,4,0,6,9,7,0,0,0,0,16061,6.8,17208,202,44,-1767,-709,20.2,1606.1
4520641910,1,14,0,1,6,2,5,2,1,1,0,17215,7.0,19549,264,57,1978,1595,26.4,1721.5,13,1,0,2,6,2,0,0,0,0,15237,7.0,17954,199,71,-1978,-1595,19.9,1523.7
4511640654,1,58,7,0,5,2,8,0,0,0,0,16385,7.0,18788,222,68,1421,1097,22.2,1638.5,28,3,1,2,5,4,1,1,0,0,14964,7.0,17691,215,61,-1421,-1097,21.5,1496.4
4506187431,1,18,0,0,3,3,2,0,0,0,0,16639,7.2,19375,269,64,835,1506,26.9,1663.9,36,5,1,3,3,4,1,1,0,0,15804,7.0,17869,216,56,-835,-1506,21.6,1580.4
4470068491,1,12,1,0,5,4,2,1,0,1,0,15798,7.0,18818,231,52,-361,671,23.1,1579.8,17,2,1,4,5,3,1,1,0,0,16159,7.0,18147,248,48,361,-671,24.8,1615.9
4522013704,1,18,6,0,4,6,7,0,0,0,0,16513,6.8,18383,249,43,-379,725,24.9,1651.3,22,3,1,6,4,12,1,1,0,0,16892,6.8,17658,240,52,379,-725,24.0,1689.2
4525584970,0,16,1,1,7,5,10,1,0,1,0,16940,6.8,16731,232,40,1523,-576,23.2,1694.0,14,3,0,5,7,6,1,1,0,0,15417,6.8,17307,185,58,-1523,576,18.5,1541.7
4513629766,0,15,2,1,10,12,8,0,0,0,0,17566,6.8,17314,202,44,-2053,-1784,20.2,1756.6,17,1,0,12,10,12,2,1,1,0,19619,7.0,19098,214,55,2053,1784,21.4,1961.9
4500342902,0,17,2,0,7,7,10,1,1,0,0,16728,7.0,17494,231,36,102,65,23.1,1672.8,24,5,1,7,7,8,0,0,0,0,16626,6.6,17429,195,52,-102,-65,19.5,1662.6
4518570301,1,17,2,1,2,4,4,1,0,1,0,15565,6.4,17312,251,64,-1185,-2402,25.1,1556.5,21,2,0,4,2,8,1,1,0,0,16750,7.4,19714,267,62,1185,2402,26.7,1675.0
4502360734,1,14,2,1,3,3,3,0,0,0,0,16213,7.2,18235,247,60,1962,730,24.7,1621.3,15,3,0,3,3,6,1,0,1,0,14251,6.8,17505,212,39,-1962,-730,21.2,1425.1
4520417782,1,10,3,0,12,6,12,0,0,0,0,17839,7.0,18147,158,43,1278,816,15.8,1783.9,15,0,1,6,12,2,0,0,0,0,16561,7.0,17331,200,48,-1278,-816,20.0,1656.1
4446051712,0,10,4,0,3,10,3,0,0,0,0,15548,6.8,17564,215,44,-2686,-2037,21.5,1554.8,184,1,1,10,3,15,1,1,0,0,18234,7.4,19601,212,43,2686,2037,21.2,1823.4
4519890701,0,13,2,1,3,5,3,1,0,1,0,15072,7.0,17479,233,52,-1247,-2320,23.3,1507.2,41,2,0,5,3,6,1,1,0,0,16319,7.4,19799,222,76,1247,2320,22.2,1631.9
4507320032,0,15,0,0,6,10,9,0,0,0,0,15325,6.6,16317,192,36,-2964,-2587,19.2,1532.5,16,1,1,10,6,12,2,1,1,0,18289,7.2,18904,208,56,2964,2587,20.8,1828.9
4523404068,0,12,1,0,6,7,6,0,0,0,0,16120,7.0,18149,215,51,-732,750,21.5,1612.0,17,0,1,7,6,7,1,1,0,0,16852,7.0,17399,205,56,732,-750,20.5,1685.2
4519846925,0,16,2,0,1,6,1,1,0,1,1,15717,6.6,16927,241,52,-856,-2269,24.1,1571.7,70,5,1,6,1,11,1,1,0,0,16573,7.2,19196,245,42,856,2269,24.5,1657.3
4452237596,1,15,2,1,3,2,2,0,0,0,0,15265,6.8,17859,224,52,446,263,22.4,1526.5,14,1,0,2,3,1,0,0,0,0,14819,6.6,17596,237,45,-446,-263,23.7,1481.9
4472387660,1,16,3,1,2,9,1,0,0,0,0,14975,6.4,16649,222,67,-2206,-2548,22.2,1497.5,18,3,0,9,2,12,1,1,0,0,17181,7.4,19197,216,48,2206,2548,21.6,1718.1
4450801674,0,14,4,0,7,7,6,1,0,1,0,16931,7.2,18446,209,52,-1570,-2103,20.9,1693.1,21,4,1,7,7,9,1,1,0,0,18501,7.6,20549,228,80,1570,2103,22.8,1850.1
4518483468,0,14,6,1,7,3,11,0,0,0,0,17443,7.4,19184,238,45,2786,881,23.8,1744.3,15,4,0,3,7,2,0,0,0,0,14657,6.8,18303,212,57,-2786,-881,21.2,1465.7
4469549199,0,15,2,1,3,1,3,1,1,0,0,15243,6.6,17194,224,56,830,-1002,22.4,1524.3,40,4,0,1,3,1,1,0,1,0,14413,6.8,18196,220,56,-830,1002,22.0,1441.3
4496503390,0,33,1,0,2,5,2,0,0,0,0,14935,7.0,17703,230,56,-1208,-152,23.0,1493.5,17,1,1,5,2,8,1,1,0,0,16143,7.0,17855,248,43,1208,152,24.8,1614.3
4439587342,1,24,8,0,4,5,3,0,0,0,0,15597,7.0,18695,238,61,-1366,-242,23.8,1559.7,27,6,1,5,4,3,1,1,0,0,16963,7.2,18937,266,50,1366,242,26.6,1696.3
4505255448,1,18,1,1,12,1,12,1,1,0,0,20136,7.8,20899,235,61,6290,4719,23.5,2013.6,13,0,0,1,12,0,0,0,0,0,13846,6.4,16180,201,63,-6290,-4719,20.1,1384.6
4454996740,0,12,3,0,4,7,5,1,1,0,0,15659,7.2,19051,210,83,-2542,1134,21.0,1565.9,11,3,1,7,4,15,1,0,1,1,18201,7.0,17917,233,48,2542,-1134,23.3,1820.1
4516284402,1,35,2,0,10,6,8,0,0,0,0,18165,7.0,18510,219,57,2746,999,21.9,1816.5,23,10,1,6,10,3,0,0,0,0,15419,6.8,17511,206,49,-2746,-999,20.6,1541.9
4522649114,1,23,5,1,5,2,9,0,0,0,0,15904,7.0,17670,213,48,1085,-556,21.3,1590.4,20,2,0,2,5,1,0,0,0,0,14819,6.8,18226,229,64,-1085,556,22.9,1481.9
4446037878,0,23,3,0,7,5,9,0,0,0,0,16219,7.2,17966,197,40,709,1449,19.7,1621.9,17,5,1,5,7,5,1,1,0,0,15510,6.4,16517,199,44,-709,-1449,19.9,1551.0
4510437554,0,103,1,0,6,3,5,0,0,0,0,15846,6.8,18039,201,62,1481,996,20.1,1584.6,18,0,1,3,6,2,0,0,0,0,14365,7.0,17043,208,39,-1481,-996,20.8,1436.5
4523021223,0,20,1,0,4,6,2,1,0,1,0,15360,6.6,16644,220,44,-829,-1232,22.0,1536.0,19,2,1,6,4,4,1,1,0,0,16189,6.8,17876,232,43,829,1232,23.2,1618.9
4507920169,0,22,3,0,8,11,9,1,0,1,0,17398,7.0,18429,206,36,-1079,252,20.6,1739.8,21,5,1,11,8,7,1,1,0,0,18477,7.0,18177,233,44,1079,-252,23.3,1847.7
4525993420,1,26,1,1,6,6,7,1,0,1,1,17312,6.6,16818,209,50,1139,-885,20.9,1731.2,17,2,0,6,6,8,1,1,0,0,16173,6.8,17703,208,52,-1139,885,20.8,1617.3
4459740551,0,17,1,1,9,17,17,0,0,0,0,16834,6.2,14815,187,29,-3887,-3392,18.7,1683.4,31,1,0,17,9,21,0,0,0,0,20721,7.0,18207,211,40,3887,3392,21.1,2072.1
4502041517,1,19,6,0,3,7,3,1,0,1,0,16074,7.0,17776,237,48,-283,-484,23.7,1607.4,44,3,1,7,3,6,0,0,0,0,16357,7.2,18260,220,31,283,484,22.0,1635.7
4503039394,1,39,3,1,7,3,11,0,0,0,0,16879,7.4,19019,237,43,2336,2323,23.7,1687.9,13,0,0,3,7,3,0,0,0,0,14543,6.8,16696,194,51,-2336,-2323,19.4,1454.3
4527275742,1,22,2,1,7,3,10,0,0,0,0,17755,7.2,19403,254,48,2864,3193,25.4,1775.5,14,3,0,3,7,3,0,0,0,0,14891,6.4,16210,221,41,-2864,-3193,22.1,1489.1
4483907436,1,16,3,0,4,11,5,1,0,1,1,16855,6.6,16360,232,40,-885,-2172,23.2,1685.5,37,1,1,11,4,15,1,1,0,0,17740,7.2,18532,216,36,885,2172,21.6,1774.0
4514094698,0,31,20,0,7,7,6,1,1,0,0,16063,6.8,17688,192,60,-1571,-1130,19.2,1606.3,47,6,1,7,7,6,0,0,0,0,17634,7.2,18818,260,60,1571,1130,26.0,1763.4
4514404370,1,19,2,1,8,2,8,0,0,0,0,17101,7.0,18836,237,45,3056,1805,23.7,1710.1,15,3,0,2,8,2,0,0,0,0,14045,6.6,17031,194,48,-3056,-1805,19.4,1404.5
4522640075,1,55,4,1,8,4,11,0,0,0,0,17064,7.0,18586,207,42,1183,1036,20.7,1706.4,18,1,0,4,8,2,1,0,1,0,15881,7.0,17550,217,54,-1183,-1036,21.7,1588.1
4518577355,1,15,3,1,10,5,9,1,1,0,0,19265,7.4,20085,244,75,4692,3644,24.4,1926.5,16,1,0,5,10,0,0,0,0,0,14573,6.6,16441,221,28,-4692,-3644,22.1,1457.3
4524081937,1,18,3,1,6,1,5,2,1,1,2,18553,7.0,18785,248,48,4957,3218,24.8,1855.3,13,2,0,1,6,0,0,0,0,0,13596,6.4,15567,214,53,-4957,-3218,21.4,1359.6
4525213548,1,21,9,0,9,5,7,0,0,0,0,16984,6.8,17014,214,35,1580,605,21.4,1698.4,56,6,1,5,9,8,0,0,0,0,15404,6.8,16409,194,40,-1580,-605,19.4,1540.4
4524151765,0,13,2,1,8,5,5,1,1,0,0,16373,7.0,18169,188,47,1221,494,18.8,1637.3,11,2,0,5,8,4,0,0,0,0,15152,7.0,17675,209,40,-1221,-494,20.9,1515.2
4523053745,0,14,1,0,1,7,3,0,0,0,0,12959,6.4,15381,172,43,-4456,-2336,17.2,1295.9,52,3,1,7,1,17,0,0,0,0,17415,6.8,17717,196,51,4456,2336,19.6,1741.5
4523803746,1,16,3,0,0,5,0,0,0,0,0,14422,6.6,17039,245,59,-1723,-545,24.5,1442.2,17,4,1,5,0,10,1,1,0,0,16145,6.8,17584,229,52,1723,545,22.9,1614.5
4506871596,1,15,3,1,7,5,8,1,1,0,0,16864,7.0,18073,224,52,1040,1194,22.4,1686.4,18,1,0,5,7,3,0,0,0,0,15824,6.6,16879,198,44,-1040,-1194,19.8,1582.4
4525134229,1,19,2,1,7,1,11,1,1,0,0,17566,7.2,19634,243,56,2821,2755,24.3,1756.6,14,2,0,1,7,3,0,0,0,0,14745,6.8,16879,234,54,-2821,-2755,23.4,1474.5
4498506216,0,14,2,1,4,10,4,0,0,0,0,14869,6.6,16447,188,52,-4659,-3884,18.8,1486.9,18,2,0,10,4,14,2,1,1,0,19528,7.4,20331,255,64,4659,3884,25.5,1952.8
4525150021,0,11,3,1,2,2,3,0,0,0,0,14385,6.6,17383,216,49,-959,-1331,21.6,1438.5,17,1,0,2,2,2,1,1,0,0,15344,7.0,18714,223,80,959,1331,22.3,1534.4
4501133727,0,18,5,0,3,7,5,0,0,0,0,14996,6.4,16234,221,44,-1502,-959,22.1,1499.6,17,4,1,7,3,13,0,0,0,0,16498,6.8,17193,229,48,1502,959,22.9,1649.8
4508799879,0,10,3,0,3,6,5,1,0,1,0,15521,6.6,16916,202,60,-1187,-714,20.2,1552.1,72,1,1,6,3,6,1,1,0,0,16708,7.0,17630,219,53,1187,714,21.9,1670.8
4519402514,0,13,3,0,2,5,2,1,0,1,0,14652,6.8,17192,205,52,-458,-559,20.5,1465.2,14,0,1,5,2,3,1,1,0,0,15110,6.8,17751,210,52,458,559,21.0,1511.0
4510799215,1,14,3,1,4,10,7,1,1,0,0,15471,6.4,15785,192,53,-3033,-3775,19.2,1547.1,18,2,0,10,4,13,0,0,0,0,18504,7.4,19560,207,64,3033,3775,20.7,1850.4
4519072442,0,13,1,1,5,14,4,0,0,0,0,15787,6.6,15849,200,40,-3783,-3300,20.0,1578.7,30,4,0,14,5,12,1,1,0,0,19570,7.2,19149,201,61,3783,3300,20.1,1957.0
4519229533,0,15,2,1,4,3,7,1,1,0,0,15669,7.0,17654,223,57,273,-1110,22.3,1566.9,21,3,0,3,4,3,0,0,0,0,15396,7.2,18764,237,56,-273,1110,23.7,1539.6
4420437374,0,17,2,1,4,3,3,0,0,0,0,14742,6.8,17515,203,40,-541,-1094,20.3,1474.2,17,3,0,3,4,5,2,1,1,0,15283,7.2,18609,230,60,541,1094,23.0,1528.3
4493674293,1,13,3,1,5,3,2,0,0,0,0,16506,6.8,17581,233,56,1922,1355,23.3,1650.6,12,1,0,3,5,4,0,0,0,0,14584,6.2,16226,218,20,-1922,-1355,21.8,1458.4
4515298308,0,13,3,1,3,2,2,1,1,0,0,14610,6.6,17048,206,53,-758,-1310,20.6,1461.0,31,2,0,2,3,2,0,0,0,0,15368,7.0,18358,249,57,758,1310,24.9,1536.8
4519180415,0,16,2,1,6,7,10,1,1,0,0,17075,7.0,18328,229,57,1188,-284,22.9,1707.5,12,0,0,7,6,5,0,0,0,0,15887,7.0,18612,182,51,-1188,284,18.2,1588.7
4467008289,1,22,4,1,5,2,2,2,1,1,0,15737,7.0,18634,217,53,1381,1017,21.7,1573.7,16,3,0,2,5,1,0,0,0,0,14356,7.0,17617,212,60,-1381,-1017,21.2,1435.6
4521702238,1,12,4,0,9,10,8,1,0,1,2,19162,7.0,17841,196,36,1082,14,19.6,1916.2,12,4,1,10,9,16,1,1,0,0,18080,6.8,17827,203,44,-1082,-14,20.3,1808.0
4521692876,0,10,3,0,4,9,3,2,1,1,0,16273,7.2,18638,246,71,-454,23,24.6,1627.3,37,1,1,9,4,6,0,0,0,0,16727,7.2,18615,204,43,454,-23,20.4,1672.7
4514402510,0,17,0,1,5,7,7,1,1,0,0,15587,6.8,16746,181,63,-1672,-2698,18.1,1558.7,14,0,0,7,5,6,0,0,0,0,17259,7.4,19444,218,76,1672,2698,21.8,1725.9
4447699269,0,37,5,0,10,6,18,0,0,0,0,17690,7.2,18278,192,45,1377,2429,19.2,1769.0,16,1,1,6,10,5,0,0,0,0,16313,6.6,15849,194,42,-1377,-2429,19.4,1631.3
4469830896,0,15,7,0,6,7,7,1,1,0,0,16517,6.8,16913,238,44,-409,-2098,23.8,1651.7,18,4,1,7,6,7,1,0,1,0,16926,7.0,19011,254,44,409,2098,25.4,1692.6
4522682981,1,14,2,1,10,1,9,0,0,0,0,18324,7.4,19267,199,54,4545,3714,19.9,1832.4,15,1,0,1,10,1,0,0,0,0,13779,6.2,15553,195,46,-4545,-3714,19.5,1377.9
4523771457,0,18,4,1,9,6,9,2,1,1,0,17721,7.0,18253,226,57,1160,939,22.6,1772.1,17,6,0,6,9,7,0,0,0,0,16561,6.8,17314,213,62,-1160,-939,21.3,1656.1
4500061522,0,15,4,0,5,8,1,0,0,0,0,14897,7.0,17306,212,47,-1770,325,21.2,1489.7,16,2,1,8,5,9,1,1,0,0,16667,6.8,16981,191,46,1770,-325,19.1,1666.7
4518844953,1,17,15,1,8,2,7,1,1,0,0,17543,7.2,19535,254,32,4387,3411,25.4,1754.3,43,2,0,2,8,0,0,0,0,0,13156,6.6,16124,188,44,-4387,-3411,18.8,1315.6
4525337352,1,14,4,0,4,5,1,1,1,0,0,15202,7.0,18246,240,56,-947,1016,24.0,1520.2,17,2,1,5,4,7,0,0,0,0,16149,6.8,17230,231,46,947,-1016,23.1,1614.9
4522233309,0,14,8,0,6,7,4,1,1,0,0,16773,6.8,17641,237,48,120,-1254,23.7,1677.3,20,2,1,7,6,5,0,0,0,0,16653,7.2,18895,224,48,-120,1254,22.4,1665.3
4512160768,0,11,1,1,2,3,5,1,1,0,0,14305,6.8,17323,214,47,-1517,-972,21.4,1430.5,16,0,0,3,2,3,1,0,1,0,15822,7.0,18295,225,68,1517,972,22.5,1582.2
4527297210,1,14,2,0,6,2,4,2,1,1,0,16886,7.2,18724,242,64,2881,2005,24.2,1688.6,141,1,1,2,6,2,0,0,0,0,14005,6.8,16719,186,48,-2881,-2005,18.6,1400.5
4473463200,1,19,2,1,7,4,3,1,1,0,0,17121,7.0,18545,242,56,2393,725,24.2,1712.1,26,4,0,4,7,3,0,0,0,0,14728,7.0,17820,194,47,-2393,-725,19.4,1472.8
4523400040,1,15,3,0,7,4,14,0,0,0,0,16865,6.8,17583,211,59,1897,1014,21.1,1686.5,13,3,1,4,7,5,0,0,0,0,14968,6.6,16569,182,28,-1897,-1014,18.2,1496.8
4515668714,0,15,3,1,4,10,6,0,0,0,0,15728,6.8,16927,212,56,-1615,-1585,21.2,1572.8,33,4,0,10,4,12,0,0,0,0,17343,7.0,18512,205,44,1615,1585,20.5,1734.3
4519356539,0,38,4,1,3,0,3,0,0,0,0,15984,6.8,18306,261,49,1916,632,26.1,1598.4,16,0,0,0,3,0,0,0,0,0,14068,6.8,17674,224,72,-1916,-632,22.4,1406.8
4500741087,0,18,3,0,3,15,3,0,0,0,0,14878,6.6,16826,197,61,-5924,-3368,19.7,1487.8,17,5,1,15,3,20,2,1,1,0,20802,7.2,20194,226,64,5924,3368,22.6,2080.2
4512265608,0,19,4,0,2,5,1,1,1,0,0,14299,6.8,17111,211,47,-1673,-787,21.1,1429.9,17,4,1,5,2,8,0,0,0,0,15972,7.0,17898,228,40,1673,787,22.8,1597.2
4480568476,0,17,2,1,5,9,6,0,0,0,0,14923,6.8,17285,173,37,-3916,-2883,17.3,1492.3,14,0,0,9,5,8,1,1,0,0,18839,7.4,20168,239,68,3916,2883,23.9,1883.9
4519509800,0,17,2,1,2,9,3,0,0,0,0,13367,6.4,15834,157,52,-4081,-1994,15.7,1336.7,19,5,0,9,2,11,1,1,0,0,17448,7.2,17828,216,44,4081,1994,21.6,1744.8
4466952270,1,18,3,0,6,5,5,0,0,0,0,16757,7.2,18596,225,46,873,2194,22.5,1675.7,12,3,1,5,6,7,0,0,0,0,15884,6.6,16402,205,65,-873,-2194,20.5,1588.4
4474899637,1,18,3,0,6,5,4,2,1,1,0,16787,7.2,18618,253,52,534,154,25.3,1678.7,17,3,1,5,6,10,0,0,0,0,16253,7.2,18464,197,75,-534,-154,19.7,1625.3
4490264226,1,18,2,1,10,4,11,0,0,0,0,18851,7.4,19227,252,52,3737,1796,25.2,1885.1,14,3,0,4,10,4,0,0,0,0,15114,7.0,17431,203,45,-3737,-1796,20.3,1511.4
4479828060,0,20,1,0,3,5,0,0,0,0,0,13729,6.2,14661,180,36,-1213,-276,18.0,1372.9,16,1,1,5,3,10,2,1,1,0,14942,6.4,14937,161,48,1213,276,16.1,1494.2
4511735384,1,16,1,1,9,3,8,2,1,1,0,18599,7.2,20735,216,76,3821,4288,21.6,1859.9,34,1,0,3,9,5,0,0,0,0,14778,6.8,16447,187,56,-3821,-4288,18.7,1477.8
4488677856,0,12,3,0,9,10,10,1,0,1,2,18947,6.8,17963,215,36,412,-655,21.5,1894.7,18,3,1,10,9,13,1,1,0,0,18535,7.2,18618,241,50,-412,655,24.1,1853.5
4514848856,0,16,1,0,8,3,7,1,1,0,0,16786,7.0,18389,250,32,651,2427,25.0,1678.6,18,2,1,3,8,3,1,0,1,1,16135,6.4,15962,201,69,-651,-2427,20.1,1613.5
4527301356,0,13,2,0,10,10,8,1,0,1,0,18524,7.0,18597,194,58,85,1243,19.4,1852.4,18,3,1,10,10,14,1,1,0,0,18439,6.6,17354,182,47,-85,-1243,18.2,1843.9
4509545038,1,11,6,0,12,6,14,1,1,0,0,18228,7.2,19302,196,55,2894,2297,19.6,1822.8,19,1,1,6,12,5,0,0,0,0,15334,6.6,17005,192,44,-2894,-2297,19.2,1533.4
4515599821,0,16,1,0,6,10,5,0,0,0,0,15985,7.0,17976,176,52,-2993,-2498,17.6,1598.5,15,1,1,10,6,7,2,1,1,0,18978,7.4,20474,218,58,2993,2498,21.8,1897.8
4475003668,0,19,4,0,2,7,3,0,0,0,0,14854,6.8,17513,250,55,-3330,-2255,25.0,1485.4,16,6,1,7,2,10,1,1,0,0,18184,7.4,19768,248,64,3330,2255,24.8,1818.4
4520582438,0,28,1,1,12,11,12,0,0,0,0,18336,7.0,17626,179,55,-466,-26,17.9,1833.6,15,2,0,11,12,19,0,0,0,0,18802,6.6,17652,211,32,466,26,21.1,1880.2
4527354441,0,37,17,0,3,5,2,0,0,0,0,15630,7.0,18378,254,48,-1092,-324,25.4,1563.0,36,3,1,5,3,7,0,0,0,0,16722,7.0,18702,264,44,1092,324,26.4,1672.2
4526135589,0,21,3,0,7,6,8,1,1,0,0,15463,6.8,16652,161,72,-1846,-1362,16.1,1546.3,44,3,1,6,7,3,1,0,1,1,17309,7.0,18014,194,48,1846,1362,19.4,1730.9
4517927232,1,16,4,1,10,7,9,0,0,0,0,16900,6.8,18173,170,54,-52,258,17.0,1690.0,14,3,0,7,10,5,1,1,0,0,16952,7.0,17915,222,40,52,-258,22.2,1695.2
4520540125,0,38,4,0,5,7,6,0,0,0,0,15485,6.8,17345,208,42,-1397,-730,20.8,1548.5,18,2,1,7,5,5,1,1,0,0,16882,7.2,18075,225,70,1397,730,22.5,1688.2
4521091786,0,15,0,1,6,9,5,1,0,1,0,16525,6.8,18095,204,47,-1782,-972,20.4,1652.5,18,3,0,9,6,11,1,1,0,0,18307,7.2,19067,217,67,1782,972,21.7,1830.7
4515361203,0,90,3,0,1,8,1,0,0,0,0,13704,6.6,16135,202,47,-5578,-2480,20.2,1370.4,17,3,1,8,1,9,2,1,1,1,19282,7.0,18615,247,64,5578,2480,24.7,1928.2
4520706889,1,15,5,0,11,10,8,0,0,0,0,17503,6.8,17699,192,52,-215,-438,19.2,1750.3,52,4,1,10,11,13,0,0,0,0,17718,7.0,18137,210,42,215,438,21.0,1771.8
4526450175,1,18,5,1,10,4,11,1,1,0,0,18266,7.2,19333,239,40,3160,2461,23.9,1826.6,17,4,0,4,10,6,0,0,0,0,15106,6.8,16872,206,47,-3160,-2461,20.6,1510.6
4517169842,0,16,3,0,4,6,7,0,0,0,0,15527,6.8,17554,202,44,-1537,93,20.2,1552.7,20,7,1,6,4,5,2,1,1,0,17064,6.8,17461,216,52,1537,-93,21.6,1706.4
4495909793,0,17,1,0,5,6,5,0,0,0,0,16179,7.0,18305,263,32,-97,1114,26.3,1617.9,15,3,1,6,5,7,2,1,1,0,16276,6.8,17191,221,60,97,-1114,22.1,1627.6
4492237019,1,15,2,0,2,3,3,1,1,0,0,15938,7.2,19963,242,72,443,1911,24.2,1593.8,15,2,1,3,2,1,0,0,0,0,15495,7.0,18052,244,56,-443,-1911,24.4,1549.5
4523483932,1,15,2,0,9,6,10,0,0,0,0,17118,7.2,19705,224,52,1550,3286,22.4,1711.8,14,3,1,6,9,8,1,1,0,0,15568,6.8,16419,182,56,-1550,-3286,18.2,1556.8
4519869638,1,16,4,0,5,9,2,1,1,0,0,15038,6.8,17122,194,45,-2755,-869,19.4,1503.8,22,2,1,9,5,11,0,0,0,0,17793,6.8,17991,218,46,2755,869,21.8,1779.3
4447657197,1,35,4,1,13,8,11,0,0,0,1,20341,7.4,19192,235,40,3202,2467,23.5,2034.1,24,6,0,8,13,10,1,1,0,0,17139,6.6,16725,189,48,-3202,-2467,18.9,1713.9
4472605223,0,13,2,0,3,6,1,0,0,0,0,14980,6.8,17697,210,59,-2958,-1627,21.0,1498.0,43,4,1,6,3,4,1,1,0,0,17938,7.2,19324,268,65,2958,1627,26.8,1793.8
4498444821,1,20,5,1,8,6,9,0,0,0,0,17777,7.4,18847,232,52,1317,1480,23.2,1777.7,15,0,0,6,8,8,1,0,1,0,16460,6.8,17367,202,40,-1317,-1480,20.2,1646.0
4433310925,1,16,1,1,5,2,5,0,0,0,0,16747,7.2,19858,250,64,2126,1070,25.0,1674.7,10,2,0,2,5,1,0,0,0,0,14621,7.0,18788,227,60,-2126,-1070,22.7,1462.1
4420481816,0,18,4,0,8,3,7,1,0,1,0,17574,7.2,19195,252,44,2774,2207,25.2,1757.4,15,4,1,3,8,2,1,1,0,0,14800,6.6,16988,225,47,-2774,-2207,22.5,1480.0
4492524476,1,14,7,0,5,9,4,0,0,0,0,15274,6.6,17169,228,37,-2538,-1731,22.8,1527.4,23,2,1,9,5,8,1,1,0,0,17812,7.2,18900,219,59,2538,1731,21.9,1781.2
4513586711,0,27,1,1,2,8,3,1,1,0,0,14071,6.4,16382,202,59,-3952,-2015,20.2,1407.1,118,4,0,8,2,8,0,0,0,0,18023,7.0,18397,228,36,3952,2015,22.8,1802.3
4506470828,0,15,4,0,3,7,1,0,0,0,0,14114,6.8,17331,215,36,-3063,-2014,21.5,1411.4,19,5,1,7,3,12,1,1,0,0,17177,7.4,19345,227,60,3063,2014,22.7,1717.7
4455048009,0,20,3,0,7,6,9,1,1,0,0,17116,7.4,19586,246,48,286,786,24.6,1711.6,18,5,1,6,7,5,0,0,0,0,16830,7.2,18800,219,60,-286,-786,21.9,1683.0
4518069601,0,14,2,0,5,6,7,0,0,0,0,15078,6.6,16578,202,28,-1018,-828,20.2,1507.8,15,0,1,6,5,6,1,1,0,0,16096,6.8,17406,222,38,1018,828,22.2,1609.6
4512380043,0,16,2,0,4,5,2,1,1,0,0,15581,7.0,18725,239,58,-460,935,23.9,1558.1,12,4,1,5,4,4,1,0,1,0,16041,7.0,17790,223,46,460,-935,22.3,1604.1
4509259241,1,10,1,1,7,5,4,1,0,1,2,19036,7.0,18857,246,47,4363,4467,24.6,1903.6,11,1,0,5,7,4,0,0,0,0,14673,5.8,14390,164,28,-4363,-4467,16.4,1467.3
4487506155,1,35,3,0,5,3,3,2,1,1,0,15884,7.2,19448,241,48,322,1377,24.1,1588.4,22,23,1,3,5,3,0,0,0,0,15562,7.2,18071,236,63,-322,-1377,23.6,1556.2
4508648367,1,58,1,0,2,3,4,0,0,0,0,13757,6.4,16461,220,34,-1752,-1746,22.0,1375.7,16,5,1,3,2,6,0,0,0,0,15509,7.2,18207,238,60,1752,1746,23.8,1550.9
4519376202,1,14,2,1,5,3,4,1,1,0,0,15836,7.0,18174,223,44,813,487,22.3,1583.6,14,1,0,3,5,3,0,0,0,0,15023,6.8,17687,219,64,-813,-487,21.9,1502.3
4466009861,1,15,3,1,9,3,11,1,0,1,1,19723,7.2,19678,249,35,4609,1189,24.9,1972.3,16,1,0,3,9,2,1,1,0,0,15114,7.2,18489,226,63,-4609,-1189,22.6,1511.4
4491372975,1,35,2,1,9,3,12,2,1,1,1,19629,7.6,21016,232,59,3865,4032,23.2,1962.9,17,0,0,3,9,7,0,0,0,0,15764,6.8,16984,225,47,-3865,-4032,22.5,1576.4
4515238176,1,14,4,0,5,2,11,1,1,0,0,16640,7.0,18989,247,63,1964,1416,24.7,1664.0,17,1,1,2,5,1,0,0,0,0,14676,7.0,17573,215,58,-1964,-1416,21.5,1467.6
4515677158,0,38,5,1,5,4,6,0,0,0,0,16402,7.0,18713,250,43,1678,1857,25.0,1640.2,15,1,0,4,5,3,1,1,0,0,14724,6.6,16856,173,75,-1678,-1857,17.3,1472.4
4520884097,1,16,2,0,8,8,7,1,1,0,0,17664,7.0,19310,220,60,257,1665,22.0,1766.4,15,2,1,8,8,11,1,0,1,0,17407,6.8,17645,225,56,-257,-1665,22.5,1740.7
4498809510,1,46,1,0,1,8,0,1,0,1,0,14206,7.0,17314,218,64,-2855,-1603,21.8,1420.6,16,14,1,8,1,8,1,1,0,0,17061,7.0,18917,228,56,2855,1603,22.8,1706.1
4523827809,1,26,4,0,5,3,6,2,1,1,0,15947,7.0,18280,219,64,402,890,21.9,1594.7,14,5,1,3,5,3,0,0,0,0,15545,7.0,17390,237,55,-402,-890,23.7,1554.5
4524067134,0,15,3,0,2,6,3,1,1,0,0,13653,7.0,17299,178,55,-4566,-2032,17.8,1365.3,25,5,1,6,2,5,1,0,1,1,18219,7.2,19331,260,46,4566,2032,26.0,1821.9
4521490447,1,84,1,1,8,5,8,1,0,1,0,17473,7.0,18577,228,48,1179,-736,22.8,1747.3,38,1,0,5,8,5,0,0,0,0,16294,7.4,19313,225,52,-1179,736,22.5,1629.4
4476404495,0,17,2,0,4,7,2,1,1,0,0,15974,6.8,17188,227,48,-836,-839,22.7,1597.4,20,5,1,7,4,10,0,0,0,0,16810,6.8,18027,217,40,836,839,21.7,1681.0
4520855918,1,16,3,0,9,3,11,1,1,0,0,17483,7.2,18777,222,44,2186,1698,22.2,1748.3,17,0,1,3,9,3,0,0,0,0,15297,6.8,17079,231,51,-2186,-1698,23.1,1529.7
4525539438,0,17,2,0,5,11,3,0,0,0,0,15645,6.8,16821,203,42,-2328,-1524,20.3,1564.5,18,3,1,11,5,13,1,1,0,0,17973,6.8,18345,209,40,2328,1524,20.9,1797.3
4506026519,1,16,4,1,7,3,6,0,0,0,0,18135,7.0,19138,252,40,2275,1360,25.2,1813.5,18,2,0,3,7,3,0,0,0,0,15860,7.0,17778,212,72,-2275,-1360,21.2,1586.0
4472368505,1,16,2,0,2,9,3,1,1,0,0,14901,6.8,16696,214,72,-3206,-2169,21.4,1490.1,16,1,1,9,2,10,0,0,0,0,18107,7.2,18865,238,58,3206,2169,23.8,1810.7
4498201124,1,14,3,1,6,3,6,0,0,0,0,17077,7.0,16964,228,44,2537,1396,22.8,1707.7,62,3,0,3,6,3,0,0,0,0,14540,6.0,15568,208,40,-2537,-1396,20.8,1454.0
4495708633,0,16,1,1,5,7,5,0,0,0,0,14352,6.4,15070,153,44,-2475,-3608,15.3,1435.2,117,3,0,7,5,8,1,1,0,0,16827,7.0,18678,227,52,2475,3608,22.7,1682.7
4442539318,0,14,2,0,1,11,0,0,0,0,0,13643,6.6,16564,199,60,-5479,-3332,19.9,1364.3,14,1,1,11,1,12,0,0,0,0,19122,7.2,19896,226,44,5479,3332,22.6,1912.2
4472895904,1,19,1,1,3,5,4,1,0,1,0,14731,6.6,16242,223,41,-2272,-2782,22.3,1473.1,12,2,0,5,3,7,1,1,0,0,17003,7.2,19024,220,84,2272,2782,22.0,1700.3
4455569547,1,11,1,1,9,7,10,0,0,0,0,17479,6.8,17898,209,52,1269,-422,20.9,1747.9,15,0,0,7,9,8,1,1,0,0,16210,6.8,18320,207,56,-1269,422,20.7,1621.0
4453021099,0,50,4,1,11,10,11,0,0,0,0,17535,6.8,17282,200,23,-400,-1684,20.0,1753.5,41,5,0,10,11,9,1,1,0,0,17935,7.2,18966,211,69,400,1684,21.1,1793.5
4513383518,0,53,2,0,0,3,0,1,1,0,0,13787,6.8,17848,225,52,-2153,-1344,22.5,1378.7,14,4,1,3,0,3,0,0,0,0,15940,7.2,19192,237,56,2153,1344,23.7,1594.0
4506309128,0,21,1,1,6,2,6,0,0,0,0,15953,6.8,18137,207,60,1496,1458,20.7,1595.3,13,2,0,2,6,5,1,1,0,0,14457,6.8,16679,201,51,-1496,-1458,20.1,1445.7
4526187847,0,15,6,0,4,10,3,0,0,0,0,15119,6.4,16068,201,28,-3770,-2959,20.1,1511.9,13,2,1,10,4,12,0,0,0,0,18889,7.0,19027,213,59,3770,2959,21.3,1888.9
4505728122,1,18,0,0,6,9,7,1,1,0,0,15596,6.2,15360,197,26,-2600,-2112,19.7,1559.6,18,1,1,9,6,7,1,0,1,1,18196,6.6,17472,185,52,2600,2112,18.5,1819.6
4523623443,0,13,6,0,6,13,6,0,0,0,0,16420,6.6,16281,223,40,-3593,-3086,22.3,1642.0,21,2,1,13,6,12,2,1,1,0,20013,7.4,19367,229,60,3593,3086,22.9,2001.3
4526678710,1,20,3,1,9,13,12,1,1,0,0,17597,6.6,16212,188,40,-1522,-1504,18.8,1759.7,16,1,0,13,9,15,0,0,0,0,19119,6.8,17716,185,37,1522,1504,18.5,1911.9
4526169931,1,14,2,0,6,5,5,0,0,0,0,16146,6.8,17725,210,52,1136,376,21.0,1614.6,13,3,1,5,6,0,1,1,0,0,15010,6.8,17349,198,58,-1136,-376,19.8,1501.0
4523647103,1,15,2,1,9,6,8,0,0,0,0,18130,7.2,19442,220,53,2635,2531,22.0,1813.0,11,1,0,6,9,4,0,0,0,0,15495,6.6,16911,195,32,-2635,-2531,19.5,1549.5
4477297316,1,16,2,1,4,3,3,1,0,1,2,17048,6.6,17678,206,48,2575,997,20.6,1704.8,14,3,0,3,4,4,1,1,0,0,14473,6.8,16681,214,43,-2575,-997,21.4,1447.3
4515644857,1,15,3,1,8,10,5,1,1,0,0,16480,7.0,17338,183,44,-1428,-1532,18.3,1648.0,28,3,0,10,8,10,0,0,0,0,17908,7.4,18870,192,56,1428,1532,19.2,1790.8
4521381994,0,17,2,0,2,7,3,0,0,0,0,13443,6.4,15718,192,40,-3241,-2297,19.2,1344.3,21,1,1,7,2,3,2,1,1,0,16684,6.8,18015,217,60,3241,2297,21.7,1668.4
4434486038,0,15,4,0,8,11,7,0,0,0,0,17550,7.0,18186,229,48,-1499,-1282,22.9,1755.0,14,4,1,11,8,14,1,0,1,0,19049,7.0,19468,247,32,1499,1282,24.7,1904.9
4508878155,1,11,5,1,9,6,10,0,0,0,0,18422,7.0,18184,219,49,2991,1357,21.9,1842.2,16,2,0,6,9,6,0,0,0,0,15431,6.6,16827,200,54,-2991,-1357,20.0,1543.1
4519552784,0,21,4,1,11,9,10,1,1,0,0,18172,6.8,17184,191,36,1390,437,19.1,1817.2,15,1,0,9,11,7,0,0,0,0,16782,6.6,16747,181,30,-1390,-437,18.1,1678.2
4523347600,1,13,2,1,9,5,9,1,1,0,0,16329,6.4,16575,206,36,948,16,20.6,1632.9,18,0,0,5,9,4,0,0,0,0,15381,6.8,16559,173,52,-948,-16,17.3,1538.1
4482162285,0,75,1,0,7,7,11,0,0,0,0,16600,7.0,18623,195,49,-335,262,19.5,1660.0,12,1,1,7,7,6,0,0,0,0,16935,7.2,18361,206,58,335,-262,20.6,1693.5
4524429870,1,14,1,1,4,5,0,2,1,1,0,15464,7.0,17833,218,71,-736,-94,21.8,1546.4,25,2,0,5,4,9,0,0,0,0,16200,7.0,17927,223,60,736,94,22.3,1620.0
4412946059,1,18,5,1,6,3,4,0,0,0,0,16876,7.0,18664,256,44,2717,2815,25.6,1687.6,17,4,0,3,6,4,0,0,0,0,14159,6.4,15849,205,43,-2717,-2815,20.5,1415.9
4491456543,1,20,5,1,10,1,15,1,1,0,0,18795,7.4,20241,260,43,4498,3370,26.0,1879.5,22,3,0,1,10,2,0,0,0,0,14297,6.4,16871,226,48,-4498,-3370,22.6,1429.7
4415032113,0,18,3,0,3,12,6,0,0,0,0,13961,6.2,14440,168,25,-4731,-2817,16.8,1396.1,20,7,1,12,3,21,0,0,0,0,18692,6.8,17257,206,42,4731,2817,20.6,1869.2
4498068359,1,13,2,0,3,7,2,0,0,0,0,15412,6.8,17502,211,45,-3768,-2111,21.1,1541.2,16,3,1,7,3,9,2,1,1,1,19180,7.4,19613,246,64,3768,2111,24.6,1918.0
4502515468,1,23,2,1,12,5,13,0,0,0,0,17307,6.4,16818,189,26,3237,2107,18.9,1730.7,14,0,0,5,12,4,0,0,0,0,14070,6.2,14711,158,33,-3237,-2107,15.8,1407.0
4510971927,1,12,4,0,9,4,8,1,1,0,0,17524,7.0,18825,258,30,2764,2121,25.8,1752.4,16,1,1,4,9,3,0,0,0,0,14760,6.4,16704,208,34,-2764,-2121,20.8,1476.0
4516079529,1,22,5,0,1,1,1,2,1,1,0,14379,6.8,17751,247,64,-411,430,24.7,1437.9,17,4,1,1,1,2,0,0,0,0,14790,7.0,17321,228,45,411,-430,22.8,1479.0
4475225279,1,12,5,1,6,5,10,1,0,1,0,16348,7.0,17866,225,36,-720,-1208,22.5,1634.8,15,1,0,5,6,9,1,1,0,0,17068,7.2,19074,248,64,720,1208,24.8,1706.8
4520529866,1,14,6,0,6,3,7,0,0,0,0,16590,7.2,19041,228,39,1214,2080,22.8,1659.0,16,1,1,3,6,2,1,1,0,0,15376,6.8,16961,224,66,-1214,-2080,22.4,1537.6
4507768381,1,17,1,1,7,3,3,0,0,0,0,16772,7.0,18456,255,47,1936,1799,25.5,1677.2,13,3,0,3,7,4,1,1,0,0,14836,6.6,16657,205,55,-1936,-1799,20.5,1483.6
4518203153,0,21,7,0,6,4,8,0,0,0,0,15840,6.8,16689,204,48,-376,-1118,20.4,1584.0,19,5,1,4,6,4,0,0,0,0,16216,6.8,17807,228,43,376,1118,22.8,1621.6
4462288936,0,105,0,0,3,8,2,0,0,0,0,14522,6.4,15305,211,39,-3596,-2738,21.1,1452.2,40,3,1,8,3,6,1,0,1,1,18118,7.0,18043,236,52,3596,2738,23.6,1811.8
4527658315,1,38,6,0,6,6,9,1,0,1,0,16368,7.0,17821,234,47,-1314,-1708,23.4,1636.8,17,6,1,6,6,4,1,1,0,0,17682,7.2,19529,230,76,1314,1708,23.0,1768.2
4523866410,1,16,5,0,6,7,4,0,0,0,0,17210,7.4,19805,243,67,42,1367,24.3,1721.0,15,3,1,7,6,3,1,1,0,0,17168,7.0,18438,255,52,-42,-1367,25.5,1716.8
4511234926,0,15,3,0,5,7,4,0,0,0,0,16162,7.0,18589,230,55,-565,738,23.0,1616.2,56,4,1,7,5,12,0,0,0,0,16727,7.0,17851,234,44,565,-738,23.4,1672.7
4526270984,0,26,2,0,4,9,3,0,0,0,0,16003,7.2,18376,229,61,-1515,-4,22.9,1600.3,13,4,1,9,4,11,2,1,1,0,17518,7.2,18380,219,56,1515,4,21.9,1751.8
4523665643,0,27,5,1,8,8,7,0,0,0,0,17130,6.8,17703,221,47,690,664,22.1,1713.0,19,7,0,8,8,14,0,0,0,0,16440,6.8,17039,208,48,-690,-664,20.8,1644.0
4523887906,1,13,2,0,8,6,8,1,1,0,0,16888,7.0,18788,202,56,856,1638,20.2,1688.8,44,1,1,6,8,5,1,0,1,0,16032,6.6,17150,198,52,-856,-1638,19.8,1603.2
4520747802,1,17,3,1,12,4,10,1,1,0,0,19724,7.8,20621,263,49,4999,3308,26.3,1972.4,19,4,0,4,12,4,1,0,1,0,14725,6.6,17313,148,73,-4999,-3308,14.8,1472.5
4410382729,1,14,2,1,6,5,9,0,0,0,0,15448,6.8,16856,180,47,58,203,18.0,1544.8,39,4,0,5,6,6,1,1,0,0,15390,6.6,16653,201,48,-58,-203,20.1,1539.0
4493890322,0,17,0,0,6,9,4,0,0,0,0,15640,7.0,17472,195,41,-1567,-232,19.5,1564.0,14,7,1,9,6,13,1,1,0,0,17207,7.0,17704,216,46,1567,232,21.6,1720.7
4522332403,0,14,2,0,1,4,1,0,0,0,0,14224,6.8,16992,229,41,-1325,-1348,22.9,1422.4,14,2,1,4,1,4,1,1,0,0,15549,7.0,18340,223,72,1325,1348,22.3,1554.9
4524919654,1,15,4,0,9,7,11,0,0,0,0,18090,7.2,18642,216,58,1884,1452,21.6,1809.0,169,1,1,7,9,8,0,0,0,0,16206,7.0,17190,190,41,-1884,-1452,19.0,1620.6
4517920600,1,16,4,0,6,7,5,1,1,0,0,15882,7.2,18675,198,68,-1019,-361,19.8,1588.2,15,3,1,7,6,5,0,0,0,0,16901,7.0,19036,240,56,1019,361,24.0,1690.1
4484146794,1,13,6,0,5,6,3,1,1,0,0,15397,6.6,17110,222,55,-775,-393,22.2,1539.7,19,0,1,6,5,5,0,0,0,0,16172,6.8,17503,191,52,775,393,19.1,1617.2
4526496557,0,15,19,0,3,3,2,1,1,0,0,14964,7.0,17928,235,52,-973,-1732,23.5,1496.4,48,3,1,3,3,1,0,0,0,0,15937,7.2,19660,251,76,973,1732,25.1,1593.7
4524990107,1,14,4,1,8,6,8,2,1,1,1,18250,7.0,17742,235,37,2518,860,23.5,1825.0,16,0,0,6,8,6,0,0,0,0,15732,6.6,16882,216,40,-2518,-860,21.6,1573.2
4503465904,1,18,4,1,10,2,8,2,1,1,0,18826,7.2,19835,259,52,5616,3916,25.9,1882.6,15,4,0,2,10,2,0,0,0,0,13210,6.6,15919,184,36,-5616,-3916,18.4,1321.0
4461233221,1,17,4,0,5,6,5,0,0,0,0,15951,6.8,17680,221,43,322,1046,22.1,1595.1,18,3,1,6,5,8,0,0,0,0,15629,6.8,16634,203,37,-322,-1046,20.3,1562.9
4523917327,1,15,2,0,16,10,17,2,1,1,0,20344,7.0,18646,193,48,3175,1975,19.3,2034.4,43,1,1,10,16,11,0,0,0,0,17169,6.6,16671,162,32,-3175,-1975,16.2,1716.9
4526244595,0,18,3,1,6,7,6,0,0,0,0,15786,6.8,16824,193,34,-1818,-2061,19.3,1578.6,19,2,0,7,6,4,1,1,0,0,17604,7.2,18885,246,61,1818,2061,24.6,1760.4
4450562955,1,22,3,1,7,0,8,1,1,0,0,18285,7.4,20035,259,52,4649,3488,25.9,1828.5,37,0,0,0,7,0,0,0,0,0,13636,6.4,16547,215,56,-4649,-3488,21.5,1363.6
4515845230,0,13,3,0,4,5,5,0,0,0,0,15610,7.0,18203,184,63,-215,155,18.4,1561.0,14,1,1,5,4,5,0,0,0,0,15825,7.0,18048,221,43,215,-155,22.1,1582.5
4493167660,0,86,5,0,3,7,3,0,0,0,0,14454,6.6,17394,191,46,-3003,-2118,19.1,1445.4,17,2,1,7,3,5,1,1,0,0,17457,7.4,19512,239,56,3003,2118,23.9,1745.7
4463389960,0,16,3,0,3,6,3,0,0,0,0,14906,6.6,16779,195,56,-1198,-599,19.5,1490.6,17,3,1,6,3,1,0,0,0,0,16104,6.8,17378,250,44,1198,599,25.0,1610.4
4515410950,0,13,1,0,4,5,6,0,0,0,0,16569,7.0,18534,228,52,77,-875,22.8,1656.9,13,1,1,5,4,6,1,1,0,0,16492,7.2,19409,246,60,-77,875,24.6,1649.2
4522545565,0,15,1,0,1,6,1,0,0,0,0,14555,6.8,17217,239,48,-1824,-613,23.9,1455.5,19,3,1,6,1,6,1,0,1,0,16379,7.0,17830,204,55,1824,613,20.4,1637.9
4485967051,0,15,3,0,2,6,3,0,0,0,0,14602,6.8,17042,208,54,-2185,-2480,20.8,1460.2,13,2,1,6,2,4,1,1,0,0,16787,7.2,19522,232,76,2185,2480,23.2,1678.7
4514736409,1,12,2,1,10,7,11,0,0,0,0,17938,6.8,17865,219,37,2161,1731,21.9,1793.8,15,1,0,7,10,6,1,1,0,0,15777,6.2,16134,195,55,-2161,-1731,19.5,1577.7
4477181015,0,18,4,1,7,9,5,0,0,0,0,17221,6.8,18291,229,54,194,1206,22.9,1722.1,123,2,0,9,7,8,1,1,0,0,17027,6.8,17085,213,44,-194,-1206,21.3,1702.7
4499786529,1,86,3,1,6,10,5,0,0,0,0,17040,7.0,17805,215,50,-545,-1102,21.5,1704.0,17,6,0,10,6,9,1,1,0,0,17585,7.0,18907,214,40,545,1102,21.4,1758.5
4458921343,0,15,0,0,9,2,9,1,0,1,0,17781,7.2,19251,228,60,3422,2271,22.8,1778.1,11,3,1,2,9,3,1,1,0,0,14359,6.6,16980,212,64,-3422,-2271,21.2,1435.9
4523899189,0,16,0,0,1,11,1,1,0,1,0,13199,6.2,15949,173,49,-6134,-4660,17.3,1319.9,15,1,1,11,1,13,0,0,0,0,19333,7.6,20609,255,54,6134,4660,25.5,1933.3
4477855283,1,18,2,1,15,7,17,1,1,0,1,20932,7.2,19304,233,48,4217,1384,23.3,2093.2,32,4,0,7,15,8,0,0,0,0,16715,7.0,17920,188,64,-4217,-1384,18.8,1671.5
4500949435,0,17,5,0,4,6,8,1,0,1,0,15922,7.0,17677,245,59,-1185,-1150,24.5,1592.2,17,4,1,6,4,7,1,1,0,0,17107,7.2,18827,236,48,1185,1150,23.6,1710.7
4445279107,0,16,3,0,6,14,4,0,0,0,0,14643,6.8,17028,154,49,-4073,-3038,15.4,1464.3,16,2,1,14,6,11,1,1,0,0,18716,7.4,20066,207,44,4073,3038,20.7,1871.6
4509889673,0,13,4,1,9,4,12,0,0,0,0,18105,7.0,18937,254,51,2627,1326,25.4,1810.5,38,3,0,4,9,2,0,0,0,0,15478,6.8,17611,216,56,-2627,-1326,21.6,1547.8
4492532758,1,13,4,0,4,7,3,0,0,0,0,15333,7.0,18073,201,68,-1942,57,20.1,1533.3,18,3,1,7,4,5,1,1,0,0,17275,6.8,18016,236,48,1942,-57,23.6,1727.5
4524703970,0,14,3,0,2,9,2,0,0,0,0,13545,6.4,15716,180,51,-4868,-4160,18.0,1354.5,16,1,1,9,2,12,1,1,0,0,18413,7.4,19876,242,47,4868,4160,24.2,1841.3
4468369355,1,18,1,0,6,5,5,1,1,0,0,16637,7.2,17981,215,60,370,212,21.5,1663.7,16,3,1,5,6,5,0,0,0,0,16267,7.0,17769,207,60,-370,-212,20.7,1626.7
4448406532,0,14,1,1,6,7,4,1,1,0,0,16103,6.8,18017,220,40,-90,-739,22.0,1610.3,14,3,0,7,6,5,0,0,0,0,16193,7.2,18756,205,37,90,739,20.5,1619.3
4460509130,1,17,1,0,9,9,7,0,0,0,0,18426,7.6,20198,240,63,380,-674,24.0,1842.6,39,4,1,9,9,6,1,1,0,0,18046,7.6,20872,211,64,-380,674,21.1,1804.6
4523411488,1,20,1,1,9,7,15,1,1,0,0,16541,6.6,16779,199,37,-146,-717,19.9,1654.1,12,3,0,7,9,8,1,0,1,0,16687,6.8,17496,225,44,146,717,22.5,1668.7
4498547016,1,85,3,1,13,4,13,1,1,0,0,18962,7.6,20021,207,48,3833,2849,20.7,1896.2,20,2,0,4,13,3,1,0,1,0,15129,6.8,17172,203,43,-3833,-2849,20.3,1512.9
4462808439,0,13,1,0,11,11,11,0,0,0,0,18496,7.0,17777,213,50,672,-1567,21.3,1849.6,9,3,1,11,11,6,1,1,0,0,17824,7.2,19344,216,54,-672,1567,21.6,1782.4
4523432307,1,13,4,0,4,7,6,0,0,0,0,16037,7.0,18122,231,58,-519,1292,23.1,1603.7,20,1,1,7,4,10,0,0,0,0,16556,6.6,16830,213,36,519,-1292,21.3,1655.6
4499806829,0,15,2,0,3,9,3,0,0,0,0,15002,6.6,16448,217,41,-3545,-3206,21.7,1500.2,39,2,1,9,3,10,2,1,1,0,18547,7.4,19654,224,55,3545,3206,22.4,1854.7
4519130933,1,19,2,0,9,5,10,1,1,0,0,17967,7.0,18521,209,52,3066,2798,20.9,1796.7,15,4,1,5,9,4,0,0,0,0,14901,6.4,15723,177,31,-3066,-2798,17.7,1490.1
4515245174,1,92,6,0,5,6,7,0,0,0,0,16161,7.0,18920,214,63,-167,855,21.4,1616.1,42,1,1,6,5,7,0,0,0,0,16328,7.2,18065,213,48,167,-855,21.3,1632.8
4479609510,0,14,3,1,3,7,4,0,0,0,0,15361,7.0,17290,235,55,-1226,-2432,23.5,1536.1,158,3,0,7,3,5,0,0,0,0,16587,7.4,19722,221,44,1226,2432,22.1,1658.7
4498316696,0,53,4,0,5,10,4,0,0,0,0,15649,7.0,17686,199,52,-2870,-2023,19.9,1564.9,15,0,1,10,5,14,1,1,0,0,18519,7.2,19709,229,60,2870,2023,22.9,1851.9
4474081068,1,88,2,0,4,3,4,0,0,0,0,17585,7.2,19376,270,55,3052,3581,27.0,1758.5,41,3,1,3,4,8,0,0,0,0,14533,6.6,15795,200,44,-3052,-3581,20.0,1453.3
4524503051,0,15,4,0,4,4,5,0,0,0,0,15741,7.0,18215,224,63,-425,-284,22.4,1574.1,14,3,1,4,4,5,1,1,0,0,16166,7.0,18499,228,56,425,284,22.8,1616.6
4513642822,0,14,7,0,5,7,13,2,1,1,0,16829,7.0,19002,251,64,-1212,972,25.1,1682.9,15,2,1,7,5,10,0,0,0,0,18041,7.0,18030,236,48,1212,-972,23.6,1804.1
4453231890,1,17,3,1,11,5,9,2,1,1,0,18532,7.6,19666,202,68,3248,2592,20.2,1853.2,14,5,0,5,11,6,0,0,0,0,15284,6.6,17074,164,57,-3248,-2592,16.4,1528.4
4524358757,1,83,3,0,9,8,12,1,1,0,0,17822,7.0,18329,209,44,-775,687,20.9,1782.2,15,2,1,8,9,8,0,0,0,1,18597,6.6,17642,219,44,775,-687,21.9,1859.7
4525534351,0,14,13,1,4,4,4,1,0,1,0,15749,7.4,19614,235,56,362,889,23.5,1574.9,37,3,0,4,4,2,1,1,0,0,15387,7.2,18725,226,59,-362,-889,22.6,1538.7
4517551883,0,14,0,0,3,5,5,0,0,0,0,14979,6.8,17163,203,52,-1968,-2932,20.3,1497.9,38,3,1,5,3,6,1,1,0,0,16947,7.2,20095,238,72,1968,2932,23.8,1694.7
4525978244,1,13,3,0,3,3,5,1,1,0,0,14697,6.6,16968,229,44,-780,-1068,22.9,1469.7,15,2,1,3,3,3,1,0,1,0,15477,7.0,18036,236,59,780,1068,23.6,1547.7
4527165791,0,17,8,1,8,8,12,0,0,0,0,16291,6.4,16508,180,33,-870,-1348,18.0,1629.1,34,5,0,8,8,11,1,1,0,0,17161,7.0,17856,207,46,870,1348,20.7,1716.1
4522857741,1,18,4,1,3,3,5,1,1,0,0,15200,6.8,17127,230,56,662,33,23.0,1520.0,15,4,0,3,3,3,0,0,0,0,14538,6.6,17094,202,47,-662,-33,20.2,1453.8
4494291164,0,17,1,0,6,4,7,0,0,0,0,16091,7.0,18518,238,38,356,122,23.8,1609.1,14,4,1,4,6,4,1,1,0,0,15735,7.0,18396,217,64,-356,-122,21.7,1573.5
4523956111,1,14,0,1,4,0,6,1,1,0,0,16070,7.2,19798,236,72,2170,2480,23.6,1607.0,13,0,0,0,4,0,0,0,0,0,13900,6.8,17318,240,48,-2170,-2480,24.0,1390.0
4521579265,1,17,1,0,3,4,4,0,0,0,0,15158,6.8,17197,236,47,-341,-1982,23.6,1515.8,18,3,1,4,3,5,2,1,1,0,15499,7.0,19179,219,56,341,1982,21.9,1549.9
4523437781,0,18,2,0,3,10,4,1,1,0,0,14878,6.4,16786,213,47,-4657,-4000,21.3,1487.8,39,4,1,10,3,11,0,0,0,1,19535,7.6,20786,244,56,4657,4000,24.4,1953.5
4519055084,0,23,1,0,8,14,12,2,1,1,0,16072,6.2,15157,170,28,-5540,-5343,17.0,1607.2,19,6,1,14,8,12,0,0,0,0,21612,7.6,20500,257,64,5540,5343,25.7,2161.2
4384388180,0,16,2,0,6,5,6,0,0,0,0,15691,7.0,17592,212,48,456,-69,21.2,1569.1,13,1,1,5,6,3,2,1,1,0,15235,6.8,17661,192,52,-456,69,19.2,1523.5
4471522569,1,18,3,0,8,6,6,2,1,1,0,17316,7.0,18199,206,68,767,796,20.6,1731.6,17,3,1,6,8,8,0,0,0,0,16549,6.8,17403,216,52,-767,-796,21.6,1654.9
4524015856,1,14,4,0,6,10,9,0,0,0,0,14711,6.4,15177,154,45,-2263,-2155,15.4,1471.1,17,2,1,10,6,11,1,1,0,0,16974,6.8,17332,196,40,2263,2155,19.6,1697.4
4527100931,0,16,2,0,3,5,5,0,0,0,0,15912,6.4,16609,236,40,1034,-973,23.6,1591.2,13,4,1,5,3,2,1,1,0,0,14878,6.8,17582,169,67,-1034,973,16.9,1487.8
4475233251,1,24,5,1,9,8,8,1,0,1,0,18321,6.8,18428,230,46,2788,558,23.0,1832.1,18,0,0,8,9,5,0,0,0,0,15533,6.6,17870,183,47,-2788,-558,18.3,1553.3
4459463690,1,15,6,0,4,4,5,1,1,0,0,15676,7.0,19069,231,61,-261,443,23.1,1567.6,59,1,1,4,4,8,1,0,1,0,15937,6.8,18626,231,56,261,-443,23.1,1593.7
4512067346,1,14,5,0,5,4,7,1,0,1,0,15644,6.8,17717,188,63,-3,1013,18.8,1564.4,20,3,1,4,5,7,0,0,0,0,15647,6.6,16704,190,48,3,-1013,19.0,1564.7
4498832228,1,18,1,0,4,4,4,1,0,1,0,15381,6.8,17303,198,56,202,686,19.8,1538.1,14,4,1,4,4,6,0,0,0,0,15179,6.6,16617,214,38,-202,-686,21.4,1517.9
4492137398,1,16,3,1,6,2,6,1,1,0,0,16605,6.8,17533,219,46,2086,360,21.9,1660.5,17,5,0,2,6,1,1,0,1,0,14519,6.6,17173,210,44,-2086,-360,21.0,1451.9
4490700723,0,18,5,1,3,3,3,0,0,0,0,14907,6.6,16847,205,50,-1021,-2152,20.5,1490.7,17,4,0,3,3,5,1,1,0,0,15928,7.2,18999,238,71,1021,2152,23.8,1592.8
4512807335,0,12,2,0,2,4,3,0,0,0,0,14593,6.6,17874,240,38,-1972,-1177,24.0,1459.3,12,2,1,4,2,5,0,0,0,0,16565,7.2,19051,253,64,1972,1177,25.3,1656.5
4476110397,0,18,1,1,7,10,9,1,0,1,0,16143,6.8,17196,181,55,-1694,-468,18.1,1614.3,14,2,0,10,7,16,1,1,0,0,17837,6.8,17664,200,56,1694,468,20.0,1783.7
4521263272,0,12,15,1,4,3,5,1,1,0,0,15694,6.8,17914,219,52,1074,237,21.9,1569.4,57,2,0,3,4,2,0,0,0,0,14620,6.8,17677,210,48,-1074,-237,21.0,1462.0
4470203201,0,128,5,1,7,8,8,1,0,1,0,16168,6.8,16435,193,44,-692,-736,19.3,1616.8,38,3,0,8,7,6,0,0,0,0,16860,6.8,17171,207,58,692,736,20.7,1686.0
4475361791,0,18,4,1,4,5,5,1,0,1,0,15481,6.6,17390,222,40,481,977,22.2,1548.1,19,3,0,5,4,8,1,1,0,0,15000,6.4,16413,199,51,-481,-977,19.9,1500.0
4507361840,1,13,2,1,5,0,4,1,1,0,0,16184,7.0,18007,223,51,2813,1222,22.3,1618.4,10,1,0,0,5,0,0,0,0,0,13371,6.6,16785,210,48,-2813,-1222,21.0,1337.1
4526838026,1,16,2,1,1,4,1,0,0,0,0,14761,7.0,17655,230,56,-294,-1277,23.0,1476.1,53,1,0,4,1,4,0,0,0,0,15055,7.2,18932,193,52,294,1277,19.3,1505.5
4524290277,1,26,2,1,7,7,5,1,1,0,0,17400,7.4,19175,239,64,567,-8,23.9,1740.0,67,0,0,7,7,10,0,0,0,0,16833,7.2,19183,237,56,-567,8,23.7,1683.3
4478851132,0,16,4,0,6,9,3,1,0,1,1,16840,7.2,18376,221,40,-990,-2014,22.1,1684.0,24,6,1,9,6,7,1,1,0,0,17830,7.4,20390,247,52,990,2014,24.7,1783.0
4507803144,0,17,2,0,2,9,2,0,0,0,0,13889,6.4,16133,200,52,-4479,-2696,20.0,1388.9,13,4,1,9,2,12,0,0,0,0,18368,7.0,18829,239,48,4479,2696,23.9,1836.8
4513054868,0,12,0,1,6,9,3,0,0,0,0,15896,6.8,17492,171,67,-1773,-422,17.1,1589.6,11,0,0,9,6,10,1,1,0,0,17669,6.8,17914,221,48,1773,422,22.1,1766.9
4523860316,0,29,5,0,6,8,10,0,0,0,0,17394,7.0,18465,213,68,-14,-776,21.3,1739.4,42,3,1,8,6,8,2,1,1,0,17408,7.2,19241,215,63,14,776,21.5,1740.8
4481332118,0,16,1,0,7,11,8,0,0,0,0,17151,6.8,17131,215,54,-2489,-2055,21.5,1715.1,14,1,1,11,7,18,1,1,0,0,19640,7.2,19186,205,65,2489,2055,20.5,1964.0
4525087986,1,21,5,1,10,3,11,1,0,1,0,18672,7.2,19616,243,44,3579,2473,24.3,1867.2,17,3,0,3,10,2,1,1,0,0,15093,6.8,17143,212,72,-3579,-2473,21.2,1509.3
4525121314,1,15,1,1,1,2,1,1,1,0,0,14392,6.6,17199,222,54,337,124,22.2,1439.2,13,2,0,2,1,2,0,0,0,0,14055,6.8,17075,197,52,-337,-124,19.7,1405.5
4523582436,1,16,1,0,5,2,6,0,0,0,0,15556,7.0,17886,219,44,1300,1228,21.9,1555.6,16,3,1,2,5,3,0,0,0,0,14256,6.6,16658,218,44,-1300,-1228,21.8,1425.6
4519427485,0,24,4,1,6,4,8,0,0,0,0,16505,6.8,17567,205,52,805,149,20.5,1650.5,13,8,0,4,6,4,1,1,0,0,15700,7.0,17418,256,44,-805,-149,25.6,1570.0
4523069290,1,24,2,1,6,5,3,0,0,0,0,16164,7.0,18306,226,63,113,-518,22.6,1616.4,15,3,0,5,6,9,1,1,0,0,16051,7.4,18824,223,52,-113,518,22.3,1605.1
4527487988,0,64,2,1,6,7,9,0,0,0,0,16054,6.6,17023,202,52,-849,-603,20.2,1605.4,15,4,0,7,6,7,1,1,0,0,16903,6.8,17626,215,46,849,603,21.5,1690.3
4439283192,0,18,4,0,4,9,4,1,1,0,0,15137,6.6,15969,206,38,-3447,-3324,20.6,1513.7,17,5,1,9,4,10,1,0,1,0,18584,7.2,19293,262,59,3447,3324,26.2,1858.4
4525145899,0,33,1,0,1,9,0,0,0,0,0,13933,6.6,16583,194,51,-5490,-2476,19.4,1393.3,18,2,1,9,1,8,1,1,0,1,19423,7.2,19059,225,52,5490,2476,22.5,1942.3
4490918171,0,16,3,0,2,9,0,0,0,0,0,14319,6.4,16192,210,56,-2914,-1623,21.0,1431.9,74,2,1,9,2,15,0,0,0,0,17233,6.8,17815,193,37,2914,1623,19.3,1723.3
4459950157,0,18,3,0,4,5,6,1,1,0,0,15871,6.8,17211,229,40,51,-1075,22.9,1587.1,17,5,1,5,4,2,0,0,0,0,15820,7.0,18286,216,52,-51,1075,21.6,1582.0
4520613359,0,18,2,0,2,2,2,0,0,0,0,15608,6.8,17516,260,47,766,331,26.0,1560.8,37,5,1,2,2,2,0,0,0,0,14842,7.0,17185,229,52,-766,-331,22.9,1484.2
4448363210,0,15,1,0,2,11,3,0,0,0,0,14773,6.6,16673,202,53,-4125,-2712,20.2,1477.3,17,6,1,11,2,11,1,1,0,0,18898,7.2,19385,237,50,4125,2712,23.7,1889.8
4502573246,1,17,1,0,5,4,7,0,0,0,0,16094,6.8,17711,219,41,956,1998,21.9,1609.4,15,1,1,4,5,4,0,0,0,0,15138,6.6,15713,183,36,-956,-1998,18.3,1513.8
4471214244,0,20,2,0,4,4,5,0,0,0,0,15465,6.8,17217,217,55,-398,-763,21.7,1546.5,13,2,1,4,4,1,1,1,0,0,15863,6.8,17980,249,52,398,763,24.9,1586.3
4524216210,1,15,3,0,12,5,12,1,1,0,0,19576,7.2,18210,236,50,4417,2933,23.6,1957.6,14,2,1,5,12,9,0,0,0,0,15159,6.2,15277,198,33,-4417,-2933,19.8,1515.9
4462392955,0,15,1,0,7,6,7,0,0,0,0,16726,7.0,18339,217,44,278,-343,21.7,1672.6,42,0,1,6,7,5,1,1,0,0,16448,7.0,18682,206,64,-278,343,20.6,1644.8
4523930264,1,17,6,0,11,4,14,0,0,0,1,19350,7.4,19830,234,39,4553,3000,23.4,1935.0,16,0,1,4,11,2,0,0,0,0,14797,6.4,16830,208,52,-4553,-3000,20.8,1479.7
4525934339,0,15,1,1,4,5,2,0,0,0,0,13933,6.4,16078,199,39,-2215,-1879,19.9,1393.3,17,1,0,5,4,6,2,1,1,0,16148,6.8,17957,212,48,2215,1879,21.2,1614.8
4525977517,1,16,5,0,6,4,6,1,1,0,0,15836,6.8,18034,216,43,75,-123,21.6,1583.6,14,3,1,4,6,1,0,0,0,0,15761,6.8,18157,254,38,-75,123,25.4,1576.1
4513511494,1,9,2,0,8,5,5,1,0,1,0,17875,7.2,20182,206,80,2095,1664,20.6,1787.5,10,3,1,5,8,3,1,1,0,0,15780,7.0,18518,215,60,-2095,-1664,21.5,1578.0
4521018486,0,18,1,0,7,5,2,0,0,0,0,15533,7.0,17431,186,48,147,582,18.6,1553.3,50,2,1,5,7,9,2,1,1,0,15386,6.6,16849,180,44,-147,-582,18.0,1538.6
4492081907,1,21,2,1,7,2,10,1,1,0,0,16867,7.2,18156,232,36,2474,1015,23.2,1686.7,149,2,0,2,7,2,0,0,0,0,14393,6.6,17141,230,52,-2474,-1015,23.0,1439.3
4508656599,0,13,1,0,3,5,4,0,0,0,0,14815,6.4,16969,221,42,-2541,-1921,22.1,1481.5,8,2,1,5,3,3,2,1,1,1,17356,7.0,18890,237,61,2541,1921,23.7,1735.6
4508573055,0,21,6,0,4,2,7,0,0,0,0,14866,6.8,17470,191,51,103,412,19.1,1486.6,21,6,1,2,4,3,1,0,1,0,14763,6.8,17058,239,41,-103,-412,23.9,1476.3
4518077809,0,17,4,1,11,6,12,1,1,0,0,18891,7.2,19302,235,50,3024,1980,23.5,1889.1,38,5,0,6,11,5,0,0,0,0,15867,7.0,17322,185,59,-3024,-1980,18.5,1586.7
4441428673,1,15,2,1,7,5,5,1,1,0,0,17541,7.2,19979,232,57,1764,2586,23.2,1754.1,17,1,0,5,7,7,0,0,0,0,15777,6.8,17393,208,49,-1764,-2586,20.8,1577.7
4450360531,0,15,2,1,14,4,15,1,1,0,0,19331,7.0,19211,213,46,4289,3990,21.3,1933.1,14,1,0,4,14,7,0,0,0,0,15042,6.4,15221,171,36,-4289,-3990,17.1,1504.2
4513746482,1,16,3,1,5,2,5,2,1,1,0,17665,7.4,19907,258,68,4520,5730,25.8,1766.5,9,1,0,2,5,0,0,0,0,0,13145,5.6,14177,210,29,-4520,-5730,21.0,1314.5
4511133368,0,12,1,1,7,9,5,0,0,0,0,16884,7.4,19682,220,67,-1474,-179,22.0,1688.4,11,3,0,9,7,8,1,1,0,0,18358,7.6,19861,228,60,1474,179,22.8,1835.8
4458282675,1,18,4,0,11,6,13,2,1,1,0,19677,7.6,20488,236,57,3977,3949,23.6,1967.7,36,5,1,6,11,12,0,0,0,0,15700,6.4,16539,208,32,-3977,-3949,20.8,1570.0
4524341789,1,15,7,1,11,3,12,1,1,0,1,20206,7.4,19702,221,52,6275,4789,22.1,2020.6,15,0,0,3,11,2,0,0,0,0,13931,6.2,14913,187,40,-6275,-4789,18.7,1393.1
4451994271,1,23,7,1,9,6,11,1,1,0,0,18152,7.0,18823,223,47,22,1773,22.3,1815.2,21,5,0,6,9,10,1,0,1,1,18130,6.6,17050,200,47,-22,-1773,20.0,1813.0
4508148812,1,15,2,0,6,6,8,1,1,0,0,16820,6.8,17746,221,44,472,426,22.1,1682.0,14,2,1,6,6,7,0,0,0,0,16348,6.8,17320,185,55,-472,-426,18.5,1634.8
4489610155,1,17,3,1,5,11,7,0,0,0,0,15897,6.8,17075,215,51,-3048,-3175,21.5,1589.7,35,4,0,11,5,8,1,1,0,0,18945,7.4,20250,245,48,3048,3175,24.5,1894.5
4519160523,1,41,4,1,8,9,10,1,1,0,0,16076,6.2,14942,181,42,143,-603,18.1,1607.6,12,0,0,9,8,18,0,0,0,0,15933,6.4,15545,178,32,-143,603,17.8,1593.3
4522459289,1,13,0,0,8,5,8,0,0,0,0,16982,7.2,19524,218,41,-212,1212,21.8,1698.2,12,2,1,5,8,10,2,1,1,0,17194,7.2,18312,242,59,212,-1212,24.2,1719.4
4526604474,0,17,3,0,1,5,1,1,0,1,0,14102,6.8,16463,211,56,-2031,-2540,21.1,1410.2,16,2,1,5,1,6,0,0,0,0,16133,7.0,19003,221,60,2031,2540,22.1,1613.3
4487355594,1,11,3,1,11,7,8,0,0,0,0,18288,7.4,19406,207,57,2616,3108,20.7,1828.8,12,0,0,7,11,9,1,1,0,0,15672,6.6,16298,177,44,-2616,-3108,17.7,1567.2
4452432602,0,18,2,0,5,6,4,0,0,0,0,14768,6.6,17244,157,64,-2337,-1158,15.7,1476.8,15,5,1,6,5,6,1,1,0,0,17105,7.2,18402,217,56,2337,1158,21.7,1710.5
4524396486,0,14,2,0,0,5,0,0,0,0,0,14211,6.6,17270,232,59,-3051,-2114,23.2,1421.1,21,6,1,5,0,3,2,1,1,1,17262,7.2,19384,250,55,3051,2114,25.0,1726.2
4496085988,0,18,2,1,4,2,5,0,0,0,0,16270,7.0,18684,248,60,454,333,24.8,1627.0,14,5,0,2,4,2,1,1,0,0,15816,7.0,18351,257,48,-454,-333,25.7,1581.6
4504366745,0,24,3,0,6,5,8,0,0,0,0,16809,7.4,19023,225,68,226,557,22.5,1680.9,52,4,1,5,6,7,2,1,1,0,16583,7.2,18466,239,64,-226,-557,23.9,1658.3
4506149588,1,18,3,1,13,3,13,1,0,1,0,18928,7.4,19725,227,55,4184,3694,22.7,1892.8,40,3,0,3,13,2,0,0,0,0,14744,6.6,16031,180,57,-4184,-3694,18.0,1474.4
4523495591,1,43,5,0,5,5,6,0,0,0,0,16419,6.8,17295,233,42,159,363,23.3,1641.9,15,1,1,5,5,5,2,1,1,0,16260,6.6,16932,194,68,-159,-363,19.4,1626.0
4467033955,1,15,5,1,8,4,7,1,0,1,0,18837,7.6,20066,246,48,3479,2657,24.6,1883.7,54,4,0,4,8,6,1,1,0,0,15358,6.8,17409,222,55,-3479,-2657,22.2,1535.8
4481963894,1,37,6,1,9,4,8,2,1,1,0,18591,7.4,20081,260,62,3105,2085,26.0,1859.1,37,2,0,4,9,5,0,0,0,0,15486,6.8,17996,208,70,-3105,-2085,20.8,1548.6
4522164881,0,42,2,1,5,3,1,1,1,0,0,15620,7.2,18429,187,72,896,1396,18.7,1562.0,17,2,0,3,5,2,0,0,0,0,14724,6.6,17033,227,54,-896,-1396,22.7,1472.4
4437082520,0,16,4,1,10,6,11,1,1,0,0,17538,7.0,19111,219,48,34,145,21.9,1753.8,16,2,0,6,10,6,0,0,0,0,17504,7.2,18966,225,68,-34,-145,22.5,1750.4
4465670561,1,35,6,1,13,1,18,1,1,0,0,19641,7.4,19614,207,57,6310,5136,20.7,1964.1,14,1,0,1,13,3,0,0,0,0,13331,6.0,14478,199,40,-6310,-5136,19.9,1333.1
4468469648,1,18,1,1,14,7,13,1,0,1,0,18802,6.8,18463,213,35,2393,675,21.3,1880.2,9,3,0,7,14,6,1,1,0,0,16409,6.8,17788,206,59,-2393,-675,20.6,1640.9
4472443604,0,16,3,0,5,13,8,0,0,0,0,15642,6.4,15825,214,35,-3811,-3107,21.4,1564.2,14,2,1,13,5,12,1,1,0,0,19453,7.2,18932,210,59,3811,3107,21.0,1945.3
4431814221,0,16,4,1,5,7,1,0,0,0,0,14991,7.0,17681,180,64,-2000,-1473,18.0,1499.1,16,3,0,7,5,6,1,1,0,0,16991,7.2,19154,208,62,2000,1473,20.8,1699.1
4486831645,1,17,1,0,6,2,6,1,1,0,0,15721,6.8,17894,203,48,1900,1732,20.3,1572.1,13,0,1,2,6,0,0,0,0,0,13821,6.4,16162,187,59,-1900,-1732,18.7,1382.1
4496714478,1,17,4,0,6,9,4,1,1,0,0,17048,7.2,18842,201,64,-32,848,20.1,1704.8,14,2,1,9,6,9,0,0,0,0,17080,7.0,17994,197,48,32,-848,19.7,1708.0
4473146660,0,13,9,0,3,9,5,0,0,0,0,14724,6.4,16015,218,42,-3541,-2434,21.8,1472.4,43,2,1,9,3,13,1,1,0,0,18265,6.8,18449,244,56,3541,2434,24.4,1826.5
4490764979,0,31,5,1,4,3,3,1,1,0,0,15876,7.0,18504,228,63,525,294,22.8,1587.6,22,3,0,3,4,2,0,0,0,0,15351,6.8,18210,227,48,-525,-294,22.7,1535.1
4456002030,0,16,2,1,6,5,4,1,1,0,0,17379,7.2,19080,251,64,1759,1710,25.1,1737.9,61,1,0,5,6,5,1,0,1,0,15620,6.8,17370,220,44,-1759,-1710,22.0,1562.0
4522381918,1,110,4,1,7,5,8,0,0,0,0,17088,7.0,18086,204,53,180,893,20.4,1708.8,36,2,0,5,7,9,2,1,1,0,16908,6.8,17193,230,54,-180,-893,23.0,1690.8
4510397182,0,17,4,1,11,4,8,1,0,1,0,17781,7.2,19581,225,45,2359,1828,22.5,1778.1,79,3,0,4,11,3,0,0,0,0,15422,6.8,17753,215,60,-2359,-1828,21.5,1542.2
4450546493,1,16,2,0,6,5,6,0,0,0,0,17342,7.2,19169,263,71,811,1501,26.3,1734.2,13,0,1,5,6,5,0,0,0,0,16531,6.6,17668,199,56,-811,-1501,19.9,1653.1
4526227889,1,16,3,0,2,5,1,0,0,0,0,14828,7.2,18224,234,60,-1402,-90,23.4,1482.8,16,1,1,5,2,10,1,1,0,0,16230,7.2,18314,230,65,1402,90,23.0,1623.0
4473361306,1,19,1,0,7,4,6,1,1,0,0,17493,7.0,18552,240,56,2851,1313,24.0,1749.3,11,2,1,4,7,4,0,0,0,0,14642,6.8,17239,198,54,-2851,-1313,19.8,1464.2
4460518084,1,11,3,1,9,7,7,0,0,0,0,18877,7.6,20418,244,67,3094,1999,24.4,1887.7,22,0,0,7,9,6,0,0,0,0,15783,7.2,18419,205,39,-3094,-1999,20.5,1578.3
4516105924,0,39,5,1,10,5,13,0,0,0,0,18866,7.4,19651,252,51,3412,2086,25.2,1886.6,18,3,0,5,10,8,0,0,0,0,15454,7.0,17565,207,49,-3412,-2086,20.7,1545.4
4517955952,1,21,2,1,8,9,8,0,0,0,0,16911,6.6,17768,207,52,-1165,729,20.7,1691.1,13,2,0,9,8,11,0,0,0,0,18076,6.6,17039,201,52,1165,-729,20.1,1807.6
4525106403,0,13,1,0,1,3,1,0,0,0,0,13991,6.8,17215,221,59,-1380,-581,22.1,1399.1,12,1,1,3,1,2,1,1,0,0,15371,7.0,17796,224,52,1380,581,22.4,1537.1
4526126466,0,15,0,1,5,6,5,1,0,1,1,18041,7.0,17904,229,52,1197,-947,22.9,1804.1,22,2,0,6,5,7,1,1,0,0,16844,7.4,18851,224,58,-1197,947,22.4,1684.4
4516104541,0,43,4,1,7,7,9,1,0,1,0,16342,6.8,17877,211,40,-2579,-1094,21.1,1634.2,35,3,0,7,7,6,1,1,0,1,18921,7.2,18971,238,81,2579,1094,23.8,1892.1
4515205200,0,14,4,1,4,3,2,1,0,1,0,16220,7.0,18251,239,54,688,415,23.9,1622.0,22,1,0,3,4,4,1,1,0,0,15532,7.0,17836,221,57,-688,-415,22.1,1553.2
4429490822,1,17,4,0,11,9,12,1,1,0,0,18585,7.2,19498,221,55,1139,1170,22.1,1858.5,14,0,1,9,11,9,0,0,0,0,17446,7.0,18328,218,54,-1139,-1170,21.8,1744.6
4526616225,1,35,1,1,10,4,8,1,1,0,0,17637,7.0,18484,198,64,2216,949,19.8,1763.7,15,1,0,4,10,2,1,0,1,0,15421,6.8,17535,236,39,-2216,-949,23.6,1542.1
4505381555,0,15,1,0,5,7,12,1,1,0,0,15218,6.4,16410,198,44,-2060,-2850,19.8,1521.8,18,1,1,7,5,6,0,0,0,0,17278,7.2,19260,240,47,2060,2850,24.0,1727.8
4526857610,1,42,3,1,10,5,5,0,0,0,0,18036,7.4,19849,243,54,2203,1534,24.3,1803.6,14,4,0,5,10,5,1,1,0,0,15833,7.0,18315,193,72,-2203,-1534,19.3,1583.3
4525971352,0,12,2,0,4,13,3,1,0,1,0,14157,6.0,15002,158,44,-3948,-4655,15.8,1415.7,15,1,1,13,4,5,1,1,0,0,18105,7.4,19657,243,68,3948,4655,24.3,1810.5
4508216792,1,13,3,0,8,8,8,0,0,0,0,18575,7.2,18686,228,42,1501,274,22.8,1857.5,15,2,1,8,8,7,0,0,0,0,17074,7.2,18412,219,43,-1501,-274,21.9,1707.4
4495005465,0,11,2,0,6,8,7,0,0,0,0,16924,6.8,17938,233,47,-465,-436,23.3,1692.4,81,1,1,8,6,10,0,0,0,0,17389,7.2,18374,214,42,465,436,21.4,1738.9
4524261959,1,16,3,0,5,10,5,0,0,0,0,15491,6.4,15893,194,45,-2183,-2010,19.4,1549.1,20,3,1,10,5,6,0,0,0,0,17674,6.8,17903,224,35,2183,2010,22.4,1767.4
4524739692,1,15,3,0,7,6,9,1,1,0,1,18551,7.2,18363,225,61,1850,834,22.5,1855.1,18,1,1,6,7,7,0,0,0,0,16701,7.0,17529,210,57,-1850,-834,21.0,1670.1
4512768961,1,17,18,0,3,3,5,1,1,0,0,15704,7.2,18700,240,74,928,955,24.0,1570.4,63,1,1,3,3,1,0,0,0,0,14776,7.0,17745,232,45,-928,-955,23.2,1477.6
4514848234,0,15,3,1,7,5,11,0,0,0,0,17467,7.2,19153,244,48,1299,879,24.4,1746.7,36,3,0,5,7,5,0,0,0,0,16168,7.0,18274,241,43,-1299,-879,24.1,1616.8
4482346658,1,17,4,1,5,1,6,1,1,0,0,18002,7.2,19467,254,76,3761,2092,25.4,1800.2,16,5,0,1,5,1,0,0,0,0,14241,6.8,17375,248,48,-3761,-2092,24.8,1424.1
4449670595,0,13,2,0,2,5,2,0,0,0,0,14673,7.2,18411,232,44,-2599,-818,23.2,1467.3,10,0,1,5,2,7,1,1,0,0,17272,7.0,19229,271,60,2599,818,27.1,1727.2
4465705901,0,17,3,0,6,13,5,1,1,0,0,17300,7.2,18747,229,68,-2604,-2089,22.9,1730.0,16,0,1,13,6,12,0,0,0,0,19904,7.6,20836,214,52,2604,2089,21.4,1990.4
4513892324,0,14,2,0,7,12,8,0,0,0,0,16804,6.6,16732,184,52,-1072,-646,18.4,1680.4,12,3,1,12,7,16,0,0,0,0,17876,7.0,17378,194,24,1072,646,19.4,1787.6
4483693148,1,22,3,1,13,5,15,1,0,1,0,18959,6.8,18151,186,56,2316,1298,18.6,1895.9,17,4,0,5,13,4,1,1,0,0,16643,6.6,16853,219,40,-2316,-1298,21.9,1664.3
4526781753,0,16,4,1,8,3,12,1,1,0,0,17479,7.2,19021,243,48,2143,1315,24.3,1747.9,17,5,0,3,8,4,0,0,0,0,15336,7.0,17706,203,44,-2143,-1315,20.3,1533.6
4481839538,0,12,1,1,6,9,5,1,1,0,0,16388,6.8,17753,213,40,-1436,-1406,21.3,1638.8,19,0,0,9,6,8,0,0,0,0,17824,7.2,19159,220,52,1436,1406,22.0,1782.4
4494851448,0,18,5,1,4,3,5,1,1,0,0,15449,6.8,17026,206,52,423,-315,20.6,1544.9,18,3,0,3,4,1,0,0,0,0,15026,6.6,17341,254,44,-423,315,25.4,1502.6
4524995677,0,16,4,1,6,8,2,1,1,0,0,15777,6.6,17401,224,53,-1370,-875,22.4,1577.7,20,2,0,8,6,9,0,0,0,0,17147,7.0,18276,210,36,1370,875,21.0,1714.7
4516653257,1,17,3,1,6,8,7,1,1,0,0,16006,6.8,17612,233,47,-1493,-1266,23.3,1600.6,16,4,0,8,6,11,0,0,0,0,17499,7.0,18878,247,36,1493,1266,24.7,1749.9
4516642389,1,17,4,0,7,7,7,0,0,0,0,16683,7.2,18315,231,48,-396,481,23.1,1668.3,11,2,1,7,7,5,2,1,1,0,17079,6.8,17834,246,42,396,-481,24.6,1707.9
4503216707,1,28,2,1,12,7,15,0,0,0,0,18193,6.6,16895,182,44,1083,554,18.2,1819.3,18,3,0,7,12,8,1,1,0,0,17110,6.8,16341,225,47,-1083,-554,22.5,1711.0
4510156433,0,15,3,0,9,7,10,0,0,0,0,17082,7.2,18101,223,36,188,-498,22.3,1708.2,15,1,1,7,9,11,1,1,0,0,16894,7.0,18599,215,72,-188,498,21.5,1689.4
4501238105,1,16,1,1,5,7,4,0,0,0,0,16324,7.0,18159,231,60,-330,55,23.1,1632.4,16,3,0,7,5,7,1,1,0,0,16654,7.0,18104,213,60,330,-55,21.3,1665.4
4521837052,1,19,1,0,5,9,7,0,0,0,0,15701,6.8,16610,186,60,-2760,-2274,18.6,1570.1,16,2,1,9,5,9,1,1,0,0,18461,7.2,18884,247,50,2760,2274,24.7,1846.1
4509755539,0,19,3,1,8,9,13,0,0,0,0,18038,7.0,18690,236,42,-22,86,23.6,1803.8,15,4,0,9,8,8,1,1,0,0,18060,7.0,18604,214,60,22,-86,21.4,1806.0
4526623923,1,17,2,1,8,4,8,1,1,0,0,16843,6.6,17489,204,40,2198,10,20.4,1684.3,17,2,0,4,8,3,1,0,1,0,14645,6.8,17479,206,43,-2198,-10,20.6,1464.5
4467393219,0,17,3,1,8,5,9,0,0,0,0,16736,7.2,18330,227,56,1271,531,22.7,1673.6,12,3,0,5,8,4,0,0,0,0,15465,7.0,17799,221,48,-1271,-531,22.1,1546.5
4489610844,0,17,4,0,4,13,3,0,0,0,0,15321,6.2,16450,198,44,-4562,-2816,19.8,1532.1,18,3,1,13,4,12,1,0,1,0,19883,7.2,19266,222,43,4562,2816,22.2,1988.3
4523634644,1,17,2,1,7,4,8,2,1,1,1,18858,7.2,19023,237,66,4338,4607,23.7,1885.8,17,3,0,4,7,11,0,0,0,0,14520,6.2,14416,166,42,-4338,-4607,16.6,1452.0
4523518605,1,15,3,1,4,5,5,2,1,1,0,15825,6.8,17561,225,58,460,-1107,22.5,1582.5,14,5,0,5,4,3,0,0,0,0,15365,7.0,18668,218,54,-460,1107,21.8,1536.5
4480357961,0,19,5,0,4,5,5,1,0,1,0,16318,6.6,17365,218,48,-326,315,21.8,1631.8,19,1,1,5,4,9,1,1,0,0,16644,6.8,17050,209,51,326,-315,20.9,1664.4
4459259003,1,19,4,1,10,1,7,0,0,0,0,18152,7.2,19147,233,47,4263,2953,23.3,1815.2,16,3,0,1,10,2,1,0,1,0,13889,6.6,16194,204,55,-4263,-2953,20.4,1388.9
4451891772,0,15,3,0,7,9,4,0,0,0,0,15002,6.4,15784,170,37,-3255,-1798,17.0,1500.2,14,4,1,9,7,10,1,1,0,0,18257,7.0,17582,240,46,3255,1798,24.0,1825.7
4495098102,1,39,3,1,10,6,12,2,1,1,1,19669,7.4,19333,220,62,4456,2338,22.0,1966.9,14,3,0,6,10,3,0,0,0,0,15213,6.6,16995,196,40,-4456,-2338,19.6,1521.3
4524748805,0,14,1,1,2,7,2,0,0,0,0,14377,7.0,17408,194,55,-3773,-3783,19.4,1437.7,14,1,0,7,2,8,1,1,0,0,18150,7.8,21191,258,52,3773,3783,25.8,1815.0
4444232401,1,11,3,0,5,6,6,1,1,0,0,15926,7.2,19262,223,63,-496,-837,22.3,1592.6,9,2,1,6,5,5,0,0,0,0,16422,7.4,20099,218,46,496,837,21.8,1642.2
4492085099,0,16,2,1,5,5,4,1,0,1,0,15745,6.8,17698,203,60,-859,361,20.3,1574.5,15,5,0,5,5,8,1,1,0,0,16604,6.8,17337,220,52,859,-361,22.0,1660.4
4476285822,0,15,4,0,4,4,7,1,1,0,0,15471,6.8,18216,220,57,-499,260,22.0,1547.1,16,1,1,4,4,4,0,0,0,0,15970,7.0,17956,252,44,499,-260,25.2,1597.0
4484505320,0,13,3,1,10,6,9,1,0,1,1,19793,7.4,19966,243,65,3387,1454,24.3,1979.3,54,2,0,6,10,9,1,1,0,0,16406,7.0,18512,239,50,-3387,-1454,23.9,1640.6
4517640142,1,16,2,1,10,7,9,0,0,0,0,17741,7.0,17857,208,48,2281,546,20.8,1774.1,12,4,0,7,10,5,1,1,0,0,15460,6.8,17311,183,57,-2281,-546,18.3,1546.0
4482519172,1,52,4,0,10,4,15,1,1,0,0,18501,7.6,19714,230,64,2907,2700,23.0,1850.1,12,0,1,4,10,6,0,0,0,0,15594,7.0,17014,215,55,-2907,-2700,21.5,1559.4
4498209347,1,29,2,1,3,3,2,2,1,1,0,15661,7.0,18396,225,64,-643,-1199,22.5,1566.1,15,3,0,3,3,5,0,0,0,0,16304,7.2,19595,256,71,643,1199,25.6,1630.4
4493432338,1,20,7,0,8,5,8,0,0,0,0,17109,7.2,18272,247,40,2006,2256,24.7,1710.9,17,4,1,5,8,7,0,0,0,0,15103,6.6,16016,200,36,-2006,-2256,20.0,1510.3
4470281902,1,17,1,1,8,6,11,0,0,0,0,17791,7.0,18244,216,48,1625,552,21.6,1779.1,16,2,0,6,8,9,1,1,0,0,16166,6.8,17692,215,48,-1625,-552,21.5,1616.6
4515910703,1,13,3,1,6,7,8,1,1,0,0,16682,6.8,17677,197,44,-970,-482,19.7,1668.2,18,4,0,7,6,8,0,0,0,0,17652,7.0,18159,227,43,970,482,22.7,1765.2
4515497599,1,17,4,1,14,3,16,0,0,0,0,20139,7.8,21898,218,56,5035,5420,21.8,2013.9,16,1,0,3,14,5,0,0,0,0,15104,6.6,16478,223,40,-5035,-5420,22.3,1510.4
4525945440,0,15,4,0,4,9,7,1,1,0,0,15315,7.0,17674,188,62,-2881,-981,18.8,1531.5,18,4,1,9,4,11,1,0,1,0,18196,7.0,18655,230,39,2881,981,23.0,1819.6
4520952711,0,21,2,0,4,10,4,0,0,0,0,14135,6.4,15854,182,48,-4416,-3186,18.2,1413.5,16,4,1,10,4,10,1,1,0,0,18551,7.4,19040,231,44,4416,3186,23.1,1855.1
4496994572,0,15,1,0,2,8,0,1,0,1,0,14591,6.8,17470,219,60,-2269,-1078,21.9,1459.1,34,4,1,8,2,7,1,1,0,0,16860,7.2,18548,223,42,2269,1078,22.3,1686.0
4478150249,1,17,0,1,9,8,12,1,0,1,0,17785,7.0,17509,202,49,1323,183,20.2,1778.5,33,0,0,8,9,6,1,1,0,0,16462,6.8,17326,181,60,-1323,-183,18.1,1646.2
4523826810,1,18,3,1,5,7,6,1,0,1,0,16407,6.8,18597,217,61,-450,127,21.7,1640.7,19,4,0,7,5,7,1,1,0,0,16857,7.0,18470,223,48,450,-127,22.3,1685.7
4472723293,0,15,2,0,7,5,11,0,0,0,0,16230,6.6,16813,181,52,-30,-965,18.1,1623.0,13,3,1,5,7,5,0,0,0,0,16260,6.8,17778,231,51,30,965,23.1,1626.0
4495034675,1,17,5,1,8,3,4,0,0,0,0,17058,6.8,16737,207,40,2559,806,20.7,1705.8,17,2,0,3,8,4,0,0,0,0,14499,6.4,15931,196,51,-2559,-806,19.6,1449.9
4519227071,1,14,2,0,6,8,4,1,0,1,0,16075,7.0,18425,211,60,-1374,-653,21.1,1607.5,16,5,1,8,6,8,1,1,0,0,17449,7.2,19078,237,43,1374,653,23.7,1744.9
4484124501,1,15,2,1,6,3,5,1,1,0,0,16523,7.0,18465,238,43,1284,1445,23.8,1652.3,15,5,0,3,6,2,0,0,0,0,15239,6.8,17020,239,56,-1284,-1445,23.9,1523.9
4500406519,1,18,4,1,4,7,2,0,0,0,0,15950,6.8,17900,235,58,-365,-434,23.5,1595.0,16,2,0,7,4,7,0,0,0,0,16315,6.8,18334,225,37,365,434,22.5,1631.5
4442047258,1,16,4,1,4,5,1,1,1,0,0,15855,7.0,18078,238,56,145,972,23.8,1585.5,17,3,0,5,4,7,0,0,0,0,15710,6.6,17106,224,36,-145,-972,22.4,1571.0
4505535527,0,16,5,0,3,9,3,0,0,0,0,15365,6.8,17435,221,55,-2450,-1150,22.1,1536.5,18,3,1,9,3,12,0,0,0,0,17815,7.2,18585,233,40,2450,1150,23.3,1781.5
4494742887,0,16,4,0,9,12,16,0,0,0,0,18633,6.8,18367,246,47,-1428,-433,24.6,1863.3,17,5,1,12,9,10,2,1,1,1,20061,7.2,18800,223,48,1428,433,22.3,2006.1
4502951007,1,15,2,1,8,2,10,0,0,0,0,17620,6.8,17878,236,41,2978,-438,23.6,1762.0,16,4,0,2,8,4,0,0,0,0,14642,7.2,18316,180,67,-2978,438,18.0,1464.2
4510669368,0,53,1,0,6,10,6,1,0,1,0,15485,6.8,17138,193,50,-2854,-2798,19.3,1548.5,13,2,1,10,6,9,0,0,0,0,18339,7.4,19936,225,52,2854,2798,22.5,1833.9
4474783005,0,16,2,0,6,5,6,0,0,0,0,16496,7.0,18365,244,48,120,1543,24.4,1649.6,19,0,1,5,6,14,1,1,0,0,16376,6.6,16822,206,70,-120,-1543,20.6,1637.6
4524645107,0,18,2,0,4,5,4,0,0,0,0,16195,7.2,18670,241,64,-339,-868,24.1,1619.5,12,4,1,5,4,4,1,1,0,0,16534,7.4,19538,259,59,339,868,25.9,1653.4
4515598035,1,18,6,1,4,4,7,1,1,0,0,15550,7.0,18512,221,64,-44,73,22.1,1555.0,41,4,0,4,4,5,0,0,0,0,15594,7.0,18439,216,48,44,-73,21.6,1559.4
4298874562,1,22,2,1,6,6,4,0,0,0,0,16192,7.0,18524,218,59,34,985,21.8,1619.2,15,2,0,6,6,7,1,1,0,0,16158,6.8,17539,209,41,-34,-985,20.9,1615.8
4508119465,0,15,2,1,11,11,13,0,0,0,0,18575,7.2,18974,198,49,-204,1350,19.8,1857.5,39,2,0,11,11,10,1,1,0,1,18779,6.8,17624,211,36,204,-1350,21.1,1877.9
4524012656,0,17,2,1,5,8,4,0,0,0,0,16568,7.0,18504,239,51,-1163,-1130,23.9,1656.8,30,5,0,8,5,11,1,1,0,0,17731,7.4,19634,223,72,1163,1130,22.3,1773.1
4525085237,1,12,1,1,2,5,1,1,1,0,0,14936,7.2,17688,231,53,-1543,-509,23.1,1493.6,14,2,0,5,2,8,0,0,0,0,16479,7.0,18197,250,40,1543,509,25.0,1647.9
4492594471,0,33,4,1,5,7,6,1,1,0,0,15534,7.0,17293,207,44,-1109,-1493,20.7,1553.4,87,1,0,7,5,4,0,0,0,0,16643,7.2,18786,223,47,1109,1493,22.3,1664.3
4510862255,1,21,0,1,11,9,10,1,1,0,0,17307,6.6,16527,161,42,-224,-765,16.1,1730.7,107,3,0,9,11,9,0,0,0,0,17531,6.8,17292,210,30,224,765,21.0,1753.1
4508860669,0,40,5,1,7,2,10,1,0,1,0,17536,7.4,19146,211,63,4003,3255,21.1,1753.6,16,1,0,2,7,1,0,0,0,0,13533,6.4,15891,204,48,-4003,-3255,20.4,1353.3
4459418166,0,15,4,0,9,6,8,0,0,0,0,17807,7.4,19554,229,46,1233,336,22.9,1780.7,80,1,1,6,9,5,2,1,1,0,16574,7.4,19218,197,53,-1233,-336,19.7,1657.4
4503585743,0,13,0,0,4,3,5,0,0,0,0,15260,7.0,17619,191,59,323,701,19.1,1526.0,89,2,1,3,4,0,2,1,1,0,14937,6.6,16918,212,52,-323,-701,21.2,1493.7
4510752222,0,16,0,0,2,10,1,0,0,0,0,13268,6.2,15564,170,47,-7839,-3333,17.0,1326.8,14,5,1,10,2,12,2,1,1,2,21107,7.2,18897,253,43,7839,3333,25.3,2110.7
4493734272,1,21,1,0,2,5,1,0,0,0,0,15337,7.2,18920,235,72,-1676,-532,23.5,1533.7,19,4,1,5,2,8,0,0,0,0,17013,7.4,19452,228,63,1676,532,22.8,1701.3
4524121467,1,14,2,1,8,2,15,0,0,0,0,18257,7.0,18323,209,49,4340,1841,20.9,1825.7,26,1,0,2,8,2,0,0,0,0,13917,6.6,16482,194,46,-4340,-1841,19.4,1391.7
4521874252,1,14,5,0,4,5,5,0,0,0,0,15281,6.6,16663,211,62,-736,-1526,21.1,1528.1,18,1,1,5,4,4,1,1,0,0,16017,7.0,18189,229,53,736,1526,22.9,1601.7
4472381222,0,18,2,0,9,8,12,0,0,0,0,18004,7.4,20025,251,46,-305,685,25.1,1800.4,19,4,1,8,9,8,1,1,0,0,18309,7.2,19340,249,64,305,-685,24.9,1830.9
4524877536,1,13,4,0,7,8,6,1,1,0,0,17002,7.0,17795,221,51,-154,-612,22.1,1700.2,19,4,1,8,7,4,1,0,1,0,17156,7.0,18407,225,48,154,612,22.5,1715.6
4517803168,1,20,3,1,13,6,12,0,0,0,0,19012,7.2,18944,210,54,2194,1814,21.0,1901.2,19,2,0,6,13,9,0,0,0,0,16818,6.8,17130,195,49,-2194,-1814,19.5,1681.8
4516598704,1,17,6,0,4,5,1,0,0,0,0,14837,6.8,17198,205,52,-576,-1318,20.5,1483.7,26,2,1,5,4,8,1,1,0,0,15413,7.2,18516,172,60,576,1318,17.2,1541.3
4500724554,0,17,4,0,3,13,3,0,0,0,0,14467,6.6,16331,209,44,-5563,-4698,20.9,1446.7,18,2,1,13,3,8,2,1,1,0,20030,7.6,21029,235,70,5563,4698,23.5,2003.0
4520641645,0,25,3,0,6,1,8,1,1,0,0,16129,7.2,18567,210,48,2279,2842,21.0,1612.9,17,2,1,1,6,1,0,0,0,0,13850,6.4,15725,205,39,-2279,-2842,20.5,1385.0
4461412010,1,13,1,1,6,1,2,1,1,0,0,17091,7.2,19482,229,64,2805,2754,22.9,1709.1,24,4,0,1,6,1,0,0,0,0,14286,6.6,16728,235,45,-2805,-2754,23.5,1428.6
4519727542,1,14,1,0,8,7,9,0,0,0,0,17793,7.0,19086,208,77,1300,3056,20.8,1779.3,23,3,1,7,8,12,1,1,0,0,16493,6.4,16030,221,42,-1300,-3056,22.1,1649.3
4524704735,1,20,3,0,4,2,4,0,0,0,0,16568,6.8,18658,242,56,1840,1870,24.2,1656.8,14,4,1,2,4,2,0,0,0,0,14728,6.6,16788,240,43,-1840,-1870,24.0,1472.8
4513544189,0,15,0,0,2,8,2,0,0,0,0,12292,5.8,13648,152,36,-9341,-6317,15.2,1229.2,15,1,1,8,2,11,1,0,1,2,21633,7.4,19965,239,84,9341,6317,23.9,2163.3
4515839148,1,20,3,1,7,8,5,0,0,0,0,16396,7.2,18362,209,36,-389,-29,20.9,1639.6,13,2,0,8,7,10,1,1,0,0,16785,7.0,18391,213,51,389,29,21.3,1678.5
4491503560,1,20,2,0,11,7,12,0,0,0,0,17649,7.2,18664,187,42,604,1983,18.7,1764.9,16,1,1,7,11,8,1,1,0,0,17045,6.6,16681,187,62,-604,-1983,18.7,1704.5
4454844515,0,88,3,0,7,11,10,0,0,0,0,17130,7.0,18060,232,36,-1553,-424,23.2,1713.0,17,3,1,11,7,16,1,1,0,0,18683,7.0,18484,247,43,1553,424,24.7,1868.3
4491961923,1,14,2,0,4,7,2,0,0,0,0,15825,7.0,18247,235,54,-306,-953,23.5,1582.5,37,3,1,7,4,7,1,1,0,0,16131,7.4,19200,227,45,306,953,22.7,1613.1
4526215462,0,16,4,1,5,6,8,0,0,0,0,15703,6.6,17085,195,53,-1085,-1869,19.5,1570.3,15,4,0,6,5,5,2,1,1,0,16788,7.2,18954,229,48,1085,1869,22.9,1678.8
4492936245,0,40,3,0,1,7,1,0,0,0,0,13325,6.6,16064,171,52,-3573,-2497,17.1,1332.5,18,3,1,7,1,12,2,1,1,0,16898,7.2,18561,230,51,3573,2497,23.0,1689.8
4512246178,1,23,3,1,11,5,6,2,1,1,1,20151,7.4,20475,261,72,4296,3034,26.1,2015.1,17,0,0,5,11,9,0,0,0,0,15855,6.8,17441,173,75,-4296,-3034,17.3,1585.5
4516127508,1,39,3,0,6,2,6,2,1,1,0,15897,6.8,18168,188,68,1433,522,18.8,1589.7,18,2,1,2,6,1,0,0,0,0,14464,6.8,17646,215,51,-1433,-522,21.5,1446.4
4524546153,0,16,6,1,5,5,5,0,0,0,0,16051,6.8,16995,235,48,-290,-1061,23.5,1605.1,17,6,0,5,5,7,1,1,0,0,16341,6.8,18056,245,35,290,1061,24.5,1634.1
4523062403,1,15,2,1,11,6,16,0,0,0,0,19563,7.2,19145,220,60,4666,4288,22.0,1956.3,17,0,0,6,11,12,0,0,0,0,14897,6.2,14857,155,32,-4666,-4288,15.5,1489.7
4463256999,1,14,2,1,11,5,11,0,0,0,0,18180,7.0,18464,190,47,2575,1454,19.0,1818.0,33,1,0,5,11,6,1,1,0,0,15605,6.6,17010,203,48,-2575,-1454,20.3,1560.5
4515242299,1,13,3,0,4,10,1,0,0,0,0,16172,6.8,18087,219,69,-1867,555,21.9,1617.2,17,1,1,10,4,18,0,0,0,0,18039,6.8,17532,202,60,1867,-555,20.2,1803.9
4523383919,1,36,0,1,7,5,5,2,1,1,0,17538,7.4,19556,229,71,1652,1714,22.9,1753.8,12,4,0,5,7,4,0,0,0,0,15886,6.8,17842,209,48,-1652,-1714,20.9,1588.6
4438396733,1,17,3,1,12,5,14,1,1,0,0,18499,7.0,17823,210,36,3473,2812,21.0,1849.9,15,1,0,5,12,6,0,0,0,0,15026,6.2,15011,204,20,-3473,-2812,20.4,1502.6
4514051378,1,12,4,0,11,9,11,1,1,0,0,17774,7.0,18440,180,49,-76,1386,18.0,1777.4,19,0,1,9,11,9,0,0,0,0,17850,6.8,17054,190,60,76,-1386,19.0,1785.0
4476906757,1,20,8,1,2,2,1,0,0,0,0,14814,7.0,18414,233,60,500,1220,23.3,1481.4,20,5,0,2,2,5,1,0,1,0,14314,6.8,17194,213,48,-500,-1220,21.3,1431.4
4463159840,0,19,1,1,7,4,11,1,0,1,0,16782,7.2,19169,213,56,299,874,21.3,1678.2,16,4,0,4,7,3,0,0,0,0,16483,7.0,18295,230,56,-299,-874,23.0,1648.3
4518963809,1,12,4,1,9,8,10,0,0,0,0,17216,6.6,17264,207,48,1462,1290,20.7,1721.6,39,4,0,8,9,9,0,0,0,0,15754,6.4,15974,165,39,-1462,-1290,16.5,1575.4
4470118865,0,15,3,0,1,4,0,0,0,0,0,14928,7.0,18640,229,81,-360,331,22.9,1492.8,13,5,1,4,1,2,1,1,0,0,15288,7.0,18309,213,46,360,-331,21.3,1528.8
4526224124,1,12,6,1,8,2,8,1,1,0,0,18477,7.2,19589,248,51,3593,1136,24.8,1847.7,19,1,0,2,8,0,0,0,0,0,14884,7.0,18453,236,64,-3593,-1136,23.6,1488.4
4461974957,1,34,1,0,5,10,5,0,0,0,0,16297,7.2,19135,212,66,-2523,-1057,21.2,1629.7,15,1,1,10,5,10,0,0,0,0,18820,7.4,20192,236,60,2523,1057,23.6,1882.0
4492401281,0,14,2,1,7,4,5,2,1,1,0,17111,7.0,17761,231,48,1318,764,23.1,1711.1,16,0,0,4,7,4,0,0,0,0,15793,6.8,16997,226,42,-1318,-764,22.6,1579.3
4473304091,0,37,4,0,3,4,3,0,0,0,0,14788,7.0,17425,227,46,-1605,-1335,22.7,1478.8,18,2,1,4,3,4,0,0,0,0,16393,7.2,18760,252,54,1605,1335,25.2,1639.3
4467692885,0,17,1,0,5,7,4,0,0,0,0,15460,6.6,16868,184,56,-1946,-1148,18.4,1546.0,17,0,1,7,5,8,0,0,0,0,17406,7.0,18016,250,59,1946,1148,25.0,1740.6
4446200696,0,15,1,0,5,7,5,1,0,1,1,17618,7.2,19203,225,63,1000,346,22.5,1761.8,11,3,1,7,5,7,1,1,0,0,16618,7.0,18857,199,52,-1000,-346,19.9,1661.8
4436503508,1,18,3,1,12,3,17,2,1,1,1,21016,7.4,20144,272,59,5512,3244,27.2,2101.6,50,1,0,3,12,6,0,0,0,0,15504,6.6,16900,212,56,-5512,-3244,21.2,1550.4
4527098797,1,84,3,0,5,9,7,0,0,0,0,15791,7.0,17342,192,57,-1892,-580,19.2,1579.1,11,1,1,9,5,12,0,0,0,0,17683,7.2,17922,205,40,1892,580,20.5,1768.3
4526260157,1,19,3,0,5,4,5,1,1,0,0,16250,7.2,18390,208,68,1170,1415,20.8,1625.0,17,4,1,4,5,5,0,0,0,0,15080,6.6,16975,205,36,-1170,-1415,20.5,1508.0
4524802127,1,22,3,1,8,6,6,0,0,0,0,16820,6.8,17719,223,39,439,-524,22.3,1682.0,11,4,0,6,8,4,1,1,0,0,16381,7.0,18243,214,64,-439,524,21.4,1638.1
4519770095,0,9,2,1,10,10,11,2,1,1,1,19556,7.2,18530,198,53,2100,1556,19.8,1955.6,16,2,0,10,10,11,0,0,0,0,17456,6.8,16974,189,47,-2100,-1556,18.9,1745.6
4521420506,0,11,4,1,6,9,10,0,0,0,0,15451,6.4,16217,188,35,-1679,-1569,18.8,1545.1,24,4,0,9,6,10,2,1,1,0,17130,7.2,17786,188,48,1679,1569,18.8,1713.0
4524732459,0,19,3,1,7,9,10,0,0,0,0,17033,6.8,16630,209,45,-462,-1186,20.9,1703.3,18,5,0,9,7,9,0,0,0,0,17495,7.0,17816,213,43,462,1186,21.3,1749.5
4499668279,0,18,1,0,8,5,7,1,1,0,0,16860,7.2,18713,198,71,-147,21,19.8,1686.0,14,1,1,5,8,5,0,0,0,0,17007,7.2,18692,257,56,147,-21,25.7,1700.7
4515399183,1,17,0,1,6,9,5,2,1,1,0,16149,6.8,16641,199,52,34,-957,19.9,1614.9,34,3,0,9,6,9,0,0,0,0,16115,6.8,17598,184,28,-34,957,18.4,1611.5
4520974128,1,13,2,1,8,5,10,1,1,0,0,17667,7.4,19486,237,48,2461,1779,23.7,1766.7,15,2,0,5,8,6,0,0,0,0,15206,6.8,17707,217,36,-2461,-1779,21.7,1520.6
4496877385,0,18,2,1,9,8,9,1,1,0,0,18096,6.8,17875,213,48,1827,972,21.3,1809.6,18,4,0,8,9,14,1,0,1,0,16269,6.8,16903,167,56,-1827,-972,16.7,1626.9
4477402246,0,15,3,0,2,4,2,2,1,1,0,15197,7.0,17925,233,64,-1519,-1363,23.3,1519.7,16,5,1,4,2,4,0,0,0,0,16716,7.2,19288,245,63,1519,1363,24.5,1671.6
4519577076,0,19,3,0,8,12,12,0,0,0,0,18501,6.8,17881,207,60,-939,-2597,20.7,1850.1,74,2,1,12,8,15,1,1,0,0,19440,7.2,20478,214,52,939,2597,21.4,1944.0
4518840906,0,9,2,0,1,14,1,0,0,0,0,12598,6.0,14826,204,20,-7070,-4989,20.4,1259.8,49,0,1,14,1,15,0,0,0,0,19668,7.4,19815,220,39,7070,4989,22.0,1966.8
4522140557,1,13,1,1,2,4,1,1,1,0,0,14804,7.0,17557,233,48,-944,-1054,23.3,1480.4,18,0,0,4,2,5,0,0,0,0,15748,7.0,18611,222,68,944,1054,22.2,1574.8
4527842983,1,38,2,0,6,7,10,1,1,0,0,17071,7.2,19207,245,58,374,1465,24.5,1707.1,13,6,1,7,6,10,0,0,0,0,16697,6.8,17742,209,36,-374,-1465,20.9,1669.7
4523099371,1,15,0,0,6,6,6,1,1,0,0,15738,7.0,17430,206,52,-360,-708,20.6,1573.8,18,2,1,6,6,1,1,0,1,0,16098,7.0,18138,230,60,360,708,23.0,1609.8
4496624699,1,17,3,0,6,14,4,0,0,0,0,15786,6.6,16995,200,46,-4443,-4140,20.0,1578.6,16,3,1,14,6,9,1,1,0,0,20229,7.6,21135,227,66,4443,4140,22.7,2022.9
4524077612,1,12,1,0,6,6,2,1,0,1,1,16753,6.8,17350,190,61,1936,1799,19.0,1675.3,10,0,1,6,6,3,1,1,0,0,14817,6.0,15551,190,57,-1936,-1799,19.0,1481.7
4520783162,1,15,2,0,2,3,2,2,1,1,0,14815,6.8,18140,246,56,-980,-1488,24.6,1481.5,14,4,1,3,2,0,0,0,0,0,15795,7.4,19628,259,62,980,1488,25.9,1579.5
4521730621,1,16,2,1,6,3,7,1,0,1,0,16691,7.4,19203,226,60,1814,1762,22.6,1669.1,12,2,0,3,6,3,0,0,0,0,14877,6.8,17441,214,55,-1814,-1762,21.4,1487.7
4470700063,0,22,6,1,3,8,4,0,0,0,0,15032,6.8,16226,221,48,-2798,-2403,22.1,1503.2,17,3,0,8,3,5,2,1,1,1,17830,7.0,18629,215,60,2798,2403,21.5,1783.0
4518362407,1,14,4,1,11,5,5,2,1,1,1,19172,7.0,18959,242,52,3456,3233,24.2,1917.2,18,5,0,5,11,5,0,0,0,0,15716,6.4,15726,197,52,-3456,-3233,19.7,1571.6
4521300478,0,42,4,1,9,6,7,0,0,0,0,18446,7.4,19613,216,60,2200,1607,21.6,1844.6,13,2,0,6,9,8,1,1,0,0,16246,6.8,18006,218,56,-2200,-1607,21.8,1624.6
4510669887,1,39,3,0,1,2,0,1,1,0,0,14645,7.2,18690,256,52,-1377,-180,25.6,1464.5,49,3,1,2,1,2,1,0,1,0,16022,7.2,18870,289,56,1377,180,28.9,1602.2
4526360728,0,13,6,0,4,7,2,0,0,0,0,15188,6.8,17740,194,69,-1269,-1991,19.4,1518.8,19,2,1,7,4,5,1,0,1,0,16457,7.2,19731,213,67,1269,1991,21.3,1645.7
4419234240,1,13,5,1,9,2,13,1,1,0,0,19079,7.4,20020,249,59,4371,2705,24.9,1907.9,21,1,0,2,9,2,0,0,0,0,14708,6.8,17315,237,39,-4371,-2705,23.7,1470.8
4493017629,1,21,3,1,4,4,3,0,0,0,0,16297,6.8,17730,237,62,1772,1255,23.7,1629.7,17,1,0,4,4,4,0,0,0,0,14525,6.6,16475,202,36,-1772,-1255,20.2,1452.5
4514596262,0,46,5,0,2,7,2,0,0,0,0,14242,6.6,17184,212,50,-2954,-1250,21.2,1424.2,15,5,1,7,2,3,1,0,1,0,17196,7.0,18434,244,52,2954,1250,24.4,1719.6
4457376464,1,95,10,0,6,4,9,0,0,0,0,16641,7.2,18364,213,60,1446,446,21.3,1664.1,59,2,1,4,6,3,1,1,0,0,15195,7.0,17918,218,59,-1446,-446,21.8,1519.5
4520706769,0,55,2,1,9,6,8,1,1,0,0,17698,7.2,19290,206,56,726,1104,20.6,1769.8,15,3,0,6,9,5,0,0,0,0,16972,6.8,18186,229,52,-726,-1104,22.9,1697.2
4514363015,0,16,2,1,4,8,5,1,1,0,0,15179,6.8,16562,220,49,-2967,-4209,22.0,1517.9,43,2,0,8,4,7,0,0,0,0,18146,7.6,20771,266,54,2967,4209,26.6,1814.6
4477077306,0,15,4,0,8,8,11,0,0,0,0,17911,6.8,17981,218,40,1014,688,21.8,1791.1,15,3,1,8,8,12,1,0,1,0,16897,6.6,17293,191,47,-1014,-688,19.1,1689.7
4524451001,1,17,4,1,8,8,10,0,0,0,0,15996,6.2,15159,185,36,-2523,-2980,18.5,1599.6,16,8,0,8,8,10,1,0,1,0,18519,6.8,18139,231,40,2523,2980,23.1,1851.9
4499239181,1,19,0,0,4,14,5,1,0,1,0,14450,6.4,15560,186,48,-5976,-4619,18.6,1445.0,13,3,1,14,4,14,1,1,0,0,20426,7.4,20179,264,33,5976,4619,26.4,2042.6
4505103694,1,70,2,0,10,5,11,2,1,1,0,18526,7.4,19693,222,65,1924,1992,22.2,1852.6,11,2,1,5,10,7,0,0,0,0,16602,7.0,17701,240,42,-1924,-1992,24.0,1660.2
4485581328,1,18,3,0,5,5,3,1,0,1,0,16009,7.2,19116,206,45,565,2073,20.6,1600.9,21,3,1,5,5,4,0,0,0,0,15444,6.8,17043,218,49,-565,-2073,21.8,1544.4
4493993749,0,18,1,0,2,9,3,1,1,0,0,14547,6.6,16366,212,48,-5367,-3464,21.2,1454.7,29,1,1,9,2,9,1,0,1,1,19914,7.2,19830,238,60,5367,3464,23.8,1991.4
4509513084,1,15,3,1,7,6,7,1,1,0,0,17120,7.0,18447,205,55,860,284,20.5,1712.0,16,2,0,6,7,8,0,0,0,0,16260,7.2,18163,200,48,-860,-284,20.0,1626.0
4424144387,0,19,5,1,4,5,4,0,0,0,0,14850,6.8,17145,198,53,-1037,-1577,19.8,1485.0,18,4,0,5,4,5,1,1,0,0,15887,7.0,18722,241,44,1037,1577,24.1,1588.7
4525626053,0,12,2,1,2,2,2,1,0,1,0,15167,6.8,18214,244,43,7,-659,24.4,1516.7,38,4,0,2,2,3,0,0,0,0,15160,7.2,18873,242,56,-7,659,24.2,1516.0
4518749206,1,17,3,1,5,3,5,1,1,0,0,16766,7.2,18841,232,68,1399,554,23.2,1676.6,36,4,0,3,5,5,0,0,0,0,15367,7.0,18287,240,36,-1399,-554,24.0,1536.7
4515501077,0,14,2,1,7,9,6,0,0,0,0,17075,7.2,18691,230,52,-1075,-1160,23.0,1707.5,11,2,0,9,7,10,1,1,0,0,18150,7.2,19851,232,74,1075,1160,23.2,1815.0
4516532233,0,17,0,0,2,13,1,0,0,0,0,14504,6.6,16668,203,58,-3966,-3112,20.3,1450.4,16,4,1,13,2,14,1,1,0,0,18470,7.4,19780,192,53,3966,3112,19.2,1847.0
4491903202,0,18,3,1,10,9,15,1,1,0,1,19120,6.8,17735,219,55,1618,393,21.9,1912.0,19,2,0,9,10,10,0,0,0,0,17502,6.8,17342,207,46,-1618,-393,20.7,1750.2
4460927725,1,16,3,1,13,1,15,1,1,0,2,22177,7.8,21202,230,58,8450,6098,23.0,2217.7,19,2,0,1,13,2,1,0,1,0,13727,6.2,15104,201,48,-8450,-6098,20.1,1372.7
4523410481,0,17,2,0,2,7,2,0,0,0,0,15106,6.8,17144,237,40,-4579,-3361,23.7,1510.6,62,5,1,7,2,7,2,1,1,2,19685,7.4,20505,246,62,4579,3361,24.6,1968.5
4456309511,0,15,1,1,8,8,7,1,0,1,1,17676,7.0,18151,206,32,393,-215,20.6,1767.6,16,1,0,8,8,9,1,1,0,0,17283,7.0,18366,223,46,-393,215,22.3,1728.3
4521575366,0,47,2,0,7,7,8,0,0,0,0,17151,6.8,17777,193,49,-1122,-926,19.3,1715.1,12,3,1,7,7,6,2,1,1,1,18273,7.2,18703,234,55,1122,926,23.4,1827.3
4473856795,0,17,0,0,3,8,4,0,0,0,0,14076,6.4,16132,184,44,-3613,-2636,18.4,1407.6,16,4,1,8,3,8,2,1,1,0,17689,7.0,18768,234,52,3613,2636,23.4,1768.9
4468599765,1,13,1,1,12,3,14,0,0,0,0,20346,7.4,19902,228,58,5797,4364,22.8,2034.6,12,0,0,3,12,3,1,1,0,0,14549,6.2,15538,203,53,-5797,-4364,20.3,1454.9
4518300534,0,15,0,0,6,6,9,0,0,0,0,16299,6.8,17800,226,42,80,-599,22.6,1629.9,13,2,1,6,6,4,1,1,0,0,16219,7.2,18399,210,48,-80,599,21.0,1621.9
4476291723,0,12,3,1,4,5,4,0,0,0,0,14538,6.6,16373,211,32,-3278,-1873,21.1,1453.8,19,1,0,5,4,5,1,0,1,1,17816,7.2,18246,255,51,3278,1873,25.5,1781.6
4481846502,1,21,3,0,5,1,2,1,1,0,0,17051,7.6,20109,259,81,2358,2590,25.9,1705.1,17,4,1,1,5,0,0,0,0,0,14693,6.8,17519,248,57,-2358,-2590,24.8,1469.3
4464643416,0,16,4,1,4,7,3,0,0,0,0,15928,7.2,18170,204,64,-935,-4,20.4,1592.8,17,2,0,7,4,5,1,1,0,0,16863,6.8,18174,233,52,935,4,23.3,1686.3
4424234082,1,14,6,1,8,3,8,0,0,0,0,17608,7.2,18800,210,43,2185,955,21.0,1760.8,20,0,0,3,8,4,0,0,0,0,15423,6.8,17845,231,53,-2185,-955,23.1,1542.3
4499336930,0,16,3,1,5,8,6,0,0,0,0,16979,7.2,19193,247,56,-988,-797,24.7,1697.9,12,1,0,8,5,6,1,1,0,0,17967,7.4,19990,219,63,988,797,21.9,1796.7
4526622617,1,19,3,0,11,8,8,0,0,0,0,17663,6.6,16879,193,30,16,-639,19.3,1766.3,15,4,1,8,11,6,2,1,1,0,17647,7.0,17518,227,42,-16,639,22.7,1764.7
4479962485,0,60,2,1,9,9,7,1,1,0,0,17459,7.0,18018,185,50,-98,-1136,18.5,1745.9,13,5,0,9,9,6,0,0,0,0,17557,7.2,19154,219,57,98,1136,21.9,1755.7
4453252980,0,42,5,0,0,9,0,0,0,0,0,13024,6.6,15869,192,48,-4912,-4457,19.2,1302.4,19,8,1,9,0,5,2,1,1,0,17936,7.4,20326,251,51,4912,4457,25.1,1793.6
4499835508,0,15,2,0,7,12,5,0,0,0,0,17080,7.0,18513,219,54,-758,-516,21.9,1708.0,34,2,1,12,7,10,1,1,0,0,17838,7.2,19029,209,64,758,516,20.9,1783.8
4518871878,0,18,2,1,6,6,9,0,0,0,0,16450,7.0,17518,212,61,-577,-1953,21.2,1645.0,14,3,0,6,6,5,2,1,1,0,17027,7.2,19471,239,55,577,1953,23.9,1702.7
4500392073,1,90,7,0,7,4,5,1,1,0,0,17929,7.4,20365,233,59,3140,3364,23.3,1792.9,16,5,1,4,7,4,1,0,1,0,14789,6.6,17001,201,52,-3140,-3364,20.1,1478.9
4462513119,0,43,2,0,5,7,5,1,1,0,0,16028,7.0,18310,216,65,-1437,-770,21.6,1602.8,12,22,1,7,5,9,0,0,0,0,17465,7.0,19080,259,48,1437,770,25.9,1746.5
4518919101,0,11,3,0,5,8,9,0,0,0,0,15388,6.4,15598,179,39,-4104,-3458,17.9,1538.8,16,3,1,8,5,8,0,0,0,1,19492,7.2,19056,264,55,4104,3458,26.4,1949.2
4494262239,0,14,0,0,3,4,6,0,0,0,0,15929,6.8,17529,226,40,-394,-1635,22.6,1592.9,14,1,1,4,3,4,1,0,1,0,16323,7.0,19164,237,64,394,1635,23.7,1632.3
4522483751,1,42,3,1,8,8,9,0,0,0,0,17885,7.0,18417,209,52,1419,557,20.9,1788.5,12,2,0,8,8,7,1,1,0,0,16466,7.0,17860,187,47,-1419,-557,18.7,1646.6
4461308775,0,51,3,1,8,8,12,0,0,0,0,16017,6.2,15395,157,40,517,-593,15.7,1601.7,16,4,0,8,8,7,0,0,0,0,15500,6.4,15988,170,44,-517,593,17.0,1550.0
4523015009,1,18,3,1,3,5,4,1,1,0,0,15257,6.6,16719,237,52,-686,-634,23.7,1525.7,12,9,0,5,3,8,0,0,0,0,15943,6.8,17353,208,43,686,634,20.8,1594.3
4527573382,0,63,2,1,2,5,1,1,0,1,0,15915,7.2,18778,245,65,-255,-545,24.5,1591.5,15,1,0,5,2,7,1,1,0,0,16170,7.2,19323,197,63,255,545,19.7,1617.0
4522194078,0,14,3,1,2,5,2,0,0,0,0,14695,6.8,17431,228,56,-2062,-1466,22.8,1469.5,13,3,0,5,2,6,1,1,0,0,16757,7.0,18897,246,58,2062,1466,24.6,1675.7
4524840446,0,13,0,0,5,10,7,0,0,0,0,13742,5.6,12556,123,18,-5705,-5364,12.3,1374.2,13,1,1,10,5,11,1,1,0,0,19447,6.8,17920,218,40,5705,5364,21.8,1944.7
4459407300,1,38,7,0,14,7,14,1,1,0,0,20063,7.4,20273,244,39,3702,3355,24.4,2006.3,18,1,1,7,14,8,1,0,1,0,16361,6.8,16918,175,56,-3702,-3355,17.5,1636.1
4475339734,0,64,2,0,2,3,1,0,0,0,0,13875,6.4,16214,212,46,-1207,-1542,21.2,1387.5,19,6,1,3,2,3,0,0,0,0,15082,7.0,17756,227,37,1207,1542,22.7,1508.2
4478061745,1,15,4,1,6,1,4,1,0,1,1,17872,7.2,19324,247,50,3544,2083,24.7,1787.2,15,3,0,1,6,1,1,1,0,0,14328,6.8,17241,219,48,-3544,-2083,21.9,1432.8
4505630754,1,18,2,1,6,5,4,0,0,0,0,16304,6.8,17893,209,50,-794,-951,20.9,1630.4,13,3,0,5,6,3,0,0,0,0,17098,7.2,18844,220,73,794,951,22.0,1709.8
4455272131,0,37,4,0,7,7,8,1,1,0,0,17114,7.0,18783,210,41,-218,-840,21.0,1711.4,11,11,1,7,7,6,0,0,0,0,17332,7.4,19623,226,71,218,840,22.6,1733.2
4504951170,1,12,2,0,6,7,6,0,0,0,0,16889,6.6,17619,194,68,533,1451,19.4,1688.9,11,1,1,7,6,10,1,0,1,0,16356,6.6,16168,220,48,-533,-1451,22.0,1635.6
4449354276,0,14,3,1,9,7,11,0,0,0,0,17382,7.2,19283,220,55,1103,1117,22.0,1738.2,41,3,0,7,9,10,0,0,0,0,16279,7.2,18166,209,36,-1103,-1117,20.9,1627.9
4474190443,1,25,2,0,5,10,1,0,0,0,0,15042,6.8,16868,189,56,-3052,-775,18.9,1504.2,20,4,1,10,5,13,1,1,0,0,18094,7.0,17643,201,56,3052,775,20.1,1809.4
4523093613,1,17,3,0,5,7,3,1,1,0,0,16056,6.8,17578,234,56,-1419,-1156,23.4,1605.6,39,2,1,7,5,13,1,0,1,0,17475,7.0,18734,227,52,1419,1156,22.7,1747.5
4526844816,0,12,3,0,4,6,2,1,0,1,0,14372,6.8,16842,205,40,-1864,-2124,20.5,1437.2,19,4,1,6,4,3,0,0,0,0,16236,7.2,18966,216,54,1864,2124,21.6,1623.6
4516373262,0,14,2,1,4,3,5,0,0,0,0,15945,7.2,18619,204,51,405,487,20.4,1594.5,15,1,0,3,4,2,0,0,0,0,15540,7.0,18132,236,55,-405,-487,23.6,1554.0
4527110786,1,47,1,0,3,2,3,0,0,0,0,14706,6.6,15747,203,45,207,-1880,20.3,1470.6,18,2,1,2,3,1,0,0,0,0,14499,6.8,17627,242,54,-207,1880,24.2,1449.9
4527319271,1,93,1,0,17,4,25,2,1,1,0,21257,7.4,20163,220,48,6713,5380,22.0,2125.7,10,3,1,4,17,3,0,0,0,0,14544,6.2,14783,170,51,-6713,-5380,17.0,1454.4
4518225344,1,14,6,1,5,5,6,1,1,0,0,16345,6.8,17499,246,45,134,-1022,24.6,1634.5,19,1,0,5,5,5,0,0,0,0,16211,7.2,18521,239,58,-134,1022,23.9,1621.1
4509706108,0,16,18,1,4,11,3,0,0,0,0,14958,6.6,16928,184,42,-5089,-4890,18.4,1495.8,53,1,0,11,4,7,1,0,1,1,20047,7.8,21818,243,63,5089,4890,24.3,2004.7
4526510226,0,16,3,1,2,4,4,0,0,0,0,14775,6.8,17337,206,45,-1285,-1925,20.6,1477.5,59,3,0,4,2,7,1,0,1,0,16060,7.2,19262,227,63,1285,1925,22.7,1606.0
4447547106,0,13,3,0,2,3,3,0,0,0,0,14752,6.8,17798,230,53,-439,-983,23.0,1475.2,36,0,1,3,2,3,2,1,1,0,15191,7.2,18781,222,65,439,983,22.2,1519.1
4482844826,0,128,3,1,8,7,8,1,1,0,0,17720,7.2,19150,232,50,1549,1179,23.2,1772.0,12,1,0,7,8,4,1,0,1,0,16171,7.0,17971,212,34,-1549,-1179,21.2,1617.1
4452292260,1,37,1,0,9,11,8,1,1,0,0,17060,6.6,17118,179,36,-896,-661,17.9,1706.0,16,15,1,11,9,14,0,0,0,0,17956,7.0,17779,200,52,896,661,20.0,1795.6
4524156095,0,16,3,1,6,5,6,0,0,0,0,16518,7.2,19187,223,56,51,140,22.3,1651.8,16,2,0,5,6,6,1,1,0,0,16467,7.2,19047,245,44,-51,-140,24.5,1646.7
4513523498,0,17,3,0,1,5,2,0,0,0,0,14031,6.6,16789,223,52,-1762,-1592,22.3,1403.1,18,7,1,5,1,5,2,1,1,0,15793,7.0,18381,216,52,1762,1592,21.6,1579.3
4452166670,1,15,2,1,4,1,7,2,1,1,0,17320,7.4,18965,264,75,2850,1646,26.4,1732.0,47,0,0,1,4,0,0,0,0,0,14470,6.8,17319,248,45,-2850,-1646,24.8,1447.0
4511137268,0,15,2,1,6,8,4,1,1,0,0,16118,6.8,17602,200,48,-1209,-1556,20.0,1611.8,17,3,0,8,6,7,0,0,0,0,17327,7.4,19158,251,42,1209,1556,25.1,1732.7
4466140539,0,15,0,1,2,5,4,0,0,0,0,14635,7.0,17734,235,54,-1478,-1388,23.5,1463.5,16,0,0,5,2,2,0,0,0,0,16113,7.2,19122,246,67,1478,1388,24.6,1611.3
4480445150,1,16,0,0,4,5,6,2,1,1,0,16127,6.8,17245,235,55,1210,1410,23.5,1612.7,19,4,1,5,4,3,0,0,0,0,14917,6.4,15835,191,40,-1210,-1410,19.1,1491.7
4520967143,0,36,2,1,4,11,2,1,1,0,0,15834,6.8,18362,197,56,-2383,-1807,19.7,1583.4,16,1,0,11,4,7,0,0,0,0,18217,7.4,20169,182,59,2383,1807,18.2,1821.7
4472023153,0,16,2,0,6,7,5,1,1,0,0,15889,6.8,16752,220,33,-1248,503,22.0,1588.9,17,3,1,7,6,12,0,0,0,1,17137,6.4,16249,191,34,1248,-503,19.1,1713.7
4519078225,0,87,4,1,8,7,7,1,0,1,1,19120,7.0,19644,248,43,2171,1375,24.8,1912.0,19,4,0,7,8,7,1,1,0,0,16949,7.0,18269,217,56,-2171,-1375,21.7,1694.9
4502724459,0,15,3,1,9,5,8,0,0,0,0,17792,7.0,18238,222,45,2785,1671,22.2,1779.2,16,2,0,5,9,1,1,1,0,0,15007,6.6,16567,204,53,-2785,-1671,20.4,1500.7
4506722541,0,11,0,0,0,8,0,0,0,0,0,13608,6.6,16690,229,52,-4785,-3229,22.9,1360.8,13,1,1,8,0,11,2,1,1,0,18393,7.2,19919,239,64,4785,3229,23.9,1839.3
4522322962,0,14,1,1,4,4,3,0,0,0,0,15021,6.8,16981,207,44,-1254,-956,20.7,1502.1,38,1,0,4,4,5,2,1,1,0,16275,7.0,17937,249,48,1254,956,24.9,1627.5
4520713335,1,13,1,1,6,5,5,0,0,0,0,16789,7.0,17947,198,57,1206,968,19.8,1678.9,32,1,0,5,6,5,0,0,0,0,15583,6.6,16979,192,36,-1206,-968,19.2,1558.3
4493766811,0,86,0,0,10,12,8,0,0,0,0,17607,7.0,18633,195,41,-740,396,19.5,1760.7,12,2,1,12,10,11,1,1,0,0,18347,7.0,18237,214,40,740,-396,21.4,1834.7
4478351147,0,13,3,0,4,11,0,0,0,0,0,14891,6.8,17683,218,59,-4035,-2639,21.8,1489.1,18,3,1,11,4,11,1,1,0,0,18926,7.4,20322,246,51,4035,2639,24.6,1892.6
4523264320,0,78,1,1,4,10,7,0,0,0,0,15035,6.4,16650,183,60,-3584,-3248,18.3,1503.5,13,2,0,10,4,10,1,1,0,0,18619,7.6,19898,238,59,3584,3248,23.8,1861.9
4421884287,1,19,5,1,9,8,19,1,1,0,0,18401,7.0,18207,237,51,506,620,23.7,1840.1,15,4,0,8,9,13,0,0,0,0,17895,7.0,17587,239,44,-506,-620,23.9,1789.5
4457599634,1,17,2,1,7,8,4,1,1,0,0,17222,7.2,19032,216,75,485,219,21.6,1722.2,16,2,0,8,7,7,0,0,0,0,16737,7.0,18813,202,28,-485,-219,20.2,1673.7
4527476599,0,17,1,0,3,7,3,2,1,1,0,14618,6.6,16828,199,56,-2564,-2469,19.9,1461.8,14,6,1,7,3,6,0,0,0,0,17182,7.0,19297,244,58,2564,2469,24.4,1718.2
4519318813,0,11,1,1,6,4,6,1,1,0,0,15437,6.6,16652,198,52,-152,-901,19.8,1543.7,17,3,0,4,6,6,1,0,1,0,15589,7.0,17553,220,49,152,901,22.0,1558.9
4526253897,0,57,2,1,6,3,10,0,0,0,0,15954,6.8,17647,203,44,534,89,20.3,1595.4,17,1,0,3,6,4,1,1,0,0,15420,6.8,17558,248,45,-534,-89,24.8,1542.0
4512335811,1,16,2,1,3,8,4,0,0,0,0,14481,6.4,15768,214,40,-2765,-2274,21.4,1448.1,16,3,0,8,3,16,2,1,1,0,17246,7.2,18042,226,51,2765,2274,22.6,1724.6
4496339306,1,12,6,0,5,3,6,1,0,1,0,17227,7.0,18492,245,62,2582,2655,24.5,1722.7,19,2,1,3,5,5,1,1,0,0,14645,6.2,15837,200,49,-2582,-2655,20.0,1464.5
4484372363,1,16,5,0,6,10,6,1,1,0,0,15815,6.6,16869,196,43,-1754,-211,19.6,1581.5,18,3,1,10,6,10,0,0,0,0,17569,6.6,17080,201,40,1754,211,20.1,1756.9
4504690323,0,20,2,0,2,6,2,2,1,1,0,15488,6.8,18660,265,67,-978,-226,26.5,1548.8,20,2,1,6,2,8,0,0,0,0,16466,7.2,18886,220,43,978,226,22.0,1646.6
4516600859,0,18,1,1,4,1,4,1,0,1,1,16808,6.8,17831,227,46,2476,772,22.7,1680.8,15,2,0,1,4,0,1,1,0,0,14332,6.8,17059,248,53,-2476,-772,24.8,1433.2
4441802146,1,21,3,0,8,8,9,0,0,0,0,16096,6.6,16891,175,36,-1327,-789,17.5,1609.6,24,9,1,8,8,9,1,1,0,0,17423,6.8,17680,198,56,1327,789,19.8,1742.3
4493677959,0,19,2,1,5,7,7,0,0,0,0,15949,6.8,17005,209,51,-1568,-1850,20.9,1594.9,19,5,0,7,5,8,1,1,0,0,17517,7.2,18855,215,71,1568,1850,21.5,1751.7
4524349618,1,75,3,0,4,6,4,1,1,0,0,15478,6.8,18212,204,60,-2375,-293,20.4,1547.8,16,1,1,6,4,4,0,0,0,1,17853,7.0,18505,236,48,2375,293,23.6,1785.3
4445514186,0,14,2,1,4,8,2,1,0,1,0,16266,6.6,17958,224,47,-622,-1278,22.4,1626.6,19,0,0,8,4,13,1,1,0,0,16888,7.2,19236,231,53,622,1278,23.1,1688.8
4525539493,0,17,2,1,6,8,8,0,0,0,0,15319,6.6,16582,158,68,-2416,-2808,15.8,1531.9,15,4,0,8,6,9,1,1,0,0,17735,7.2,19390,209,68,2416,2808,20.9,1773.5
4487018877,1,16,4,1,5,8,4,1,1,0,0,15964,6.8,17011,204,53,-1399,-1727,20.4,1596.4,53,1,0,8,5,7,0,0,0,0,17363,7.2,18738,217,49,1399,1727,21.7,1736.3
4491980235,0,14,2,1,10,7,10,0,0,0,0,18296,7.0,18788,208,52,1011,17,20.8,1829.6,20,1,0,7,10,8,0,0,0,0,17285,7.0,18771,237,48,-1011,-17,23.7,1728.5
4480172739,0,40,6,0,4,9,3,0,0,0,0,15469,6.6,17314,234,45,-2472,-554,23.4,1546.9,18,7,1,9,4,8,2,1,1,0,17941,6.8,17868,227,68,2472,554,22.7,1794.1
4526130313,1,25,1,0,2,3,2,1,0,1,0,13703,6.8,16964,187,48,-1912,-957,18.7,1370.3,13,2,1,3,2,0,0,0,0,0,15615,7.0,17921,241,56,1912,957,24.1,1561.5
4527590417,0,12,2,0,4,10,3,0,0,0,0,15690,6.8,18165,223,40,-2802,-1606,22.3,1569.0,17,3,1,10,4,16,2,1,1,0,18492,7.4,19771,227,44,2802,1606,22.7,1849.2
4497526633,0,16,0,0,3,4,2,0,0,0,0,14652,7.0,18395,235,42,-1075,11,23.5,1465.2,15,5,1,4,3,2,1,1,0,0,15727,7.2,18384,233,58,1075,-11,23.3,1572.7
4492010722,1,18,0,1,9,5,7,2,1,1,0,16587,7.0,17630,212,44,814,2199,21.2,1658.7,14,2,0,5,9,7,0,0,0,0,15773,6.4,15431,176,48,-814,-2199,17.6,1577.3
4504510674,1,16,4,1,5,6,6,0,0,0,0,16632,6.8,17833,215,59,999,482,21.5,1663.2,15,5,0,6,5,10,1,1,0,0,15633,7.0,17351,198,49,-999,-482,19.8,1563.3
4472652986,0,17,4,0,7,8,6,1,1,0,0,16007,7.0,17830,204,47,-873,308,20.4,1600.7,17,3,1,8,7,7,0,0,0,0,16880,6.8,17522,215,44,873,-308,21.5,1688.0
4499694291,0,13,0,0,3,11,2,0,0,0,0,13962,6.4,15298,192,27,-5812,-5009,19.2,1396.2,13,1,1,11,3,7,2,1,1,1,19774,7.4,20307,225,44,5812,5009,22.5,1977.4
4517761831,1,14,2,0,9,4,7,0,0,0,0,17047,7.2,19134,226,57,1992,2548,22.6,1704.7,14,1,1,4,9,4,1,1,0,0,15055,6.6,16586,225,44,-1992,-2548,22.5,1505.5
4461471902,0,19,1,1,2,7,3,0,0,0,0,14711,6.6,16207,221,45,-2625,-3375,22.1,1471.1,15,3,0,7,2,5,1,1,0,0,17336,7.6,19582,244,66,2625,3375,24.4,1733.6
4501067949,1,79,3,1,9,2,11,0,0,0,0,18124,7.4,19613,213,48,4232,3448,21.3,1812.4,55,2,0,2,9,0,0,0,0,0,13892,6.6,16165,205,52,-4232,-3448,20.5,1389.2
4521189222,1,37,4,1,14,7,15,0,0,0,0,21699,7.6,20734,242,43,5773,3643,24.2,2169.9,16,13,0,7,14,6,1,1,0,0,15926,6.8,17091,208,50,-5773,-3643,20.8,1592.6
4470658458,1,14,4,0,8,4,8,1,0,1,0,17349,7.6,19375,197,55,1942,1658,19.7,1734.9,19,3,1,4,8,2,1,1,0,0,15407,6.8,17717,228,52,-1942,-1658,22.8,1540.7
4446235910,1,23,4,1,13,6,13,0,0,0,0,20329,7.6,20692,264,48,4227,3892,26.4,2032.9,16,5,0,6,13,7,0,0,0,0,16102,6.6,16800,174,40,-4227,-3892,17.4,1610.2
4511453042,1,44,4,1,6,4,5,0,0,0,0,17012,7.2,19091,225,52,324,106,22.5,1701.2,19,2,0,4,6,5,1,1,0,0,16688,7.2,18985,229,71,-324,-106,22.9,1668.8
4521397420,0,36,3,0,2,9,4,1,1,0,0,13570,6.6,15970,195,41,-6374,-4421,19.5,1357.0,16,2,1,9,2,8,1,0,1,1,19944,7.8,20391,262,56,6374,4421,26.2,1994.4
4487004786,0,18,5,0,7,7,7,1,1,0,0,16056,6.6,16268,188,40,-1151,-1924,18.8,1605.6,15,1,1,7,7,14,1,0,1,0,17207,7.0,18192,235,49,1151,1924,23.5,1720.7
4521819708,0,18,2,0,7,8,6,1,1,0,0,16482,6.6,17043,229,40,-672,-335,22.9,1648.2,16,3,1,8,7,13,1,0,1,0,17154,6.8,17378,190,56,672,335,19.0,1715.4
4494225858,1,23,1,1,10,3,13,2,1,1,1,18929,7.0,18674,170,60,3235,1168,17.0,1892.9,35,2,0,3,10,6,0,0,0,0,15694,7.0,17506,241,44,-3235,-1168,24.1,1569.4
4522848793,0,17,4,0,2,8,2,0,0,0,0,14117,6.6,16799,199,44,-4158,-3452,19.9,1411.7,15,3,1,8,2,7,2,1,1,0,18275,7.4,20251,248,56,4158,3452,24.8,1827.5
4521949679,0,14,2,1,6,7,8,1,1,0,0,15307,6.4,15025,175,48,-660,-922,17.5,1530.7,44,1,0,7,6,12,0,0,0,0,15967,6.4,15947,171,37,660,922,17.1,1596.7
4514457087,1,14,1,1,9,4,11,0,0,0,0,17494,7.0,18057,205,56,1518,-5,20.5,1749.4,13,0,0,4,9,5,1,1,0,0,15976,7.0,18062,199,72,-1518,5,19.9,1597.6
4510113331,0,39,5,0,4,3,5,0,0,0,0,15450,7.0,17766,202,61,312,33,20.2,1545.0,45,5,1,3,4,8,2,1,1,0,15138,7.2,17733,243,52,-312,-33,24.3,1513.8
4515674132,0,39,0,0,6,8,8,0,0,0,0,16065,7.0,17606,193,50,-1823,-2149,19.3,1606.5,13,1,1,8,6,7,1,1,0,0,17888,7.4,19755,234,63,1823,2149,23.4,1788.8
4524110417,0,16,5,1,9,6,5,0,0,0,0,17341,7.2,19621,203,51,1266,1770,20.3,1734.1,41,2,0,6,9,6,0,0,0,0,16075,7.0,17851,193,52,-1266,-1770,19.3,1607.5
4524580424,1,16,1,1,9,7,14,1,0,1,0,17465,6.6,17463,211,40,875,276,21.1,1746.5,13,2,0,7,9,7,0,0,0,0,16590,6.6,17187,183,44,-875,-276,18.3,1659.0
4521344335,1,43,4,1,7,0,15,2,1,1,0,17525,7.2,19534,240,53,3884,2315,24.0,1752.5,30,5,0,0,7,0,0,0,0,0,13641,6.8,17219,238,53,-3884,-2315,23.8,1364.1
4515880497,1,16,3,0,5,4,6,0,0,0,0,16632,7.0,18912,233,53,1224,1259,23.3,1663.2,39,3,1,4,5,5,1,1,0,0,15408,6.8,17653,228,40,-1224,-1259,22.8,1540.8
4475925954,0,14,1,1,4,12,5,0,0,0,0,15056,6.4,16369,198,46,-3772,-3034,19.8,1505.6,13,1,0,12,4,20,1,1,0,1,18828,7.4,19403,177,53,3772,3034,17.7,1882.8
4503987105,1,17,1,1,10,4,15,1,1,0,0,18928,7.2,18365,210,47,4165,2230,21.0,1892.8,12,1,0,4,10,6,1,0,1,0,14763,6.6,16135,197,40,-4165,-2230,19.7,1476.3
4522435963,1,25,4,0,7,3,7,1,1,0,0,16409,7.4,19634,215,51,1261,2149,21.5,1640.9,98,2,1,3,7,4,0,0,0,0,15148,7.0,17485,242,56,-1261,-2149,24.2,1514.8
4506292782,1,13,0,1,12,3,16,1,1,0,0,19443,7.2,19743,254,48,5349,4131,25.4,1944.3,17,2,0,3,12,3,0,0,0,0,14094,6.6,15612,190,48,-5349,-4131,19.0,1409.4
4510943404,1,23,1,1,7,6,9,0,0,0,0,16531,7.0,17534,218,40,-136,-290,21.8,1653.1,22,3,0,6,7,8,2,1,1,0,16667,7.0,17824,243,55,136,290,24.3,1666.7
4520570200,0,16,2,0,2,4,0,0,0,0,0,14876,7.0,18374,218,68,-1187,-1561,21.8,1487.6,12,3,1,4,2,3,1,1,0,0,16063,7.4,19935,222,68,1187,1561,22.2,1606.3
4514601074,1,46,3,1,10,7,6,1,1,0,0,17678,7.4,18832,189,76,1754,433,18.9,1767.8,13,2,0,7,10,4,0,0,0,0,15924,6.8,18399,207,54,-1754,-433,20.7,1592.4
4475412255,0,13,0,0,5,6,4,0,0,0,0,15882,6.6,17373,231,46,-764,-128,23.1,1588.2,9,2,1,6,5,6,1,1,0,0,16646,6.8,17501,225,43,764,128,22.5,1664.6
4423083360,0,14,2,0,3,5,2,0,0,0,0,15148,7.0,18263,213,50,-1416,63,21.3,1514.8,15,2,1,5,3,8,1,1,0,0,16564,7.0,18200,230,67,1416,-63,23.0,1656.4
4519502337,1,17,4,0,9,6,12,1,1,0,0,18555,7.2,19740,250,56,2976,1300,25.0,1855.5,16,3,1,6,9,6,0,0,0,0,15579,7.0,18440,207,48,-2976,-1300,20.7,1557.9
4504999462,0,15,4,0,4,4,5,1,1,0,0,14592,6.6,16682,204,47,-1208,-1061,20.4,1459.2,17,3,1,4,4,3,0,0,0,0,15800,6.8,17743,205,60,1208,1061,20.5,1580.0
4489141814,0,14,1,0,2,5,4,0,0,0,0,14743,6.8,17174,228,44,-1625,-2061,22.8,1474.3,21,3,1,5,2,8,2,1,1,0,16368,7.4,19235,239,60,1625,2061,23.9,1636.8
4465444294,0,41,0,0,8,7,9,0,0,0,0,17430,6.8,17345,210,33,421,-755,21.0,1743.0,16,2,1,7,8,7,1,1,0,0,17009,7.0,18100,216,42,-421,755,21.6,1700.9
4527385482,0,22,2,0,3,5,3,1,1,0,0,15309,6.8,17455,245,49,-1069,-298,24.5,1530.9,18,7,1,5,3,5,0,0,0,0,16378,6.8,17753,241,51,1069,298,24.1,1637.8
4513799193,0,14,1,0,2,4,3,1,1,0,0,14318,7.0,17405,207,51,-2928,-110,20.7,1431.8,17,4,1,4,2,10,0,0,0,1,17246,7.0,17515,240,44,2928,110,24.0,1724.6
4484301779,1,20,2,1,3,4,6,0,0,0,0,14632,6.4,16037,198,53,-1134,-906,19.8,1463.2,15,4,0,4,3,5,1,0,1,0,15766,6.8,16943,223,46,1134,906,22.3,1576.6
4525144811,0,17,0,0,8,8,5,1,0,1,0,18233,7.4,19767,256,56,363,-533,25.6,1823.3,78,2,1,8,8,13,1,1,0,0,17870,7.6,20300,239,52,-363,533,23.9,1787.0
4515342785,0,15,2,1,6,5,4,1,1,0,0,15698,7.0,17468,206,59,-1143,-859,20.6,1569.8,15,1,0,5,6,3,1,0,1,0,16841,7.0,18327,259,50,1143,859,25.9,1684.1
4465548347,0,45,5,1,3,8,4,0,0,0,0,14324,6.4,16390,217,43,-2808,-1555,21.7,1432.4,21,19,0,8,3,12,0,0,0,0,17132,7.0,17945,231,35,2808,1555,23.1,1713.2
4508344730,1,16,1,1,7,6,10,1,1,0,0,16497,7.0,17789,201,57,787,-575,20.1,1649.7,17,3,0,6,7,2,0,0,0,0,15710,7.0,18364,232,42,-787,575,23.2,1571.0
4500976861,1,34,5,0,2,7,2,0,0,0,0,15356,7.0,17995,230,60,-1706,-1004,23.0,1535.6,20,3,1,7,2,7,1,1,0,0,17062,7.0,18999,209,71,1706,1004,20.9,1706.2
4486075079,1,17,1,1,9,3,9,1,0,1,0,18159,7.4,19769,245,52,3037,2677,24.5,1815.9,20,4,0,3,9,4,1,1,0,0,15122,6.6,17092,213,50,-3037,-2677,21.3,1512.2
4522174170,0,16,2,1,9,11,15,2,1,1,0,18281,7.0,17856,218,44,785,812,21.8,1828.1,48,3,0,11,9,12,0,0,0,0,17496,7.0,17044,184,40,-785,-812,18.4,1749.6
4502578758,1,21,2,1,7,4,12,0,0,0,0,17380,6.8,18705,232,50,2615,2028,23.2,1738.0,14,3,0,4,7,3,0,0,0,0,14765,6.6,16677,181,56,-2615,-2028,18.1,1476.5
4456684874,0,17,1,0,4,9,2,0,0,0,0,15445,6.6,17280,222,51,-1775,-2698,22.2,1544.5,11,6,1,9,4,6,1,0,1,0,17220,7.4,19978,228,38,1775,2698,22.8,1722.0
4479055235,0,17,1,1,6,8,5,0,0,0,0,16684,6.8,17071,213,46,-944,-556,21.3,1668.4,34,3,0,8,6,15,1,1,0,0,17628,6.8,17627,187,54,944,556,18.7,1762.8
4521070443,0,13,3,1,5,4,5,0,0,0,0,15933,7.2,18047,246,40,465,632,24.6,1593.3,40,2,0,4,5,5,2,1,1,0,15468,6.8,17415,203,49,-465,-632,20.3,1546.8
4449428423,0,19,6,1,3,7,5,1,1,0,0,14758,6.6,15950,202,52,-2993,-2494,20.2,1475.8,16,4,0,7,3,12,1,0,1,1,17751,7.0,18444,215,39,2993,2494,21.5,1775.1
4486940002,0,16,4,0,3,7,4,1,1,0,0,14384,6.2,15955,199,36,-3388,-3025,19.9,1438.4,21,4,1,7,3,9,0,0,0,0,17772,7.2,18980,256,52,3388,3025,25.6,1777.2
4431970864,0,22,3,0,4,12,0,1,1,0,0,14276,6.8,16422,190,51,-4262,-2426,19.0,1427.6,16,2,1,12,4,14,0,0,0,0,18538,7.2,18848,224,40,4262,2426,22.4,1853.8
4503192981,1,17,4,0,6,5,5,1,0,1,0,16000,6.8,17778,206,60,379,406,20.6,1600.0,16,1,1,5,6,5,1,1,0,0,15621,6.8,17372,214,44,-379,-406,21.4,1562.1
4459848079,0,16,4,0,2,9,2,0,0,0,0,13791,6.6,16220,199,50,-4379,-3811,19.9,1379.1,15,3,1,9,2,6,0,0,0,0,18170,7.4,20031,250,54,4379,3811,25.0,1817.0
4521499585,0,12,0,0,2,9,2,1,1,0,0,14132,6.8,16898,210,48,-4668,-3772,21.0,1413.2,11,2,1,9,2,11,1,0,1,0,18800,7.6,20670,226,67,4668,3772,22.6,1880.0
4519857386,1,17,4,1,5,4,4,0,0,0,0,17431,7.2,18675,272,46,300,427,27.2,1743.1,17,2,0,4,5,3,2,1,1,1,17131,7.0,18248,236,56,-300,-427,23.6,1713.1
4457626899,1,18,3,1,4,8,4,1,0,1,0,16657,7.0,18154,210,58,-206,-1476,21.0,1665.7,17,6,0,8,4,0,1,1,0,0,16863,7.2,19630,248,52,206,1476,24.8,1686.3
4527291717,0,71,4,0,4,7,2,0,0,0,0,14961,6.8,17673,215,40,-2090,-916,21.5,1496.1,18,3,1,7,4,7,1,1,0,0,17051,7.0,18589,239,56,2090,916,23.9,1705.1
4512257962,0,40,2,1,7,6,8,2,1,1,0,17002,7.2,18865,209,64,-365,-267,20.9,1700.2,13,2,0,6,7,5,0,0,0,0,17367,7.4,19132,229,50,365,267,22.9,1736.7
4509716236,0,13,0,0,6,6,4,1,1,0,0,16248,7.0,18567,220,47,174,1511,22.0,1624.8,16,2,1,6,6,7,0,0,0,0,16074,6.6,17056,211,42,-174,-1511,21.1,1607.4
4492063220,1,51,4,1,11,3,9,1,1,0,0,16663,7.0,18021,188,64,1884,1871,18.8,1666.3,16,2,0,3,11,2,0,0,0,0,14779,6.4,16150,208,40,-1884,-1871,20.8,1477.9
4519439702,1,42,4,1,11,3,14,1,0,1,1,20145,7.4,19898,242,39,5634,2094,24.2,2014.5,15,3,0,3,11,1,1,1,0,0,14511,6.8,17804,196,85,-5634,-2094,19.6,1451.1
4468685425,0,40,1,0,3,8,3,0,0,0,0,14416,6.8,16951,185,38,-3253,-3049,18.5,1441.6,15,15,1,8,3,9,1,1,0,0,17669,7.6,20000,229,60,3253,3049,22.9,1766.9
4520391228,1,38,1,0,8,5,10,1,1,0,0,17194,7.2,19279,200,71,2562,3016,20.0,1719.4,14,3,1,5,8,4,0,0,0,0,14632,6.4,16263,184,44,-2562,-3016,18.4,1463.2
4509988764,0,16,3,1,7,8,8,1,1,0,0,16907,7.2,18706,213,46,-28,-28,21.3,1690.7,15,0,0,8,7,10,0,0,0,0,16935,7.0,18734,227,48,28,28,22.7,1693.5
4524530613,1,15,3,0,4,12,3,0,0,0,0,16361,6.8,17937,225,68,-2902,-1196,22.5,1636.1,53,3,1,12,4,16,1,1,0,0,19263,7.2,19133,231,56,2902,1196,23.1,1926.3
4489456327,0,42,3,0,8,7,13,1,1,0,0,17909,6.4,16512,165,39,1340,-207,16.5,1790.9,19,4,1,7,8,10,0,0,0,0,16569,6.6,16719,201,32,-1340,207,20.1,1656.9
4493053223,0,16,4,1,9,5,12,2,1,1,0,17390,7.0,17256,196,54,614,-322,19.6,1739.0,16,5,0,5,9,7,0,0,0,0,16776,6.6,17578,213,48,-614,322,21.3,1677.6
4456415287,1,17,2,1,13,5,9,0,0,0,0,19124,7.2,20438,244,56,3579,2679,24.4,1912.4,15,3,0,5,13,4,1,1,0,0,15545,7.0,17759,191,52,-3579,-2679,19.1,1554.5
4449194030,1,21,4,1,15,9,22,1,1,0,0,20558,7.0,18104,230,40,4230,1545,23.0,2055.8,16,0,0,9,15,5,0,0,0,0,16328,6.8,16559,167,36,-4230,-1545,16.7,1632.8
4446190086,0,18,1,0,4,9,5,0,0,0,0,14842,6.6,16718,203,44,-3400,-2763,20.3,1484.2,17,4,1,9,4,11,1,1,0,0,18242,7.2,19481,241,66,3400,2763,24.1,1824.2
4524643428,1,19,4,1,12,2,13,1,1,0,0,19320,7.4,20189,251,37,4544,3126,25.1,1932.0,17,4,0,2,12,2,0,0,0,0,14776,6.8,17063,206,52,-4544,-3126,20.6,1477.6
4505993951,1,15,0,1,3,5,5,0,0,0,0,14896,6.8,17240,207,42,-2200,-1933,20.7,1489.6,53,2,0,5,3,6,2,1,1,0,17096,7.4,19173,235,63,2200,1933,23.5,1709.6
4493967269,0,54,4,0,8,7,9,0,0,0,0,16355,7.0,17876,193,44,-495,934,19.3,1635.5,16,2,1,7,8,7,1,1,0,0,16850,6.6,16942,191,60,495,-934,19.1,1685.0
4523024529,0,38,2,0,6,10,8,0,0,0,0,16530,7.0,18808,205,54,-1726,-267,20.5,1653.0,20,3,1,10,6,12,1,1,0,0,18256,7.0,19075,238,46,1726,267,23.8,1825.6
4516510079,0,33,2,0,2,11,2,1,1,0,0,14099,6.6,16884,201,59,-3938,-2767,20.1,1409.9,18,1,1,11,2,8,0,0,0,0,18037,7.2,19651,218,53,3938,2767,21.8,1803.7
4517801069,1,38,3,1,9,7,11,1,1,0,0,17869,7.0,17810,205,40,636,-214,20.5,1786.9,14,1,0,7,9,9,0,0,0,0,17233,6.8,18024,215,48,-636,214,21.5,1723.3
4477722097,0,13,2,1,3,1,4,1,0,1,0,16156,7.0,18605,233,61,1639,1308,23.3,1615.6,14,4,0,1,3,3,1,1,0,0,14517,7.0,17297,241,40,-1639,-1308,24.1,1451.7
4526189371,0,13,0,0,6,9,4,0,0,0,0,15917,6.8,17466,200,51,-3142,-2289,20.0,1591.7,13,2,1,9,6,8,0,0,0,0,19059,7.4,19755,243,56,3142,2289,24.3,1905.9
4518869333,0,14,1,0,7,8,4,1,1,0,0,17209,6.8,17808,229,37,1710,1298,22.9,1720.9,14,0,1,8,7,5,0,0,0,0,15499,6.4,16510,166,46,-1710,-1298,16.6,1549.9
4468031280,1,17,5,0,5,3,8,1,1,0,0,15574,6.8,17788,230,45,840,196,23.0,1557.4,14,2,1,3,5,1,0,0,0,0,14734,7.0,17592,203,59,-840,-196,20.3,1473.4
4502850011,0,18,2,1,4,8,3,0,0,0,0,15119,6.4,16105,216,35,-1901,-3111,21.6,1511.9,14,5,0,8,4,10,1,1,0,0,17020,7.2,19216,216,64,1901,3111,21.6,1702.0
4527478355,1,21,1,0,11,8,17,1,0,1,1,20109,7.2,18733,211,51,2700,1463,21.1,2010.9,15,2,1,8,11,9,0,0,0,0,17409,6.8,17270,231,40,-2700,-1463,23.1,1740.9
4515298489,0,18,1,0,2,5,4,2,1,1,0,14414,6.4,16249,215,64,-2363,-2144,21.5,1441.4,13,2,1,5,2,10,0,0,0,0,16777,7.2,18393,233,64,2363,2144,23.3,1677.7
4511111206,0,17,3,1,8,14,11,0,0,0,0,17886,6.4,15999,219,32,-1988,-1490,21.9,1788.6,11,3,0,14,8,17,2,1,1,0,19874,6.8,17489,151,48,1988,1490,15.1,1987.4
4519559671,0,53,15,1,3,9,2,1,0,1,0,13876,6.2,15218,183,36,-5694,-3457,18.3,1387.6,74,4,0,9,3,15,0,0,0,1,19570,6.8,18675,204,51,5694,3457,20.4,1957.0
4493204321,0,15,2,0,2,8,1,0,0,0,0,14826,6.6,16327,222,37,-1635,-1544,22.2,1482.6,17,4,1,8,2,12,2,1,1,0,16461,6.8,17871,210,50,1635,1544,21.0,1646.1
4525637223,1,19,0,0,6,6,5,1,1,0,0,16444,7.0,18703,207,60,370,726,20.7,1644.4,11,3,1,6,6,3,0,0,0,0,16074,6.8,17977,226,44,-370,-726,22.6,1607.4
4516672650,0,14,0,0,2,9,2,1,1,0,0,14695,6.8,17395,223,63,-3426,-2539,22.3,1469.5,16,1,1,9,2,10,0,0,0,0,18121,7.4,19934,236,44,3426,2539,23.6,1812.1
4527645576,1,16,0,1,16,2,15,2,1,1,0,20943,7.4,19895,241,52,7847,5766,24.1,2094.3,17,1,0,2,16,2,0,0,0,0,13096,6.0,14129,142,52,-7847,-5766,14.2,1309.6
4472758849,0,37,0,0,3,6,1,0,0,0,0,15276,7.2,18400,214,59,-1729,-437,21.4,1527.6,14,3,1,6,3,8,1,1,0,0,17005,7.0,18837,250,52,1729,437,25.0,1700.5
4489404475,1,18,3,0,7,5,8,0,0,0,0,16525,6.8,17494,191,51,67,-303,19.1,1652.5,15,0,1,5,7,5,0,0,0,0,16458,7.0,17797,228,46,-67,303,22.8,1645.8
4432011419,1,15,3,0,6,8,10,0,0,0,0,15579,6.8,16747,204,46,-1815,-1309,20.4,1557.9,15,3,1,8,6,8,2,1,1,0,17394,7.0,18056,205,59,1815,1309,20.5,1739.4
4523414264,1,64,4,0,5,9,7,0,0,0,0,15220,6.4,16145,174,46,-3679,-3273,17.4,1522.0,11,5,1,9,5,11,0,0,0,0,18899,7.0,19418,266,64,3679,3273,26.6,1889.9
4500982447,1,13,3,0,7,2,8,0,0,0,0,17102,7.2,19068,219,56,2763,2232,21.9,1710.2,15,2,1,2,7,1,0,0,0,0,14339,6.8,16836,229,42,-2763,-2232,22.9,1433.9
4512764436,1,29,2,1,6,2,8,0,0,0,0,16523,7.0,18018,196,60,1652,701,19.6,1652.3,14,1,0,2,6,1,0,0,0,0,14871,6.4,17317,239,51,-1652,-701,23.9,1487.1
4466270705,1,15,1,1,2,4,3,0,0,0,0,14767,7.2,18018,236,58,-976,-1408,23.6,1476.7,29,0,0,4,2,4,1,0,1,0,15743,7.2,19426,215,59,976,1408,21.5,1574.3
4515261143,1,8,0,1,4,3,2,1,1,0,0,15278,7.0,18693,227,49,734,355,22.7,1527.8,13,1,0,3,4,3,0,0,0,0,14544,7.2,18338,203,50,-734,-355,20.3,1454.4
4511868118,0,15,2,1,5,3,9,0,0,0,0,15692,6.4,16690,206,51,482,-2053,20.6,1569.2,39,4,0,3,5,2,1,0,1,0,15210,7.2,18743,235,54,-482,2053,23.5,1521.0
4525924001,1,16,12,1,9,4,8,1,1,0,0,17915,7.0,19615,225,56,1963,781,22.5,1791.5,36,4,0,4,9,1,0,0,0,0,15952,7.2,18834,258,56,-1963,-781,25.8,1595.2
4496662443,1,15,4,0,5,6,9,2,1,1,1,17450,6.6,17226,226,53,555,-1022,22.6,1745.0,19,3,1,6,5,12,0,0,0,0,16895,7.0,18248,232,50,-555,1022,23.2,1689.5
4525070748,0,19,2,1,9,3,8,0,0,0,0,17049,6.8,17241,202,41,1863,328,20.2,1704.9,17,2,0,3,9,5,0,0,0,0,15186,6.8,16913,204,58,-1863,-328,20.4,1518.6
4462140519,1,14,4,0,11,7,13,1,1,0,0,18877,7.2,19556,209,54,1711,1767,20.9,1887.7,15,3,1,7,11,7,0,0,0,0,17166,7.0,17789,215,46,-1711,-1767,21.5,1716.6
4520971034,0,17,1,0,12,9,11,1,0,1,0,18325,7.4,19498,190,55,793,1612,19.0,1832.5,10,0,1,9,12,7,1,1,0,0,17532,6.8,17886,208,40,-793,-1612,20.8,1753.2
4459085850,1,13,1,1,9,8,12,1,1,0,0,18254,7.2,18805,218,52,844,1636,21.8,1825.4,18,1,0,8,9,15,1,0,1,0,17410,6.8,17169,183,52,-844,-1636,18.3,1741.0
4477615327,0,15,2,1,7,4,10,2,1,1,0,17256,7.0,18265,228,64,1177,226,22.8,1725.6,14,1,0,4,7,6,0,0,0,0,16079,6.8,18039,217,51,-1177,-226,21.7,1607.9
4469128584,1,87,2,1,6,6,9,0,0,0,0,16369,7.0,18278,201,40,311,-50,20.1,1636.9,13,3,0,6,6,5,0,0,0,0,16058,7.2,18328,216,52,-311,50,21.6,1605.8
4512249103,1,12,1,0,5,9,2,0,0,0,0,16055,6.8,17800,226,50,6,1624,22.6,1605.5,13,1,1,9,5,15,1,1,0,0,16049,6.6,16176,160,40,-6,-1624,16.0,1604.9
4491875550,1,38,1,1,7,5,4,1,1,0,0,16605,7.0,18407,199,61,-643,508,19.9,1660.5,17,3,0,5,7,5,1,0,1,1,17248,6.8,17899,241,46,643,-508,24.1,1724.8
4508425453,1,185,2,0,10,12,5,0,0,0,0,17849,7.2,18632,184,52,-287,255,18.4,1784.9,27,3,1,12,10,9,0,0,0,0,18136,6.8,18377,210,36,287,-255,21.0,1813.6
4525018915,0,20,5,1,4,6,4,0,0,0,0,15688,6.6,16920,226,53,-162,-553,22.6,1568.8,20,7,0,6,4,10,0,0,0,0,15850,7.0,17473,233,44,162,553,23.3,1585.0
4518861669,1,19,2,1,6,4,7,1,1,0,0,17084,7.2,18215,227,59,2439,2070,22.7,1708.4,44,3,0,4,6,9,0,0,0,0,14645,6.6,16145,208,45,-2439,-2070,20.8,1464.5
4480070649,1,20,0,1,10,3,8,0,0,0,0,17648,7.2,18419,181,56,3525,2979,18.1,1764.8,14,3,0,3,10,4,0,0,0,0,14123,6.4,15440,183,44,-3525,-2979,18.3,1412.3
4520992156,0,16,3,0,4,9,4,0,0,0,0,14837,6.6,17437,209,48,-4715,-1691,20.9,1483.7,12,5,1,9,4,10,2,1,1,1,19552,7.4,19128,239,44,4715,1691,23.9,1955.2
4514070207,1,18,3,0,4,8,2,2,1,1,0,14752,6.8,16831,209,44,-2511,-2094,20.9,1475.2,17,8,1,8,4,10,0,0,0,0,17263,7.4,18925,242,61,2511,2094,24.2,1726.3
4527853173,0,17,0,0,2,8,1,0,0,0,0,13446,6.4,15500,190,32,-4676,-3551,19.0,1344.6,10,6,1,8,2,9,2,1,1,0,18122,7.2,19051,243,50,4676,3551,24.3,1812.2
4509064121,1,45,0,1,13,1,18,0,0,0,0,18917,7.6,19563,226,48,4611,3311,22.6,1891.7,84,0,0,1,13,1,0,0,0,0,14306,6.6,16252,213,48,-4611,-3311,21.3,1430.6
4522580950,1,41,13,1,2,4,3,1,0,1,0,15180,7.0,18148,225,68,-986,-1508,22.5,1518.0,40,1,0,4,2,3,1,1,0,0,16166,7.6,19656,235,76,986,1508,23.5,1616.6
4452015662,1,12,2,1,3,5,5,2,1,1,0,15188,6.8,17576,221,48,-888,-975,22.1,1518.8,16,3,0,5,3,5,0,0,0,0,16076,7.0,18551,192,59,888,975,19.2,1607.6
4524176284,1,16,1,1,6,4,4,1,1,0,0,16540,6.8,18026,230,60,-41,307,23.0,1654.0,13,4,0,4,6,5,1,0,1,0,16581,6.6,17719,254,42,41,-307,25.4,1658.1
4423136265,1,16,1,1,6,4,6,0,0,0,0,16184,6.8,18288,224,48,-382,-247,22.4,1618.4,16,5,0,4,6,6,0,0,0,0,16566,7.2,18535,242,59,382,247,24.2,1656.6
4498316560,0,17,2,1,8,5,9,1,1,0,0,17172,7.0,18972,196,60,1131,1145,19.6,1717.2,13,2,0,5,8,5,1,0,1,0,16041,6.8,17827,231,56,-1131,-1145,23.1,1604.1
4527276580,1,17,1,1,6,3,5,1,1,0,0,16563,7.0,18392,215,52,1786,-5,21.5,1656.3,13,0,0,3,6,2,0,0,0,0,14777,7.0,18397,201,63,-1786,5,20.1,1477.7
4522465523,1,13,3,0,8,7,10,1,1,0,0,18261,7.4,18602,248,65,1753,935,24.8,1826.1,15,4,1,7,8,8,0,0,0,0,16508,7.0,17667,218,41,-1753,-935,21.8,1650.8
4447227454,1,14,1,1,5,2,7,1,1,0,0,16443,7.0,18538,238,48,1717,508,23.8,1644.3,12,0,0,2,5,4,0,0,0,0,14726,7.0,18030,197,60,-1717,-508,19.7,1472.6
4501385353,1,53,3,1,12,5,17,0,0,0,0,17838,6.8,17217,194,42,2554,1453,19.4,1783.8,18,3,0,5,12,5,0,0,0,0,15284,6.4,15764,215,41,-2554,-1453,21.5,1528.4
4493623351,1,22,2,1,6,6,4,2,1,1,0,16043,7.0,18113,213,56,-76,1720,21.3,1604.3,14,1,0,6,6,8,0,0,0,0,16119,6.6,16393,206,40,76,-1720,20.6,1611.9
4509468172,0,34,4,0,6,7,0,1,0,1,0,16338,7.0,18577,223,64,-524,468,22.3,1633.8,17,3,1,7,6,11,1,1,0,0,16862,7.0,18109,209,41,524,-468,20.9,1686.2
4526858516,0,18,6,1,1,5,0,1,1,0,0,14524,6.4,16989,234,64,-2527,-1697,23.4,1452.4,18,3,0,5,1,7,1,0,1,0,17051,7.0,18686,238,42,2527,1697,23.8,1705.1
4484101947,0,14,1,1,2,5,2,0,0,0,0,14985,7.0,17710,224,60,-1522,-1437,22.4,1498.5,14,2,0,5,2,5,1,1,0,0,16507,7.2,19147,253,56,1522,1437,25.3,1650.7
4456258019,0,12,3,0,6,4,9,0,0,0,0,16628,7.0,18812,216,60,1457,715,21.6,1662.8,14,1,1,4,6,4,1,1,0,0,15171,7.2,18097,208,40,-1457,-715,20.8,1517.1
4467196417,1,34,5,1,12,5,8,0,0,0,0,19313,7.8,21625,237,56,4185,3858,23.7,1931.3,14,0,0,5,12,2,0,0,0,0,15128,7.2,17767,182,68,-4185,-3858,18.2,1512.8
4521099004,1,38,4,1,16,5,28,0,0,0,0,21089,7.0,18924,218,55,5859,3289,21.8,2108.9,22,3,0,5,16,7,0,0,0,0,15230,6.4,15635,205,41,-5859,-3289,20.5,1523.0
4491168583,1,51,4,0,7,5,14,1,1,0,0,17075,7.0,18159,230,52,462,579,23.0,1707.5,17,4,1,5,7,6,0,0,0,0,16613,6.6,17580,224,51,-462,-579,22.4,1661.3
4477701411,1,17,5,0,6,10,7,1,0,1,0,16100,7.0,17451,192,60,-2907,-1376,19.2,1610.0,18,3,1,10,6,9,1,1,0,0,19007,7.2,18827,260,40,2907,1376,26.0,1900.7
4502764370,0,13,2,1,9,6,17,0,0,0,0,17333,6.8,17113,209,43,1936,1447,20.9,1733.3,18,1,0,6,9,5,0,0,0,0,15397,6.4,15666,197,40,-1936,-1447,19.7,1539.7
4438606528,1,23,3,0,10,3,9,1,1,0,0,18334,7.0,18032,225,40,3485,2447,22.5,1833.4,14,1,1,3,10,3,0,0,0,0,14849,6.4,15585,188,32,-3485,-2447,18.8,1484.9
4500845226,1,18,4,1,5,1,5,2,1,1,0,16951,7.2,18681,270,43,1341,-85,27.0,1695.1,77,4,0,1,5,1,0,0,0,0,15610,7.2,18766,254,76,-1341,85,25.4,1561.0
4527418646,0,14,1,0,6,8,8,0,0,0,0,15193,6.4,16021,199,45,-2162,-1230,19.9,1519.3,13,2,1,8,6,11,1,1,0,0,17355,6.6,17251,205,45,2162,1230,20.5,1735.5
4482482069,1,12,0,1,8,10,9,1,1,0,0,16795,6.8,18177,203,43,-1381,-907,20.3,1679.5,14,0,0,10,8,9,0,0,0,0,18176,7.2,19084,221,60,1381,907,22.1,1817.6
4488482640,0,16,1,1,6,6,4,0,0,0,0,16485,7.2,18589,220,44,-750,-906,22.0,1648.5,12,2,0,6,6,6,1,1,0,0,17235,7.4,19495,242,64,750,906,24.2,1723.5
4494990363,1,19,3,1,12,6,16,2,1,1,0,18021,7.2,18556,202,37,1373,1766,20.2,1802.1,16,5,0,6,12,10,0,0,0,0,16648,6.4,16790,200,43,-1373,-1766,20.0,1664.8
4523321677,0,12,0,0,5,4,5,1,0,1,1,16888,7.2,18334,225,40,1063,-391,22.5,1688.8,14,1,1,4,5,2,1,1,0,0,15825,7.0,18725,231,55,-1063,391,23.1,1582.5
4480798079,1,18,4,0,5,6,4,0,0,0,1,17350,7.2,18857,202,72,1492,1607,20.2,1735.0,17,5,1,6,5,9,1,1,0,0,15858,7.0,17250,191,44,-1492,-1607,19.1,1585.8
4502271780,0,9,2,0,4,8,2,0,0,0,0,15901,6.8,18288,233,55,-1333,284,23.3,1590.1,14,0,1,8,4,13,1,1,0,0,17234,7.0,18004,214,40,1333,-284,21.4,1723.4
4489674580,1,14,0,1,12,7,13,0,0,0,0,18291,7.2,18548,176,53,2182,1012,17.6,1829.1,13,2,0,7,12,4,0,0,0,0,16109,6.8,17536,210,48,-2182,-1012,21.0,1610.9
4527078434,0,17,2,1,5,6,10,1,0,1,0,14566,6.4,16031,182,37,-2061,-2046,18.2,1456.6,11,0,0,6,5,7,1,1,0,0,16627,7.0,18077,200,50,2061,2046,20.0,1662.7
4447263506,0,16,1,1,5,1,0,1,1,0,0,16117,7.2,19109,221,60,2975,3977,22.1,1611.7,13,2,0,1,5,1,0,0,0,0,13142,6.2,15132,182,42,-2975,-3977,18.2,1314.2
4521090757,1,110,3,0,2,3,5,0,0,0,0,15186,7.2,18537,236,67,-35,1112,23.6,1518.6,19,3,1,3,2,4,0,0,0,0,15221,6.8,17425,236,48,35,-1112,23.6,1522.1
4521617459,1,15,2,1,13,4,23,0,0,0,0,18957,7.4,19663,222,68,2842,1659,22.2,1895.7,15,3,0,4,13,7,1,1,0,0,16115,6.8,18004,238,64,-2842,-1659,23.8,1611.5
4507914365,1,20,4,1,11,6,15,1,0,1,0,19670,7.4,19683,239,52,3380,1666,23.9,1967.0,16,6,0,6,11,10,0,0,0,0,16290,7.0,18017,197,52,-3380,-1666,19.7,1629.0
4458821215,1,18,4,1,2,6,1,2,1,1,0,14448,6.8,17294,198,68,-2279,-958,19.8,1444.8,27,4,0,6,2,7,0,0,0,0,16727,7.2,18252,239,40,2279,958,23.9,1672.7
4474588712,0,14,4,1,9,4,8,0,0,0,0,18471,7.4,19497,225,65,3252,2304,22.5,1847.1,15,3,0,4,9,3,1,1,0,0,15219,6.8,17193,201,62,-3252,-2304,20.1,1521.9
4524652479,0,18,2,0,1,5,2,1,1,0,0,14445,6.8,17594,232,61,-925,41,23.2,1444.5,13,2,1,5,1,9,0,0,0,0,15370,7.0,17553,211,52,925,-41,21.1,1537.0
4519983082,1,17,2,0,7,10,9,0,0,0,0,16282,6.8,16826,198,45,-1516,-1467,19.8,1628.2,16,4,1,10,7,10,2,1,1,0,17798,6.8,18293,201,47,1516,1467,20.1,1779.8
4464924793,0,38,4,0,4,11,3,0,0,0,0,15939,6.8,17619,253,40,-1874,-1182,25.3,1593.9,77,6,1,11,4,7,1,0,1,0,17813,7.0,18801,221,36,1874,1182,22.1,1781.3
4500333234,1,34,3,1,5,3,5,2,1,1,0,17018,7.4,20337,262,60,1496,1664,26.2,1701.8,16,2,0,3,5,2,0,0,0,0,15522,7.2,18673,253,59,-1496,-1664,25.3,1552.2
4518558277,1,15,3,0,9,3,14,1,1,0,0,17693,6.8,17892,201,36,4282,1993,20.1,1769.3,14,4,1,3,9,1,0,0,0,0,13411,6.6,15899,149,47,-4282,-1993,14.9,1341.1
4511011052,1,37,4,0,19,3,25,0,0,0,1,23278,7.8,22125,240,48,8667,7645,24.0,2327.8,15,3,1,3,19,7,0,0,0,0,14611,6.2,14480,189,46,-8667,-7645,18.9,1461.1
4505664040,1,14,4,1,11,2,9,0,0,0,0,19250,7.6,19703,251,48,5096,3310,25.1,1925.0,15,3,0,2,11,2,0,0,0,0,14154,6.4,16393,196,53,-5096,-3310,19.6,1415.4
4473157317,0,21,4,1,5,2,5,1,1,0,0,16724,7.0,18895,229,64,2432,1875,22.9,1672.4,17,0,0,2,5,3,0,0,0,0,14292,6.6,17020,221,44,-2432,-1875,22.1,1429.2
4517738815,1,16,2,1,4,6,3,0,0,0,0,15865,7.0,18037,225,50,-517,-425,22.5,1586.5,16,2,0,6,4,8,1,1,0,0,16382,6.8,18462,244,45,517,425,24.4,1638.2
4521716722,1,17,1,1,4,8,2,0,0,0,0,16152,7.0,18347,212,59,-633,-502,21.2,1615.2,139,2,0,8,4,14,1,1,0,0,16785,7.0,18849,196,53,633,502,19.6,1678.5
4465445670,0,14,4,1,9,1,5,0,0,0,0,17773,7.2,18937,236,46,4257,2902,23.6,1777.3,14,3,0,1,9,1,0,0,0,0,13516,6.4,16035,204,53,-4257,-2902,20.4,1351.6
4523527545,0,16,0,1,4,10,2,0,0,0,0,13980,6.2,15464,181,43,-4330,-4347,18.1,1398.0,23,2,0,10,4,12,0,0,0,0,18310,7.4,19811,228,44,4330,4347,22.8,1831.0
4497961157,1,14,2,0,10,5,7,1,1,0,0,17687,6.8,18625,213,56,2159,2100,21.3,1768.7,15,2,1,5,10,5,0,0,0,0,15528,6.8,16525,180,52,-2159,-2100,18.0,1552.8
4477843877,1,16,5,1,4,4,8,1,1,0,0,16667,7.2,18290,239,60,1692,373,23.9,1666.7,15,5,0,4,4,3,1,0,1,0,14975,6.8,17917,209,44,-1692,-373,20.9,1497.5
4520891327,0,15,0,0,5,4,5,1,1,0,0,15740,7.0,17449,206,56,-312,-473,20.6,1574.0,13,2,1,4,5,5,0,0,0,0,16052,6.8,17922,229,47,312,473,22.9,1605.2
4500454224,1,15,1,0,2,8,2,1,1,0,0,15467,7.0,18928,228,63,-2524,-376,22.8,1546.7,15,1,1,8,2,6,0,0,0,0,17991,7.0,19304,252,56,2524,376,25.2,1799.1
4527144982,1,51,4,1,7,5,7,0,0,0,0,17549,7.4,19400,239,54,2588,1353,23.9,1754.9,13,1,0,5,7,6,0,0,0,0,14961,6.6,18047,192,50,-2588,-1353,19.2,1496.1
4522288723,1,17,3,1,6,3,9,1,1,0,0,16198,6.8,17866,226,44,1873,1987,22.6,1619.8,18,2,0,3,6,4,0,0,0,0,14325,6.4,15879,179,44,-1873,-1987,17.9,1432.5
4526793578,0,15,0,1,5,9,4,0,0,0,0,17292,7.0,18087,238,63,-689,-266,23.8,1729.2,11,3,0,9,5,18,1,1,0,0,17981,7.0,18353,214,44,689,266,21.4,1798.1
4516905603,1,15,1,0,7,8,8,0,0,0,1,18283,7.0,18662,209,60,905,312,20.9,1828.3,15,3,1,8,7,6,1,1,0,0,17378,7.0,18350,206,61,-905,-312,20.6,1737.8
4516180818,1,20,1,1,5,6,6,1,1,0,0,16035,6.8,16853,190,63,-608,-703,19.0,1603.5,47,6,0,6,5,8,0,0,0,0,16643,6.8,17556,210,48,608,703,21.0,1664.3
4490186049,1,15,4,0,4,4,1,2,1,1,0,16292,7.2,18889,274,50,1229,1059,27.4,1629.2,18,2,1,4,4,2,0,0,0,0,15063,7.0,17830,220,50,-1229,-1059,22.0,1506.3
4519247405,1,16,3,0,3,5,4,1,1,0,0,15501,7.0,17414,245,40,-257,-180,24.5,1550.1,55,2,1,5,3,7,0,0,0,0,15758,6.8,17594,199,52,257,180,19.9,1575.8
4499825635,1,16,0,1,8,2,10,0,0,0,0,18330,7.4,19257,232,52,1769,319,23.2,1833.0,38,1,0,2,8,1,2,1,1,1,16561,7.2,18938,251,67,-1769,-319,25.1,1656.1
4502961112,1,15,4,0,5,5,6,0,0,0,0,15413,6.4,16314,210,36,-3,-765,21.0,1541.3,17,1,1,5,5,4,0,0,0,0,15416,6.6,17079,221,47,3,765,22.1,1541.6
4495044073,1,15,2,0,4,7,5,0,0,0,0,15013,6.6,16013,210,41,-1937,-1459,21.0,1501.3,11,3,1,7,4,10,1,0,1,0,16950,6.8,17472,197,52,1937,1459,19.7,1695.0
4484373881,0,17,1,1,6,4,8,2,1,1,0,17249,7.0,18964,239,56,1095,768,23.9,1724.9,12,4,0,4,6,6,0,0,0,0,16154,7.0,18196,247,56,-1095,-768,24.7,1615.4
4527750562,0,37,4,1,5,7,6,0,0,0,0,15993,6.8,17528,206,48,-645,-448,20.6,1599.3,19,5,0,7,5,9,1,1,0,0,16638,6.8,17976,197,64,645,448,19.7,1663.8
4522067733,0,17,0,0,1,7,0,0,0,0,0,14266,6.8,17850,222,56,-3389,-1855,22.2,1426.6,39,3,1,7,1,9,2,1,1,0,17655,7.4,19705,231,76,3389,1855,23.1,1765.5
4515973150,0,57,4,0,3,6,4,0,0,0,0,15426,7.2,18766,212,79,-1672,-470,21.2,1542.6,60,9,1,6,3,6,1,1,0,0,17098,7.2,19236,259,56,1672,470,25.9,1709.8
4525024153,1,17,2,0,8,8,5,0,0,0,0,17871,7.4,18848,243,52,1591,1901,24.3,1787.1,21,3,1,8,8,11,1,1,0,0,16280,6.6,16947,197,43,-1591,-1901,19.7,1628.0
4524450290,0,17,6,0,4,2,2,0,0,0,0,14841,7.0,17969,183,72,-224,635,18.3,1484.1,41,4,1,2,4,2,2,1,1,0,15065,6.8,17334,234,56,224,-635,23.4,1506.5
4512775669,0,13,2,1,5,2,5,1,1,0,0,15767,7.0,17413,224,52,384,-690,22.4,1576.7,16,3,0,2,5,3,1,0,1,0,15383,7.0,18103,250,48,-384,690,25.0,1538.3
4476445956,0,16,2,0,4,11,2,2,1,1,0,14657,6.8,16983,188,59,-3113,-1771,18.8,1465.7,20,1,1,11,4,20,0,0,0,0,17770,7.2,18754,201,45,3113,1771,20.1,1777.0
4524953398,0,15,2,1,5,13,3,0,0,0,0,15557,6.6,16910,190,65,-4197,-2772,19.0,1555.7,21,0,0,13,5,20,1,1,0,0,19754,7.2,19682,228,46,4197,2772,22.8,1975.4
4474893713,1,16,1,1,12,7,14,2,1,1,0,19592,7.2,19231,235,53,3214,2261,23.5,1959.2,54,1,0,7,12,5,0,0,0,0,16378,7.0,16970,184,49,-3214,-2261,18.4,1637.8
4451681116,0,12,2,1,2,6,1,0,0,0,0,14824,7.0,17975,214,59,-2465,-911,21.4,1482.4,14,2,0,6,2,6,1,0,1,0,17289,7.2,18886,243,60,2465,911,24.3,1728.9
4522556160,0,23,3,0,4,6,5,0,0,0,0,16467,7.2,18715,261,56,-530,-123,26.1,1646.7,19,3,1,6,4,8,1,1,0,0,16997,7.0,18838,227,64,530,123,22.7,1699.7
4517679097,0,13,3,0,7,5,8,1,1,0,0,17182,7.2,18588,233,64,1276,1161,23.3,1718.2,16,1,1,5,7,8,0,0,0,0,15906,6.8,17427,213,52,-1276,-1161,21.3,1590.6
4442569713,1,16,4,1,10,5,8,1,1,0,0,18633,6.8,18488,231,44,4235,3554,23.1,1863.3,15,3,0,5,10,4,0,0,0,0,14398,6.2,14934,164,48,-4235,-3554,16.4,1439.8
4486000436,0,18,2,0,3,9,4,1,1,0,0,15280,6.6,16614,220,50,-2034,-1071,22.0,1528.0,19,5,1,9,3,17,0,0,0,0,17314,6.8,17685,220,37,2034,1071,22.0,1731.4
4516668528,0,16,3,1,6,7,10,0,0,0,0,16245,6.8,16720,215,34,-713,-1111,21.5,1624.5,18,3,0,7,6,5,1,1,0,0,16958,6.8,17831,207,47,713,1111,20.7,1695.8
4514199530,1,114,1,0,5,7,3,0,0,0,0,15715,7.0,17843,237,46,-1425,-1296,23.7,1571.5,12,1,1,7,5,9,0,0,0,0,17140,7.4,19139,228,60,1425,1296,22.8,1714.0
4520894516,0,38,4,1,5,7,4,0,0,0,0,16562,7.2,18781,210,64,44,170,21.0,1656.2,21,1,0,7,5,8,1,1,0,0,16518,7.0,18611,245,36,-44,-170,24.5,1651.8
4519632042,1,49,2,0,5,4,6,0,0,0,0,15217,7.0,18056,195,49,-784,754,19.5,1521.7,16,9,1,4,5,5,1,1,0,0,16001,6.6,17302,238,54,784,-754,23.8,1600.1
4517957834,0,19,2,1,6,7,8,0,0,0,0,16067,6.8,17256,190,48,-1176,-671,19.0,1606.7,16,4,0,7,6,7,2,1,1,0,17243,7.2,17927,220,47,1176,671,22.0,1724.3
4510530318,0,16,2,0,1,11,0,0,0,0,0,13206,6.6,15553,195,36,-6001,-5404,19.5,1320.6,20,6,1,11,1,6,1,1,0,0,19207,7.4,20957,244,64,6001,5404,24.4,1920.7
4500668371,0,14,2,0,2,9,3,0,0,0,0,14433,6.4,15908,210,42,-4395,-4086,21.0,1443.3,17,4,1,9,2,9,2,1,1,1,18828,7.4,19994,219,63,4395,4086,21.9,1882.8
4523328232,1,14,2,1,7,6,9,1,0,1,1,18273,6.8,17500,207,48,2544,862,20.7,1827.3,16,4,0,6,7,11,1,1,0,0,15729,6.6,16638,185,48,-2544,-862,18.5,1572.9
4504943058,1,22,3,1,6,6,7,0,0,0,0,17078,7.0,17751,224,46,-304,-1023,22.4,1707.8,85,5,0,6,6,6,1,1,0,0,17382,7.0,18774,240,45,304,1023,24.0,1738.2
4506593398,1,33,4,1,8,6,11,2,1,1,0,16813,6.8,18065,200,52,70,508,20.0,1681.3,37,2,0,6,8,9,0,0,0,0,16743,6.8,17557,204,56,-70,-508,20.4,1674.3
4524997224,0,18,3,0,2,5,1,1,1,0,0,14579,6.8,17772,218,67,-1684,-772,21.8,1457.9,15,3,1,5,2,3,0,0,0,0,16263,7.2,18544,226,64,1684,772,22.6,1626.3
4424200095,0,16,3,1,9,9,10,1,1,0,0,17168,6.8,17668,212,40,-25,1849,21.2,1716.8,21,3,0,9,9,10,0,0,0,0,17193,6.6,15819,196,32,25,-1849,19.6,1719.3
4472951560,1,21,4,0,13,8,16,1,1,0,0,19865,7.2,18655,225,39,2819,1294,22.5,1986.5,14,4,1,8,13,8,0,0,0,0,17046,6.8,17361,210,44,-2819,-1294,21.0,1704.6
4510322898,1,16,4,1,9,2,12,1,1,0,0,17664,7.0,17554,221,46,2946,1011,22.1,1766.4,13,5,0,2,9,4,0,0,0,0,14718,6.6,16543,236,46,-2946,-1011,23.6,1471.8
4524417546,1,11,2,0,3,5,5,1,1,0,0,15310,7.2,18085,228,52,-354,-8,22.8,1531.0,61,2,1,5,3,2,0,0,0,0,15664,7.0,18093,239,43,354,8,23.9,1566.4
4525023717,0,15,1,1,6,5,4,0,0,0,0,16287,6.6,17787,226,52,25,2,22.6,1628.7,13,2,0,5,6,9,0,0,0,0,16262,6.8,17785,226,45,-25,-2,22.6,1626.2
4514235759,1,15,0,0,9,8,5,1,0,1,0,17149,6.8,17767,211,35,-417,-1028,21.1,1714.9,39,4,1,8,9,6,1,1,0,0,17566,7.0,18795,215,61,417,1028,21.5,1756.6
4509128702,0,14,2,0,3,7,3,0,0,0,0,14794,6.8,17179,185,50,-2124,-1109,18.5,1479.4,10,2,1,7,3,7,1,1,0,0,16918,7.0,18288,217,68,2124,1109,21.7,1691.8
4470749064,1,16,1,0,6,7,6,0,0,0,0,16881,7.0,18851,228,56,-216,301,22.8,1688.1,13,2,1,7,6,6,0,0,0,0,17097,7.0,18550,233,44,216,-301,23.3,1709.7
4515979529,0,41,3,1,5,1,5,1,1,0,0,16224,7.2,18401,233,52,1697,1110,23.3,1622.4,15,3,0,1,5,1,0,0,0,0,14527,6.6,17291,238,60,-1697,-1110,23.8,1452.7
4465803971,0,18,0,1,6,9,7,1,0,1,1,17077,6.8,16829,175,49,-995,-1497,17.5,1707.7,14,3,0,9,6,10,1,1,0,0,18072,7.2,18326,228,40,995,1497,22.8,1807.2
4502030084,0,20,1,0,4,7,4,0,0,0,0,14696,6.6,16517,202,41,-2688,-1172,20.2,1469.6,53,4,1,7,4,5,1,1,0,0,17384,7.0,17689,212,56,2688,1172,21.2,1738.4
4500743979,0,13,2,0,2,10,1,0,0,0,0,14227,6.6,16822,205,44,-2617,-2322,20.5,1422.7,15,1,1,10,2,11,1,1,0,0,16844,7.2,19144,208,40,2617,2322,20.8,1684.4
4459704027,1,18,19,1,5,2,7,1,1,0,0,16858,7.2,18543,251,39,2407,939,25.1,1685.8,43,1,0,2,5,3,0,0,0,0,14451,6.6,17604,221,44,-2407,-939,22.1,1445.1
4503648979,1,20,5,1,8,2,7,1,1,0,0,17011,7.2,17776,194,55,2659,2757,19.4,1701.1,39,2,0,2,8,2,0,0,0,0,14352,6.0,15019,201,37,-2659,-2757,20.1,1435.2
4520080755,1,18,3,0,7,3,10,1,1,0,0,16892,7.0,18221,207,64,2391,1726,20.7,1689.2,15,0,1,3,7,1,0,0,0,0,14501,6.6,16495,190,47,-2391,-1726,19.0,1450.1
4506832120,1,19,3,0,13,10,7,0,0,0,0,18388,7.0,18350,185,36,535,776,18.5,1838.8,18,3,1,10,13,10,0,0,0,0,17853,7.0,17574,198,56,-535,-776,19.8,1785.3
4505778188,1,15,0,1,7,3,8,0,0,0,0,16702,6.8,17865,203,54,1713,1391,20.3,1670.2,15,4,0,3,7,6,0,0,0,0,14989,6.6,16474,228,42,-1713,-1391,22.8,1498.9
4477278221,1,19,5,1,8,6,7,1,0,1,1,18203,6.8,17893,248,32,2297,392,24.8,1820.3,16,4,0,6,8,6,1,1,0,0,15906,6.8,17501,193,52,-2297,-392,19.3,1590.6
4464937851,0,17,1,0,7,7,7,1,1,0,0,16645,6.8,18070,231,44,-742,-750,23.1,1664.5,13,0,1,7,7,5,0,0,0,0,17387,7.0,18820,223,72,742,750,22.3,1738.7
4525939655,0,15,1,0,11,9,10,1,1,0,0,17480,6.6,17096,203,39,-366,-923,20.3,1748.0,17,1,1,9,11,10,0,0,0,0,17846,6.6,18019,217,60,366,923,21.7,1784.6
4498002913,1,12,0,0,7,8,7,0,0,0,0,16697,7.0,18511,211,43,-864,-865,21.1,1669.7,13,3,1,8,7,8,0,0,0,0,17561,7.2,19376,226,52,864,865,22.6,1756.1
4515457790,1,32,0,1,4,1,3,0,0,0,0,16454,7.6,19703,241,60,2711,2693,24.1,1645.4,122,1,0,1,4,1,0,0,0,0,13743,6.6,17010,211,55,-2711,-2693,21.1,1374.3
4509680666,0,16,2,0,4,14,2,0,0,0,0,14450,6.4,15750,186,38,-4637,-3355,18.6,1445.0,15,4,1,14,4,19,0,0,0,0,19087,7.2,19105,210,54,4637,3355,21.0,1908.7
4494572826,0,39,4,0,1,5,1,0,0,0,0,13936,6.6,16231,235,45,-2566,-1797,23.5,1393.6,15,2,1,5,1,5,1,1,0,0,16502,7.0,18028,264,51,2566,1797,26.4,1650.2
4509965953,0,15,4,0,2,11,1,0,0,0,0,14316,6.6,16505,214,48,-4885,-2721,21.4,1431.6,18,2,1,11,2,12,2,1,1,0,19201,7.4,19226,249,55,4885,2721,24.9,1920.1
4521690079,1,16,5,0,6,7,4,0,0,0,0,16286,6.8,18048,230,52,-396,795,23.0,1628.6,16,3,1,7,6,3,1,1,0,0,16682,6.6,17253,229,55,396,-795,22.9,1668.2
4516741439,0,12,2,0,6,7,6,0,0,0,0,16685,6.6,17126,223,44,17,-1180,22.3,1668.5,13,2,1,7,6,4,1,1,0,0,16668,7.0,18306,175,61,-17,1180,17.5,1666.8
4516194928,0,17,3,0,4,10,10,0,0,0,0,15928,6.8,17242,204,56,-2760,-1949,20.4,1592.8,12,3,1,10,4,13,1,1,0,0,18688,7.2,19191,233,55,2760,1949,23.3,1868.8
4494902684,1,32,2,0,7,8,8,1,1,0,0,16284,7.4,19396,197,44,-496,604,19.7,1628.4,37,4,1,8,7,7,0,0,0,0,16780,7.0,18792,209,48,496,-604,20.9,1678.0
4524360641,1,14,2,1,8,4,11,0,0,0,0,17299,6.8,17445,233,32,2406,1503,23.3,1729.9,16,0,0,4,8,2,0,0,0,0,14893,6.2,15942,194,49,-2406,-1503,19.4,1489.3
4526331089,0,14,3,0,5,6,3,1,1,0,0,15367,7.2,18799,217,56,-2021,-768,21.7,1536.7,16,4,1,6,5,7,0,0,0,0,17388,7.4,19567,238,68,2021,768,23.8,1738.8
4525859252,1,16,3,1,8,4,9,2,1,1,0,17315,7.0,18205,231,51,1327,566,23.1,1731.5,79,6,0,4,8,5,0,0,0,0,15988,6.8,17639,232,50,-1327,-566,23.2,1598.8
4512161240,1,17,5,1,8,7,4,1,0,1,0,17505,7.2,19027,236,48,1014,850,23.6,1750.5,18,2,0,7,8,5,1,1,0,0,16491,7.0,18177,201,60,-1014,-850,20.1,1649.1
4499439386,0,16,3,0,6,3,7,2,1,1,0,16326,7.0,18447,232,44,1165,744,23.2,1632.6,15,2,1,3,6,3,0,0,0,0,15161,7.0,17703,231,53,-1165,-744,23.1,1516.1
4508352698,0,18,4,0,1,5,0,0,0,0,0,13533,6.4,15497,212,35,-2191,-1498,21.2,1353.3,42,5,1,5,1,9,1,1,0,0,15724,6.8,16995,207,50,2191,1498,20.7,1572.4
4521217468,0,42,8,0,5,10,4,1,1,0,0,15876,6.8,17206,224,39,-2266,-2047,22.4,1587.6,20,5,1,10,5,9,1,0,1,0,18142,7.2,19253,221,60,2266,2047,22.1,1814.2
4521449532,0,13,1,0,2,13,0,0,0,0,0,13049,6.2,14294,163,52,-6395,-4800,16.3,1304.9,56,3,1,13,2,20,2,1,1,0,19444,7.2,19094,239,52,6395,4800,23.9,1944.4
4525056568,0,18,4,0,2,7,0,0,0,0,0,13791,6.6,16437,191,62,-2262,-1391,19.1,1379.1,18,3,1,7,2,4,1,1,0,0,16053,6.8,17828,218,48,2262,1391,21.8,1605.3
4452314277,0,19,2,0,4,7,5,1,0,1,0,15214,6.8,16970,211,40,-802,-842,21.1,1521.4,15,5,1,7,4,6,1,1,0,0,16016,6.8,17812,209,52,802,842,20.9,1601.6
4501521847,1,90,3,1,13,5,17,1,1,0,0,18787,7.0,17878,193,40,3886,1777,19.3,1878.7,14,3,0,5,13,5,0,0,0,0,14901,6.6,16101,175,43,-3886,-1777,17.5,1490.1
4522564932,1,81,2,0,6,3,4,0,0,0,0,18314,7.6,21257,257,76,3274,3262,25.7,1831.4,44,0,1,3,6,3,1,1,0,0,15040,7.0,17995,195,72,-3274,-3262,19.5,1504.0
4502024676,1,11,0,1,8,13,5,0,0,0,0,17846,6.8,18045,198,51,-796,-594,19.8,1784.6,15,2,0,13,8,12,0,0,0,0,18642,7.2,18639,194,50,796,594,19.4,1864.2
4490468164,1,15,5,0,4,7,4,0,0,0,0,15777,6.8,17261,229,48,-621,-784,22.9,1577.7,57,1,1,7,4,14,1,1,0,0,16398,7.0,18045,204,56,621,784,20.4,1639.8
4524374262,1,16,1,1,12,13,15,0,0,0,0,17940,6.8,16927,162,41,-2725,-3568,16.2,1794.0,16,3,0,13,12,15,1,1,0,0,20665,7.6,20495,252,48,2725,3568,25.2,2066.5
4512094452,0,14,1,0,11,7,12,1,1,0,0,18096,7.2,18860,222,56,686,350,22.2,1809.6,37,4,1,7,11,7,1,0,1,0,17410,7.0,18510,193,68,-686,-350,19.3,1741.0
4449138530,0,14,4,0,1,4,0,1,0,1,0,14112,6.8,17417,202,52,-1309,351,20.2,1411.2,18,3,1,4,1,7,1,1,0,0,15421,6.6,17066,205,53,1309,-351,20.5,1542.1
4464507584,1,12,2,1,3,7,3,1,1,0,0,14958,6.6,16560,239,56,-2607,-2125,23.9,1495.8,19,2,0,7,3,8,0,0,0,0,17565,7.0,18685,253,56,2607,2125,25.3,1756.5
4472433085,0,53,2,0,3,7,3,0,0,0,0,15162,6.8,18046,227,56,-1980,-973,22.7,1516.2,19,4,1,7,3,5,0,0,0,0,17142,7.2,19019,256,56,1980,973,25.6,1714.2
4477722271,1,35,1,0,4,4,5,0,0,0,0,16349,7.2,18699,253,62,754,13,25.3,1634.9,13,3,1,4,4,3,1,1,0,0,15595,7.2,18686,243,55,-754,-13,24.3,1559.5
4517040983,1,19,3,0,6,4,5,1,1,0,1,17946,7.2,18589,225,64,2398,1573,22.5,1794.6,16,4,1,4,6,2,1,0,1,0,15548,6.6,17016,230,45,-2398,-1573,23.0,1554.8
4459091081,1,15,6,0,5,6,5,1,1,0,0,16941,7.0,19352,228,52,-441,390,22.8,1694.1,83,1,1,6,5,8,0,0,0,0,17382,7.2,18962,233,41,441,-390,23.3,1738.2
4519593233,1,145,3,1,8,6,10,1,0,1,0,17816,7.0,18186,226,47,1789,244,22.6,1781.6,17,3,0,6,8,11,1,1,0,0,16027,6.8,17942,210,60,-1789,-244,21.0,1602.7
4514754903,1,16,2,1,7,2,10,2,1,1,1,18890,7.2,18772,227,67,4234,1695,22.7,1889.0,58,0,0,2,7,3,0,0,0,0,14656,6.6,17077,214,48,-4234,-1695,21.4,1465.6
4492254219,1,18,3,0,8,5,7,1,1,0,0,17393,7.2,19257,219,60,1959,2441,21.9,1739.3,17,4,1,5,8,7,0,0,0,0,15434,6.6,16816,212,43,-1959,-2441,21.2,1543.4
4503795353,1,16,6,0,7,8,7,1,0,1,0,16936,7.0,18077,236,43,-96,827,23.6,1693.6,20,5,1,8,7,8,1,1,0,0,17032,6.8,17250,211,52,96,-827,21.1,1703.2
4506113510,1,16,1,1,10,3,12,1,1,0,0,18177,7.0,18965,219,50,3504,995,21.9,1817.7,16,3,0,3,10,4,0,0,0,0,14673,6.8,17970,214,46,-3504,-995,21.4,1467.3
4524913906,1,11,1,1,9,4,10,0,0,0,0,17495,7.4,19387,178,60,1871,2897,17.8,1749.5,14,0,0,4,9,3,0,0,0,0,15624,6.6,16490,227,40,-1871,-2897,22.7,1562.4
4439417196,1,19,5,1,8,5,9,1,1,0,0,17389,6.8,18252,198,57,836,883,19.8,1738.9,17,3,0,5,8,10,0,0,0,0,16553,6.6,17369,237,56,-836,-883,23.7,1655.3
4526157711,1,52,1,1,9,1,13,2,1,1,0,18159,6.6,16870,217,59,5302,3045,21.7,1815.9,13,0,0,1,9,2,0,0,0,0,12857,6.0,13825,147,48,-5302,-3045,14.7,1285.7
4505985909,1,12,2,0,8,9,7,2,1,1,1,18790,7.2,18604,224,48,1726,-196,22.4,1879.0,72,4,1,9,8,13,0,0,0,0,17064,7.2,18800,195,51,-1726,196,19.5,1706.4
4524926639,0,16,3,1,8,6,12,0,0,0,0,16808,6.8,16741,200,44,616,-87,20.0,1680.8,16,4,0,6,8,8,0,0,0,0,16192,6.6,16828,198,48,-616,87,19.8,1619.2
4489371310,0,12,0,0,1,6,0,0,0,0,0,13977,6.6,17736,208,60,-4097,-1658,20.8,1397.7,31,1,1,6,1,7,0,0,0,0,18074,7.2,19394,226,72,4097,1658,22.6,1807.4
4523056816,1,16,2,1,7,2,8,0,0,0,0,16861,7.2,18561,196,51,2211,1501,19.6,1686.1,33,1,0,2,7,1,1,1,0,0,14650,7.0,17060,208,48,-2211,-1501,20.8,1465.0
4526837498,1,19,5,1,10,0,14,1,1,0,0,20302,7.0,18149,212,52,7577,2363,21.2,2030.2,16,4,0,0,10,0,0,0,0,0,12725,6.6,15786,165,48,-7577,-2363,16.5,1272.5
4469859843,0,15,3,0,6,6,4,1,1,0,0,15412,6.8,17010,197,48,-886,-476,19.7,1541.2,16,3,1,6,6,8,0,0,0,0,16298,6.8,17486,205,52,886,476,20.5,1629.8
4505104327,1,13,2,0,6,7,6,0,0,0,0,16559,7.0,18024,208,54,-1192,-1896,20.8,1655.9,13,5,1,7,6,6,1,1,0,0,17751,7.4,19920,242,77,1192,1896,24.2,1775.1
4481753075,1,16,3,0,4,5,5,0,0,0,0,15375,6.8,17114,200,56,-1270,-2363,20.0,1537.5,17,0,1,5,4,1,1,1,0,0,16645,7.2,19477,273,60,1270,2363,27.3,1664.5
4440143794,1,48,5,0,6,3,8,1,1,0,0,17612,7.6,19905,246,68,2356,2431,24.6,1761.2,19,1,1,3,6,2,0,0,0,0,15256,7.0,17474,213,55,-2356,-2431,21.3,1525.6
4503510396,0,38,1,0,3,4,4,0,0,0,0,14881,6.6,17401,196,48,-1659,-1134,19.6,1488.1,12,3,1,4,3,5,1,1,0,0,16540,7.2,18535,248,63,1659,1134,24.8,1654.0
4525030965,1,36,1,1,11,6,10,1,0,1,0,18849,7.2,19086,220,65,3281,1747,22.0,1884.9,9,4,0,6,11,3,1,1,0,0,15568,6.8,17339,202,56,-3281,-1747,20.2,1556.8
4522027915,0,21,0,1,10,5,7,1,0,1,0,17971,7.2,19214,231,44,3146,1518,23.1,1797.1,12,3,0,5,10,2,1,1,0,0,14825,7.0,17696,181,47,-3146,-1518,18.1,1482.5
4481881840,0,16,1,0,1,9,1,0,0,0,0,14109,6.4,16353,205,52,-3300,-3318,20.5,1410.9,12,0,1,9,1,7,0,0,0,0,17409,7.2,19671,231,39,3300,3318,23.1,1740.9
4500439445,1,18,2,1,4,5,3,0,0,0,0,15846,7.0,18388,214,58,-330,-466,21.4,1584.6,15,3,0,5,4,5,1,1,0,0,16176,7.2,18854,236,52,330,466,23.6,1617.6
4525996242,1,34,6,0,4,11,7,0,0,0,0,15790,6.8,17533,208,47,-2878,-1184,20.8,1579.0,24,10,1,11,4,13,0,0,0,0,18668,7.0,18717,234,44,2878,1184,23.4,1866.8
4517025991,1,11,3,0,9,8,6,2,1,1,0,17385,7.2,18349,216,60,1133,1833,21.6,1738.5,37,1,1,8,9,7,0,0,0,0,16252,6.8,16516,178,28,-1133,-1833,17.8,1625.2
4521931000,0,14,4,0,6,8,3,1,1,0,0,16425,7.0,18433,232,39,-336,-124,23.2,1642.5,15,1,1,8,6,6,0,0,0,0,16761,7.2,18557,197,47,336,124,19.7,1676.1
4522420599,1,16,8,0,7,4,6,1,1,0,0,16296,7.0,18093,222,48,1576,1573,22.2,1629.6,17,3,1,4,7,2,0,0,0,0,14720,6.6,16520,192,53,-1576,-1573,19.2,1472.0
4472501015,1,17,3,1,8,5,11,1,0,1,1,18802,6.8,17609,236,42,3247,576,23.6,1880.2,13,4,0,5,8,4,0,0,0,0,15555,6.8,17033,207,51,-3247,-576,20.7,1555.5
4500809848,0,16,3,0,3,6,1,0,0,0,0,15533,6.8,18287,244,66,-1585,-280,24.4,1553.3,19,2,1,6,3,10,1,1,0,0,17118,7.0,18567,256,60,1585,280,25.6,1711.8
4478343793,1,16,2,1,6,7,4,1,0,1,1,17805,7.0,17597,218,40,1446,-1351,21.8,1780.5,38,1,0,7,6,9,1,1,0,0,16359,7.0,18948,212,45,-1446,1351,21.2,1635.9
4470213868,1,20,1,1,6,2,1,0,0,0,0,17413,7.2,19603,257,66,2646,2305,25.7,1741.3,69,5,0,2,6,2,1,1,0,0,14767,6.6,17298,210,58,-2646,-2305,21.0,1476.7
4522429552,1,17,2,1,7,6,3,0,0,0,0,16611,6.8,18323,216,60,912,505,21.6,1661.1,27,4,0,6,7,6,1,1,0,0,15699,7.0,17818,195,57,-912,-505,19.5,1569.9
4513003533,0,22,3,0,9,10,14,1,1,0,0,16749,6.4,16227,166,48,-2419,-3313,16.6,1674.9,19,1,1,10,9,13,0,0,0,0,19168,7.4,19540,240,39,2419,3313,24.0,1916.8
4526998867,0,17,1,1,3,6,5,2,1,1,0,15390,7.0,17555,230,46,-544,154,23.0,1539.0,14,4,0,6,3,4,0,0,0,0,15934,6.8,17401,216,52,544,-154,21.6,1593.4
4508952905,0,15,3,0,3,4,2,0,0,0,0,14961,7.0,18313,230,52,33,817,23.0,1496.1,24,5,1,4,3,3,1,1,0,0,14928,7.0,17496,191,55,-33,-817,19.1,1492.8
4449478989,1,16,6,1,4,1,4,2,1,1,0,15492,7.0,18241,212,56,1412,737,21.2,1549.2,15,2,0,1,4,0,0,0,0,0,14080,6.8,17504,236,52,-1412,-737,23.6,1408.0
4508648866,1,78,2,1,9,3,17,1,1,0,0,17496,7.4,18327,220,47,1849,669,22.0,1749.6,17,1,0,3,9,2,1,0,1,0,15647,6.8,17658,224,57,-1849,-669,22.4,1564.7
4457622951,1,15,4,1,8,5,7,1,1,0,0,16735,6.8,17862,215,49,926,967,21.5,1673.5,78,0,0,5,8,7,0,0,0,0,15809,6.6,16895,188,56,-926,-967,18.8,1580.9
4515414704,1,14,1,1,13,5,9,0,0,0,0,19195,7.2,19569,205,44,2818,1675,20.5,1919.5,14,1,0,5,13,4,0,0,0,0,16377,7.0,17894,200,56,-2818,-1675,20.0,1637.7
4522518201,0,9,5,1,8,1,5,0,0,0,0,17761,7.4,20143,247,48,2501,2298,24.7,1776.1,18,2,0,1,8,1,0,0,0,0,15260,6.6,17845,251,56,-2501,-2298,25.1,1526.0
4451727242,0,70,2,0,8,6,12,2,1,1,0,15976,7.0,18227,178,56,-722,891,17.8,1597.6,13,1,1,6,8,6,0,0,0,0,16698,6.6,17336,232,39,722,-891,23.2,1669.8
4515404379,0,43,0,0,7,7,6,1,1,0,0,16396,7.0,18419,204,52,-2,866,20.4,1639.6,14,2,1,7,7,5,0,0,0,0,16398,6.8,17553,202,48,2,-866,20.2,1639.8
4524958032,0,16,2,1,5,9,9,1,1,0,0,16394,7.2,17514,238,41,-2037,-1895,23.8,1639.4,17,1,0,9,5,12,1,0,1,0,18431,7.2,19409,229,42,2037,1895,22.9,1843.1
4493434645,1,15,1,1,9,8,11,1,0,1,0,18677,7.0,18208,220,44,1334,-236,22.0,1867.7,108,1,0,8,9,10,1,1,0,0,17343,6.8,18444,206,60,-1334,236,20.6,1734.3
4517893176,0,12,1,0,4,12,4,0,0,0,0,14958,6.2,15925,192,52,-4917,-4426,19.2,1495.8,16,0,1,12,4,9,0,0,0,1,19875,7.4,20351,241,52,4917,4426,24.1,1987.5
4526732497,1,16,2,1,11,6,9,1,1,0,0,18445,7.2,19242,218,42,2691,2052,21.8,1844.5,18,0,0,6,11,5,0,0,0,0,15754,6.6,17190,205,40,-2691,-2052,20.5,1575.4
4484159432,1,41,3,1,11,3,15,1,1,0,0,19116,7.6,19542,223,36,3648,1867,22.3,1911.6,17,0,0,3,11,2,0,0,0,0,15468,7.0,17675,209,68,-3648,-1867,20.9,1546.8
4505728929,0,36,2,1,3,4,2,0,0,0,0,15211,6.8,18224,234,53,-834,-1333,23.4,1521.1,16,4,0,4,3,2,1,1,0,0,16045,7.4,19557,217,73,834,1333,21.7,1604.5
4513547989,1,16,3,1,16,2,14,0,0,0,1,21658,7.6,20318,211,52,6413,3952,21.1,2165.8,76,3,0,2,16,1,2,1,1,0,15245,6.4,16366,203,52,-6413,-3952,20.3,1524.5
4526014315,1,15,2,0,2,9,4,0,0,0,0,15074,6.8,16329,225,52,-1673,-1730,22.5,1507.4,13,4,1,9,2,10,1,1,0,0,16747,7.0,18059,215,52,1673,1730,21.5,1674.7
4520736553,1,15,2,1,7,5,5,1,1,0,0,17263,7.4,19542,237,66,715,-69,23.7,1726.3,17,1,0,5,7,5,0,0,0,0,16548,7.6,19611,231,68,-715,69,23.1,1654.8
4462400484,1,12,2,1,2,2,0,0,0,0,0,15098,7.0,19226,239,64,-631,337,23.9,1509.8,23,2,0,2,2,2,1,1,0,0,15729,7.2,18889,258,76,631,-337,25.8,1572.9
4522447446,1,15,4,1,10,3,8,0,0,0,0,19549,7.4,20404,266,55,4712,3798,26.6,1954.9,28,2,0,3,10,1,0,0,0,0,14837,6.4,16606,203,56,-4712,-3798,20.3,1483.7
4450359024,0,9,1,0,2,9,2,0,0,0,0,14953,6.8,17850,228,52,-3084,-1719,22.8,1495.3,15,3,1,9,2,9,1,1,0,0,18037,7.4,19569,258,56,3084,1719,25.8,1803.7
4509723024,0,13,0,0,6,6,7,2,1,1,0,16210,7.2,18620,231,49,-245,330,23.1,1621.0,15,1,1,6,6,8,0,0,0,0,16455,7.2,18290,220,55,245,-330,22.0,1645.5
4524294233,0,20,5,1,11,6,14,0,0,0,0,18379,7.2,19031,203,52,1952,1542,20.3,1837.9,17,3,0,6,11,9,1,1,0,0,16427,6.8,17489,196,64,-1952,-1542,19.6,1642.7
4502099918,1,12,6,0,12,7,9,0,0,0,0,18879,7.4,19472,219,40,1912,1686,21.9,1887.9,123,2,1,7,12,8,1,1,0,0,16967,7.0,17786,197,50,-1912,-1686,19.7,1696.7
4508742388,1,16,2,1,3,5,3,1,1,0,0,15735,7.0,18331,233,52,539,774,23.3,1573.5,19,2,0,5,3,4,0,0,0,0,15196,7.0,17557,220,40,-539,-774,22.0,1519.6
4489494110,1,25,5,1,14,3,15,0,0,0,0,20317,7.4,20330,212,54,6153,3916,21.2,2031.7,13,4,0,3,14,4,0,0,0,0,14164,6.4,16414,196,45,-6153,-3916,19.6,1416.4
4456819413,0,29,3,0,5,7,8,0,0,0,0,15796,6.6,17121,184,49,-1044,-487,18.4,1579.6,18,2,1,7,5,11,1,1,0,0,16840,7.0,17608,226,49,1044,487,22.6,1684.0
4505606908,1,12,3,1,10,5,9,1,1,0,0,19187,7.2,19762,211,64,2796,2669,21.1,1918.7,16,1,0,5,10,5,0,0,0,0,16391,6.6,17093,205,65,-2796,-2669,20.5,1639.1
4518987840,0,17,0,0,2,9,1,0,0,0,0,13405,6.4,15189,182,43,-5392,-2904,18.2,1340.5,19,2,1,9,2,19,1,1,0,0,18797,6.8,18093,231,54,5392,2904,23.1,1879.7
4524120513,1,44,3,1,6,5,5,0,0,0,0,16246,7.2,18652,199,56,750,786,19.9,1624.6,14,1,0,5,6,6,0,0,0,0,15496,6.8,17866,199,50,-750,-786,19.9,1549.6
4516773266,0,23,4,1,2,7,1,0,0,0,0,15409,7.0,18219,247,64,-2550,-792,24.7,1540.9,17,6,0,7,2,10,1,1,0,0,17959,7.0,19011,256,52,2550,792,25.6,1795.9
4520766314,0,16,4,1,9,3,13,1,1,0,0,17941,7.2,18842,205,52,2361,770,20.5,1794.1,17,2,0,3,9,3,0,0,0,0,15580,6.8,18072,249,52,-2361,-770,24.9,1558.0
4477872277,1,15,3,1,6,8,8,1,1,0,0,15586,6.8,17198,199,45,-1022,-1301,19.9,1558.6,19,1,0,8,6,7,0,0,0,0,16608,6.8,18499,210,41,1022,1301,21.0,1660.8
4469941308,1,10,4,1,7,3,13,0,0,0,0,16501,7.0,18045,208,63,1440,1148,20.8,1650.1,18,2,0,3,7,2,0,0,0,0,15061,6.8,16897,258,42,-1440,-1148,25.8,1506.1
4469793505,1,15,2,0,6,3,9,0,0,0,0,16568,7.2,18645,197,52,1188,2039,19.7,1656.8,20,2,1,3,6,4,2,1,1,0,15380,6.8,16606,207,52,-1188,-2039,20.7,1538.0
4488518196,1,17,2,1,6,5,8,1,1,0,0,16168,6.8,17052,176,60,-1149,-1327,17.6,1616.8,17,2,0,5,6,9,1,0,1,0,17317,7.0,18379,263,60,1149,1327,26.3,1731.7
4515338642,0,19,2,0,3,4,2,0,0,0,0,14564,6.6,17178,214,43,-1999,-647,21.4,1456.4,21,6,1,4,3,5,1,1,0,0,16563,7.0,17825,238,64,1999,647,23.8,1656.3
4498323673,0,18,4,1,11,11,16,0,0,0,0,18730,7.0,18011,208,38,175,-532,20.8,1873.0,18,4,0,11,11,14,1,1,0,0,18555,7.0,18543,219,81,-175,532,21.9,1855.5
4522839923,1,15,4,1,3,5,6,1,1,0,0,16120,7.0,18058,246,53,-576,-1269,24.6,1612.0,88,1,0,5,3,6,1,0,1,0,16696,7.2,19327,228,59,576,1269,22.8,1669.6
4490184459,0,18,2,0,5,9,7,0,0,0,0,15089,6.4,16002,182,32,-2349,-2678,18.2,1508.9,17,4,1,9,5,7,1,1,0,0,17438,7.0,18680,201,54,2349,2678,20.1,1743.8
4439464616,0,15,4,1,4,8,3,0,0,0,0,14901,7.0,17696,209,42,-2427,-1462,20.9,1490.1,16,0,0,8,4,7,0,0,0,0,17328,7.2,19158,224,52,2427,1462,22.4,1732.8
4509846773,1,16,4,1,2,7,4,2,1,1,0,14820,7.0,17885,211,64,-2497,-2400,21.1,1482.0,17,2,0,7,2,12,0,0,0,0,17317,7.6,20285,260,56,2497,2400,26.0,1731.7
4526825925,1,17,5,1,7,7,5,1,1,0,0,16825,7.4,19699,229,48,389,1652,22.9,1682.5,42,1,0,7,7,8,1,0,1,0,16436,7.0,18047,194,47,-389,-1652,19.4,1643.6
4519054552,1,15,4,0,11,4,12,0,0,0,0,18733,7.4,19592,201,62,3925,4105,20.1,1873.3,15,0,1,4,11,9,1,1,0,0,14808,6.4,15487,179,44,-3925,-4105,17.9,1480.8
4467397510,1,19,3,1,6,4,8,1,1,0,0,16130,6.8,17156,242,32,1428,701,24.2,1613.0,19,4,0,4,6,6,0,0,0,0,14702,6.6,16455,200,51,-1428,-701,20.0,1470.2
4494384806,0,35,1,0,1,2,2,2,1,1,0,13683,6.8,16232,198,60,-2032,-1876,19.8,1368.3,16,3,1,2,1,1,0,0,0,0,15715,6.8,18108,262,51,2032,1876,26.2,1571.5
4524523316,1,34,5,1,13,9,16,2,1,1,0,19694,7.2,19555,215,64,1910,1136,21.5,1969.4,13,5,0,9,13,13,0,0,0,0,17784,7.2,18419,212,44,-1910,-1136,21.2,1778.4
4467537493,0,17,2,0,3,8,3,0,0,0,0,13817,6.4,14829,167,44,-3294,-2723,16.7,1381.7,13,3,1,8,3,5,1,1,0,0,17111,6.6,17552,206,48,3294,2723,20.6,1711.1
4491965198,0,19,2,1,7,9,12,0,0,0,0,16594,6.6,16531,210,40,-712,-537,21.0,1659.4,18,2,0,9,7,16,1,1,0,0,17306,6.8,17068,170,64,712,537,17.0,1730.6
4515405283,1,17,1,1,9,2,5,0,0,0,0,17777,7.4,19414,238,48,3361,3545,23.8,1777.7,13,4,0,2,9,1,0,0,0,0,14416,6.4,15869,208,44,-3361,-3545,20.8,1441.6
4501354453,1,43,2,1,5,4,5,1,0,1,0,17027,6.8,17816,213,56,508,-1704,21.3,1702.7,14,2,0,4,5,4,1,1,0,0,16519,7.4,19520,231,75,-508,1704,23.1,1651.9
4525964486,0,15,1,1,8,9,8,1,1,0,0,17770,7.2,18781,223,76,-379,-662,22.3,1777.0,13,2,0,9,8,9,1,0,1,0,18149,7.0,19443,228,52,379,662,22.8,1814.9
4511208354,1,13,3,1,5,4,5,0,0,0,0,16262,7.0,18089,235,62,467,850,23.5,1626.2,14,2,0,4,5,4,0,0,0,0,15795,6.8,17239,228,43,-467,-850,22.8,1579.5
4511816090,0,18,1,1,2,2,3,1,0,1,0,15736,7.0,18218,234,60,705,-208,23.4,1573.6,16,1,0,2,2,2,1,1,0,0,15031,7.0,18426,250,59,-705,208,25.0,1503.1
4520335431,1,18,1,1,8,2,8,1,1,0,0,18433,7.2,19855,237,54,4759,3279,23.7,1843.3,10,1,0,2,8,3,1,0,1,0,13674,6.6,16576,183,44,-4759,-3279,18.3,1367.4
4471503799,1,52,2,1,13,5,16,0,0,0,1,20862,7.0,18335,232,39,6423,3767,23.2,2086.2,15,1,0,5,13,8,0,0,0,0,14439,6.2,14568,148,45,-6423,-3767,14.8,1443.9
4527458073,0,21,6,1,8,4,12,1,1,0,0,17134,6.8,17172,222,51,1167,-814,22.2,1713.4,18,3,0,4,8,6,0,0,0,0,15967,6.8,17986,221,58,-1167,814,22.1,1596.7
4518157842,1,42,4,0,5,6,5,1,1,0,0,16308,7.2,18876,245,64,-1055,-207,24.5,1630.8,18,14,1,6,5,5,1,0,1,0,17363,7.2,19083,259,60,1055,207,25.9,1736.3
4477027360,0,16,4,0,4,6,3,0,0,0,0,15008,6.6,16888,214,38,-1015,-1751,21.4,1500.8,31,3,1,6,4,4,1,1,0,0,16023,6.8,18639,208,59,1015,1751,20.8,1602.3
4515616629,1,11,2,1,8,3,8,0,0,0,0,17628,7.2,18793,231,61,3539,2952,23.1,1762.8,123,2,0,3,8,4,0,0,0,0,14089,6.4,15841,195,46,-3539,-2952,19.5,1408.9
4506773682,0,16,1,1,9,4,11,0,0,0,0,17685,7.0,17947,224,36,2260,248,22.4,1768.5,17,1,0,4,9,3,0,0,0,0,15425,7.0,17699,226,47,-2260,-248,22.6,1542.5
4523669745,0,36,4,1,8,5,6,2,1,1,0,17622,7.2,19988,252,72,1530,2220,25.2,1762.2,51,6,0,5,8,9,0,0,0,0,16092,7.0,17768,239,41,-1530,-2220,23.9,1609.2
4524074857,1,80,4,0,9,5,6,2,1,1,0,18419,7.6,19957,246,56,1773,1953,24.6,1841.9,13,3,1,5,9,7,0,0,0,0,16646,6.8,18004,244,50,-1773,-1953,24.4,1664.6
4429858119,0,14,5,1,4,7,4,0,0,0,0,15220,6.4,16809,236,45,-2475,-2226,23.6,1522.0,19,3,0,7,4,9,0,0,0,0,17695,7.2,19035,247,64,2475,2226,24.7,1769.5
4519990070,0,21,3,0,2,10,3,1,0,1,0,14825,6.8,17113,236,51,-3103,-2355,23.6,1482.5,17,5,1,10,2,16,1,1,0,0,17928,7.2,19468,230,52,3103,2355,23.0,1792.8
4478461160,1,14,2,1,9,0,8,0,0,0,0,17086,7.2,19170,221,49,3655,2743,22.1,1708.6,37,2,0,0,9,0,1,1,0,0,13431,6.4,16427,198,60,-3655,-2743,19.8,1343.1
4494051117,1,13,4,1,8,4,11,0,0,0,0,17356,7.0,18583,206,64,2028,1844,20.6,1735.6,17,1,0,4,8,2,1,1,0,0,15328,6.8,16739,227,55,-2028,-1844,22.7,1532.8
4502652617,0,11,0,1,5,5,3,1,0,1,0,16993,7.0,18944,241,67,1140,-531,24.1,1699.3,12,1,0,5,5,5,1,1,0,0,15853,7.0,19475,231,60,-1140,531,23.1,1585.3
4526773374,1,58,3,0,5,2,9,0,0,0,0,15917,7.2,18903,220,49,1528,1785,22.0,1591.7,15,3,1,2,5,4,1,1,0,0,14389,6.8,17118,199,64,-1528,-1785,19.9,1438.9
4502473645,1,22,3,0,3,5,3,0,0,0,0,15970,7.0,18425,245,59,24,-286,24.5,1597.0,18,1,1,5,3,1,0,0,0,0,15946,6.8,18711,249,53,-24,286,24.9,1594.6
4522493624,1,17,1,1,7,6,6,1,1,0,0,16737,7.2,18903,240,48,1411,1163,24.0,1673.7,14,2,0,6,7,3,0,0,0,0,15326,7.0,17740,177,49,-1411,-1163,17.7,1532.6
4521553541,1,15,1,1,7,7,6,1,1,0,0,16375,7.2,18784,217,55,-270,-1095,21.7,1637.5,11,3,0,7,7,4,1,0,1,0,16645,7.4,19879,209,52,270,1095,20.9,1664.5
4524915225,1,18,2,0,5,12,4,0,0,0,0,16033,7.0,17043,207,40,-2746,-827,20.7,1603.3,20,3,1,12,5,17,0,0,0,0,18779,6.8,17870,202,48,2746,827,20.2,1877.9
4494255603,1,13,1,1,8,8,11,1,0,1,0,17185,6.8,16790,193,35,-246,-870,19.3,1718.5,13,2,0,8,8,8,0,0,0,0,17431,6.8,17660,208,75,246,870,20.8,1743.1
4523553248,0,16,11,1,6,7,3,1,1,0,0,15829,7.0,18055,228,48,-464,-47,22.8,1582.9,43,9,0,7,6,8,0,0,0,0,16293,7.0,18102,208,42,464,47,20.8,1629.3
4511218061,1,14,5,0,17,6,17,1,1,0,1,22296,7.8,21451,251,72,6535,5732,25.1,2229.6,17,2,1,6,17,8,0,0,0,0,15761,6.4,15719,177,40,-6535,-5732,17.7,1576.1
4465279641,0,16,2,1,8,13,4,0,0,0,0,17008,7.2,18223,217,55,-4178,-1302,21.7,1700.8,12,4,0,13,8,13,1,1,0,1,21186,7.4,19525,219,40,4178,1302,21.9,2118.6
4461002538,0,13,3,0,11,9,15,0,0,0,0,17924,6.6,16556,219,35,449,-260,21.9,1792.4,16,3,1,9,11,10,0,0,0,0,17475,6.8,16816,182,44,-449,260,18.2,1747.5
4526842255,0,11,2,1,4,11,6,0,0,0,0,15402,6.2,15435,205,48,-2180,-3706,20.5,1540.2,17,1,0,11,4,12,0,0,0,0,17582,7.2,19141,204,54,2180,3706,20.4,1758.2
4517493567,0,15,5,1,4,3,4,0,0,0,0,15267,6.6,17321,232,53,453,-19,23.2,1526.7,16,2,0,3,4,3,0,0,0,0,14814,6.8,17340,209,51,-453,19,20.9,1481.4
4524182340,1,19,4,1,6,4,3,1,0,1,0,16561,7.0,17961,232,53,1496,-730,23.2,1656.1,55,6,0,4,6,4,1,1,0,0,15065,7.0,18691,191,55,-1496,730,19.1,1506.5
4434652049,0,18,1,1,9,7,8,0,0,0,0,17875,7.0,18320,203,43,2561,1875,20.3,1787.5,14,0,0,7,9,6,0,0,0,0,15314,6.6,16445,179,32,-2561,-1875,17.9,1531.4
4449261764,0,15,4,1,4,7,2,0,0,0,0,15099,6.6,17573,205,52,-3196,-3217,20.5,1509.9,13,6,0,7,4,10,1,1,0,0,18295,7.4,20790,226,71,3196,3217,22.6,1829.5
4516451603,1,17,2,1,12,5,17,1,1,0,0,18685,6.8,18421,234,44,2857,1406,23.4,1868.5,12,4,0,5,12,4,0,0,0,0,15828,6.8,17015,214,48,-2857,-1406,21.4,1582.8
4508674756,0,15,4,0,2,11,2,0,0,0,0,13418,5.8,13877,175,32,-5710,-4952,17.5,1341.8,94,1,1,11,2,15,2,1,1,0,19128,7.2,18829,213,63,5710,4952,21.3,1912.8
4479756200,0,15,3,1,6,10,4,0,0,0,0,16123,6.6,16738,194,49,-2240,-1945,19.4,1612.3,17,2,0,10,6,13,0,0,0,0,18363,6.8,18683,223,52,2240,1945,22.3,1836.3
4525767247,1,13,6,1,8,6,7,1,1,0,1,18791,6.8,18424,254,52,2989,1250,25.4,1879.1,63,2,0,6,8,10,0,0,0,0,15802,6.8,17174,188,40,-2989,-1250,18.8,1580.2
4492581081,0,15,0,0,4,7,4,0,0,0,0,14686,6.4,15538,184,32,-3927,-3207,18.4,1468.6,14,2,1,7,4,4,1,0,1,1,18613,7.0,18745,262,46,3927,3207,26.2,1861.3
4461377893,1,17,1,1,8,2,9,1,0,1,0,17243,7.2,19173,233,50,3082,1360,23.3,1724.3,48,3,0,2,8,0,0,0,0,0,14161,6.6,17813,222,45,-3082,-1360,22.2,1416.1
4510559226,1,17,3,0,6,3,9,1,1,0,0,15692,6.8,17598,217,32,189,-99,21.7,1569.2,16,3,1,3,6,2,0,0,0,0,15503,6.6,17697,244,48,-189,99,24.4,1550.3
4474892602,1,16,1,1,6,3,7,1,0,1,0,17167,6.8,18274,247,59,2089,1771,24.7,1716.7,11,2,0,3,6,4,1,1,0,0,15078,6.4,16503,202,50,-2089,-1771,20.2,1507.8
4501794843,0,15,4,1,4,1,4,0,0,0,0,16385,7.0,18374,249,44,3001,1223,24.9,1638.5,60,1,0,1,4,0,1,1,0,0,13384,6.8,17151,213,42,-3001,-1223,21.3,1338.4
4516433412,0,81,0,1,3,2,3,1,0,1,0,15716,7.2,19033,251,56,121,264,25.1,1571.6,15,2,0,2,3,1,1,1,0,0,15595,7.0,18769,255,76,-121,-264,25.5,1559.5
4519024034,1,20,3,1,9,5,13,1,0,1,2,20356,7.0,17899,225,49,5305,382,22.5,2035.6,42,3,0,5,9,10,1,1,0,0,15051,7.0,17517,184,49,-5305,-382,18.4,1505.1
4497723883,1,14,5,1,5,4,6,1,1,0,0,16214,7.2,18139,257,54,862,-426,25.7,1621.4,20,3,0,4,5,3,0,0,0,0,15352,7.0,18565,219,56,-862,426,21.9,1535.2
4526408349,0,17,4,1,4,5,4,2,1,1,0,16552,7.2,18731,227,57,334,145,22.7,1655.2,16,3,0,5,4,9,0,0,0,0,16218,6.8,18586,225,56,-334,-145,22.5,1621.8
4524450625,1,13,2,1,9,5,6,0,0,0,1,17795,7.0,18241,220,36,1642,878,22.0,1779.5,15,3,0,5,9,5,1,1,0,0,16153,6.8,17363,216,61,-1642,-878,21.6,1615.3
4527605062,0,15,4,1,11,10,9,1,0,1,0,17797,7.0,17892,191,36,354,248,19.1,1779.7,18,2,0,10,11,11,0,0,0,0,17443,6.8,17644,198,44,-354,-248,19.8,1744.3
4494944051,0,13,5,1,3,7,4,0,0,0,0,15392,6.8,17234,240,44,-1445,-694,24.0,1539.2,15,3,0,7,3,9,0,0,0,0,16837,6.8,17928,225,50,1445,694,22.5,1683.7
4520390476,1,11,3,1,8,2,11,1,1,0,0,17794,7.0,17983,220,56,4793,3669,22.0,1779.4,12,0,0,2,8,2,0,0,0,0,13001,5.8,14314,217,12,-4793,-3669,21.7,1300.1
4522631457,0,16,4,1,2,7,4,0,0,0,0,14367,6.4,16705,203,47,-2901,-2666,20.3,1436.7,14,2,0,7,2,8,1,0,1,0,17268,7.2,19371,229,60,2901,2666,22.9,1726.8
4527454700,1,16,1,0,5,1,7,0,0,0,0,16025,7.4,19176,208,63,1886,2653,20.8,1602.5,15,2,1,1,5,1,1,1,0,0,14139,6.6,16523,219,54,-1886,-2653,21.9,1413.9
4522671632,1,19,6,0,7,5,5,1,1,0,0,17381,7.2,19539,234,59,1300,1783,23.4,1738.1,14,10,1,5,7,6,0,0,0,0,16081,6.8,17756,227,52,-1300,-1783,22.7,1608.1
4484119748,1,18,1,1,5,6,5,0,0,0,0,16006,7.0,18385,225,40,-769,-701,22.5,1600.6,13,5,0,6,5,5,1,1,0,0,16775,7.0,19086,235,52,769,701,23.5,1677.5
4523417130,0,33,0,1,7,10,10,0,0,0,0,16425,6.8,16635,207,36,-964,-1439,20.7,1642.5,14,1,0,10,7,7,0,0,0,0,17389,7.0,18074,189,44,964,1439,18.9,1738.9
4522887845,1,18,1,1,6,5,5,1,1,0,0,16966,7.6,19311,231,58,138,1085,23.1,1696.6,12,1,0,5,6,6,1,0,1,0,16828,7.0,18226,214,58,-138,-1085,21.4,1682.8
4508130317,0,18,5,1,8,4,10,0,0,0,0,17297,7.0,18369,211,50,1961,564,21.1,1729.7,38,1,0,4,8,5,1,1,0,0,15336,6.8,17805,211,46,-1961,-564,21.1,1533.6
4522621799,1,13,3,0,8,5,6,2,1,1,1,18731,7.0,18165,225,48,2892,1413,22.5,1873.1,19,1,1,5,8,5,0,0,0,0,15839,6.4,16752,207,56,-2892,-1413,20.7,1583.9
4517940231,1,18,4,0,7,4,16,1,1,0,1,18539,7.0,18188,253,53,3466,1525,25.3,1853.9,25,2,1,4,7,2,1,0,1,0,15073,6.6,16663,222,42,-3466,-1525,22.2,1507.3
4519154901,0,16,1,1,2,6,0,0,0,0,0,14072,6.6,16596,207,56,-2186,-1093,20.7,1407.2,37,1,0,6,2,7,1,1,0,0,16258,7.0,17689,210,54,2186,1093,21.0,1625.8
4519739017,0,15,4,0,1,9,0,0,0,0,0,13401,6.4,16144,222,44,-5654,-2236,22.2,1340.1,26,5,1,9,1,11,2,1,1,1,19055,7.2,18380,253,48,5654,2236,25.3,1905.5
4483111734,0,13,1,0,3,6,3,0,0,0,0,14647,7.2,17841,185,68,-2084,-851,18.5,1464.7,15,0,1,6,3,6,2,1,1,0,16731,7.0,18692,251,40,2084,851,25.1,1673.1
4456760342,1,15,2,1,15,11,13,0,0,0,0,19402,7.2,18717,195,39,2008,2566,19.5,1940.2,15,2,0,11,15,12,0,0,0,0,17394,6.4,16151,180,44,-2008,-2566,18.0,1739.4
4504897086,0,18,2,1,4,5,3,0,0,0,0,16281,7.2,18349,219,64,699,-254,21.9,1628.1,16,2,0,5,4,7,1,1,0,0,15582,7.2,18603,200,66,-699,254,20.0,1558.2
4527350448,1,20,2,1,8,10,5,1,1,0,0,16285,6.4,16278,183,48,-1655,-1008,18.3,1628.5,16,3,0,10,8,9,0,0,0,0,17940,6.6,17286,189,36,1655,1008,18.9,1794.0
4463534767,1,16,2,0,12,5,12,0,0,0,1,20190,7.2,19713,200,64,5553,3915,20.0,2019.0,16,2,1,5,12,4,1,1,0,0,14637,6.4,15798,149,46,-5553,-3915,14.9,1463.7
4521542696,1,13,0,1,9,4,6,0,0,0,0,18189,7.0,19191,220,54,3905,3713,22.0,1818.9,15,3,0,4,9,3,0,0,0,0,14284,6.2,15478,181,52,-3905,-3713,18.1,1428.4
4522673306,1,26,5,0,7,4,13,1,1,0,0,17878,7.6,20464,232,62,2566,3097,23.2,1787.8,25,2,1,4,7,4,0,0,0,0,15312,7.0,17367,235,47,-2566,-3097,23.5,1531.2
4502124778,0,13,4,1,6,11,6,0,0,0,0,15240,7.0,17500,162,48,-3562,-2590,16.2,1524.0,16,0,0,11,6,8,1,1,0,0,18802,7.4,20090,221,48,3562,2590,22.1,1880.2
4480700431,1,10,3,0,6,13,5,1,1,0,0,14996,6.8,17677,181,60,-4822,-2537,18.1,1499.6,16,3,1,13,6,15,0,0,0,0,19818,7.4,20214,249,44,4822,2537,24.9,1981.8
4467563573,0,18,3,0,8,6,15,1,1,0,0,16501,6.2,15376,190,27,-383,-667,19.0,1650.1,18,3,1,6,8,9,0,0,0,0,16884,6.6,16043,229,50,383,667,22.9,1688.4
4518622747,1,16,2,1,12,10,10,2,1,1,1,20065,7.2,18844,204,71,2763,3068,20.4,2006.5,16,3,0,10,12,11,0,0,0,0,17302,6.4,15776,168,39,-2763,-3068,16.8,1730.2
4486642684,0,16,4,0,3,3,3,0,0,0,0,15275,6.8,17812,217,56,-701,346,21.7,1527.5,12,1,1,3,3,5,1,1,0,0,15976,6.8,17466,214,56,701,-346,21.4,1597.6
4482031505,0,18,0,1,4,2,7,1,1,0,0,15790,6.8,17238,209,52,785,-350,20.9,1579.0,67,0,0,2,4,3,0,0,0,0,15005,7.0,17588,241,59,-785,350,24.1,1500.5
4520814737,0,15,3,0,4,3,4,1,0,1,0,16043,7.0,18432,237,48,711,1614,23.7,1604.3,13,2,1,3,4,5,1,1,0,0,15332,6.8,16818,209,48,-711,-1614,20.9,1533.2
4523981551,0,17,2,0,6,9,5,0,0,0,0,16158,7.2,18018,213,48,-900,267,21.3,1615.8,17,4,1,9,6,12,2,1,1,0,17058,6.8,17751,177,48,900,-267,17.7,1705.8
4477916243,0,13,0,1,9,9,7,1,1,0,0,17687,6.8,18503,206,56,-609,-504,20.6,1768.7,16,1,0,9,9,13,0,0,0,0,18296,7.0,19007,225,60,609,504,22.5,1829.6
4483298051,0,19,3,0,7,3,5,0,0,0,0,17235,7.4,19915,257,57,2648,2595,25.7,1723.5,14,6,1,3,7,3,0,0,0,0,14587,6.8,17320,191,52,-2648,-2595,19.1,1458.7
4518244695,0,31,2,0,2,3,4,0,0,0,0,15267,6.8,17987,226,80,-392,-995,22.6,1526.7,18,1,1,3,2,1,1,1,0,0,15659,7.4,18982,254,60,392,995,25.4,1565.9
4523813027,1,17,1,1,5,4,9,0,0,0,0,16587,7.0,18340,252,48,-16,497,25.2,1658.7,18,6,0,4,5,5,2,1,1,0,16603,7.0,17843,242,53,16,-497,24.2,1660.3
4527001202,0,13,3,1,7,12,8,1,1,0,0,16763,7.0,17386,221,45,-1469,-2427,22.1,1676.3,11,1,0,12,7,10,0,0,0,0,18232,7.4,19813,214,44,1469,2427,21.4,1823.2
4475216536,0,18,1,1,11,7,21,1,1,0,0,18997,7.2,17998,237,45,1373,57,23.7,1899.7,18,4,0,7,11,7,0,0,0,0,17624,6.8,17941,227,48,-1373,-57,22.7,1762.4
4520825058,1,64,3,0,7,2,7,1,1,0,0,17033,6.8,18063,225,41,2789,2000,22.5,1703.3,18,2,1,2,7,2,0,0,0,0,14244,6.4,16063,210,41,-2789,-2000,21.0,1424.4
4489343970,0,15,1,0,3,5,2,0,0,0,0,16102,7.2,19258,257,66,-281,110,25.7,1610.2,13,3,1,5,3,4,1,1,0,0,16383,7.0,19148,251,50,281,-110,25.1,1638.3
4523696498,1,19,2,0,4,6,4,1,0,1,0,15578,6.8,17702,229,46,-1018,-1124,22.9,1557.8,20,2,1,6,4,6,0,0,0,0,16596,7.0,18826,240,51,1018,1124,24.0,1659.6
4455108830,0,28,1,0,9,10,12,1,0,1,0,17524,7.2,18124,203,52,-1319,-840,20.3,1752.4,14,6,1,10,9,13,1,1,0,0,18843,7.4,18964,223,56,1319,840,22.3,1884.3
4514189275,0,11,2,0,8,6,9,0,0,0,0,17304,7.2,19455,233,52,1127,1908,23.3,1730.4,7,1,1,6,8,5,1,1,0,0,16177,6.8,17547,211,52,-1127,-1908,21.1,1617.7
4525381159,0,16,5,0,5,12,5,1,1,0,0,14819,6.8,16721,164,47,-4413,-3537,16.4,1481.9,39,7,1,12,5,8,0,0,0,0,19232,7.4,20258,242,42,4413,3537,24.2,1923.2
4499273242,1,36,3,1,17,7,24,1,0,1,0,20182,7.6,20589,199,44,3404,2667,19.9,2018.2,13,1,0,7,17,5,1,1,0,0,16778,7.0,17922,206,61,-3404,-2667,20.6,1677.8
4522498843,0,14,2,0,3,4,1,1,0,1,0,15438,7.2,19325,213,62,-38,2015,21.3,1543.8,12,0,1,4,3,3,1,1,0,0,15476,6.8,17310,218,59,38,-2015,21.8,1547.6
4518409381,1,16,3,0,5,7,3,1,0,1,0,16911,7.2,18891,247,52,681,2047,24.7,1691.1,14,2,1,7,5,10,1,1,0,0,16230,6.8,16844,196,38,-681,-2047,19.6,1623.0
4526484364,1,19,2,1,10,5,11,1,1,0,0,18436,7.0,18039,209,47,1990,-86,20.9,1843.6,16,4,0,5,10,4,1,0,1,0,16446,6.8,18125,226,48,-1990,86,22.6,1644.6
4518651197,0,16,0,0,3,4,2,1,0,1,0,14909,6.8,17001,208,59,-447,676,20.8,1490.9,17,1,1,4,3,6,0,0,0,0,15356,6.6,16325,197,40,447,-676,19.7,1535.6
4479801050,1,12,2,1,9,10,10,0,0,0,0,17761,7.0,18196,229,48,-237,-500,22.9,1776.1,19,2,0,10,9,13,1,1,0,0,17998,7.2,18696,200,60,237,500,20.0,1799.8
4518322002,1,39,2,0,8,9,8,0,0,0,0,17389,7.0,18770,218,43,-1067,-523,21.8,1738.9,18,2,1,9,8,9,1,1,0,0,18456,7.4,19293,234,60,1067,523,23.4,1845.6
4456733355,0,13,5,1,5,10,7,0,0,0,0,15135,6.8,16444,197,41,-3704,-4361,19.7,1513.5,38,4,0,10,5,12,1,1,0,0,18839,7.6,20805,244,72,3704,4361,24.4,1883.9
4488750744,1,16,5,1,5,1,4,0,0,0,0,16279,7.0,18714,255,57,2004,385,25.5,1627.9,22,1,0,1,5,1,1,1,0,0,14275,7.0,18329,213,66,-2004,-385,21.3,1427.5
4512891978,0,13,1,1,6,4,8,1,1,0,0,15452,7.0,18378,191,49,-1039,827,19.1,1545.2,12,6,0,4,6,4,1,0,1,1,16491,6.8,17551,215,51,1039,-827,21.5,1649.1
4513262976,1,18,5,0,4,1,9,1,1,0,0,15357,6.8,17204,200,59,1273,1061,20.0,1535.7,16,5,1,1,4,2,0,0,0,0,14084,6.4,16143,239,40,-1273,-1061,23.9,1408.4
4508629003,0,16,2,1,7,9,5,2,1,1,0,16806,7.0,18034,228,48,-256,-1580,22.8,1680.6,34,2,0,9,7,7,0,0,0,0,17062,7.4,19614,230,52,256,1580,23.0,1706.2
4515332748,1,23,2,1,5,3,4,1,1,0,0,16448,7.2,19635,245,62,1619,1470,24.5,1644.8,13,0,0,3,5,3,1,0,1,0,14829,6.8,18165,209,55,-1619,-1470,20.9,1482.9
4496660905,1,16,1,1,9,4,14,1,1,0,0,17759,7.0,18824,228,48,3082,3200,22.8,1775.9,15,1,0,4,9,4,1,0,1,0,14677,6.2,15624,168,44,-3082,-3200,16.8,1467.7
4522629474,0,44,2,1,7,2,9,1,1,0,0,16966,7.2,19062,222,55,1996,2078,22.2,1696.6,18,1,0,2,7,2,0,0,0,0,14970,6.8,16984,222,43,-1996,-2078,22.2,1497.0
4519886887,0,30,0,0,6,5,8,0,0,0,0,16517,6.6,17531,219,56,1183,887,21.9,1651.7,16,2,1,5,6,7,0,0,0,0,15334,6.6,16644,192,40,-1183,-887,19.2,1533.4
4525782560,0,18,6,1,7,5,5,1,0,1,1,18107,7.0,18102,236,46,2002,301,23.6,1810.7,34,2,0,5,7,6,0,0,0,0,16105,6.6,17801,217,68,-2002,-301,21.7,1610.5
4502568283,1,15,3,0,7,7,8,2,1,1,1,19435,7.4,19608,248,63,2831,1855,24.8,1943.5,15,1,1,7,7,6,0,0,0,0,16604,6.8,17753,197,48,-2831,-1855,19.7,1660.4
4473772500,0,109,0,1,10,3,14,1,0,1,0,19056,7.2,18501,233,43,4312,1000,23.3,1905.6,16,3,0,3,10,1,1,1,0,0,14744,6.8,17501,211,48,-4312,-1000,21.1,1474.4
4518301313,1,15,0,1,5,4,4,0,0,0,0,16987,7.2,18495,255,44,1153,-5,25.5,1698.7,12,1,0,4,5,6,1,1,0,0,15834,7.2,18500,241,56,-1153,5,24.1,1583.4
4509524180,0,17,3,1,5,7,9,1,1,0,0,15288,6.6,16534,206,57,-861,131,20.6,1528.8,25,3,0,7,5,13,0,0,0,0,16149,6.6,16403,200,34,861,-131,20.0,1614.9
4517895985,0,15,1,0,5,7,6,0,0,0,0,15532,6.8,17712,201,40,-1768,-1778,20.1,1553.2,14,4,1,7,5,8,2,1,1,0,17300,7.4,19490,253,59,1768,1778,25.3,1730.0
4515989660,1,19,1,1,11,4,10,1,1,0,0,17570,7.2,18349,226,43,2414,2407,22.6,1757.0,12,3,0,4,11,5,0,0,0,0,15156,6.4,15942,219,44,-2414,-2407,21.9,1515.6
4520501584,1,15,2,1,6,4,6,1,1,0,0,16385,6.6,16580,208,45,1163,-1176,20.8,1638.5,14,0,0,4,6,4,1,0,1,0,15222,6.8,17756,194,52,-1163,1176,19.4,1522.2
4508074072,0,14,6,0,1,7,0,0,0,0,0,13657,6.4,16618,220,48,-3849,-2159,22.0,1365.7,18,1,1,7,1,7,1,1,0,0,17506,7.0,18777,235,56,3849,2159,23.5,1750.6
4494830005,0,22,5,0,2,2,1,1,1,0,0,14569,6.6,16559,227,38,-676,-864,22.7,1456.9,13,12,1,2,2,3,0,0,0,0,15245,6.8,17423,236,46,676,864,23.6,1524.5
4508680387,0,14,3,0,9,9,10,1,1,0,0,17326,6.8,17581,188,50,54,-321,18.8,1732.6,85,0,1,9,9,8,0,0,0,0,17272,6.8,17902,193,44,-54,321,19.3,1727.2
4477390538,0,15,2,1,8,3,8,1,1,0,0,17623,7.0,17787,229,48,3100,1006,22.9,1762.3,26,2,0,3,8,2,0,0,0,0,14523,6.8,16781,209,47,-3100,-1006,20.9,1452.3
4496718092,0,13,2,0,6,10,2,0,0,0,0,15485,6.6,17335,191,55,-2650,-388,19.1,1548.5,14,1,1,10,6,10,1,1,0,0,18135,6.8,17723,201,40,2650,388,20.1,1813.5
4518559997,0,17,0,1,4,5,3,2,1,1,0,16018,7.2,18223,215,68,-599,192,21.5,1601.8,17,5,0,5,4,10,0,0,0,0,16617,6.8,18031,242,48,599,-192,24.2,1661.7
4463551021,0,17,1,0,2,11,2,0,0,0,0,13714,6.6,16890,201,43,-5129,-3055,20.1,1371.4,13,1,1,11,2,12,1,0,1,0,18843,7.2,19945,250,38,5129,3055,25.0,1884.3
4455245413,0,14,1,1,5,10,4,0,0,0,0,15985,6.8,17576,223,47,-974,-1978,22.3,1598.5,13,3,0,10,5,11,1,1,0,0,16959,7.2,19554,188,37,974,1978,18.8,1695.9
4521172111,1,39,3,1,6,2,3,1,1,0,0,16569,7.2,19120,238,44,1398,1804,23.8,1656.9,17,18,0,2,6,3,0,0,0,0,15171,6.6,17316,233,60,-1398,-1804,23.3,1517.1
4525210320,0,37,3,1,6,3,9,1,1,0,0,16989,7.0,18073,242,48,1359,132,24.2,1698.9,38,18,0,3,6,2,0,0,0,0,15630,7.0,17941,239,60,-1359,-132,23.9,1563.0
4518118181,1,12,2,1,6,7,7,0,0,0,0,16119,6.6,16372,203,51,292,-206,20.3,1611.9,25,1,0,7,6,6,1,1,0,0,15827,6.6,16578,206,36,-292,206,20.6,1582.7
4481631636,0,19,4,0,2,8,1,0,0,0,0,14208,7.0,17036,194,64,-4891,-2335,19.4,1420.8,20,1,1,8,2,8,1,0,1,1,19099,7.2,19371,266,40,4891,2335,26.6,1909.9
4524348697,0,19,1,0,6,5,3,1,0,1,0,16141,7.4,19201,215,58,488,2349,21.5,1614.1,16,3,1,5,6,9,1,1,0,0,15653,6.6,16852,183,44,-488,-2349,18.3,1565.3
4462766288,1,16,4,0,11,2,7,1,1,0,0,17389,7.2,18459,221,52,2577,2588,22.1,1738.9,18,2,1,2,11,2,1,0,1,0,14812,6.6,15871,218,53,-2577,-2588,21.8,1481.2
4515957232,0,52,2,0,2,10,1,0,0,0,0,14817,6.4,16953,212,60,-3264,-1507,21.2,1481.7,16,2,1,10,2,11,1,1,0,0,18081,7.0,18460,211,40,3264,1507,21.1,1808.1
4525218047,1,18,2,1,9,9,16,0,0,0,0,17561,6.8,17359,208,40,-778,-1358,20.8,1756.1,28,2,0,9,9,10,1,0,1,0,18339,7.2,18717,231,59,778,1358,23.1,1833.9
4527241479,0,90,2,0,7,6,8,0,0,0,0,16224,7.0,18263,189,45,-376,1005,18.9,1622.4,13,3,1,6,7,7,1,1,0,0,16600,6.6,17258,220,45,376,-1005,22.0,1660.0
4435131804,1,17,6,1,9,2,10,0,0,0,0,17922,7.2,18511,224,37,3703,3118,22.4,1792.2,17,4,0,2,9,4,0,0,0,0,14219,6.2,15393,206,40,-3703,-3118,20.6,1421.9
4456005306,0,14,3,0,4,8,4,0,0,0,0,15385,6.8,17267,219,52,-2109,-335,21.9,1538.5,15,4,1,8,4,14,1,1,0,0,17494,7.0,17602,226,40,2109,335,22.6,1749.4
4493753133,0,15,1,0,7,7,10,0,0,0,0,16095,6.8,17497,228,24,-986,-1163,22.8,1609.5,36,2,1,7,7,6,0,0,0,0,17081,7.2,18660,237,46,986,1163,23.7,1708.1
4456521073,1,16,5,1,9,1,8,0,0,0,0,17483,7.8,20101,239,60,3502,3747,23.9,1748.3,17,5,0,1,9,2,0,0,0,0,13981,6.6,16354,214,52,-3502,-3747,21.4,1398.1
4494532333,0,15,3,0,2,4,1,0,0,0,0,14865,7.0,18385,233,60,-1179,646,23.3,1486.5,17,2,1,4,2,4,2,1,1,0,16044,6.8,17739,226,56,1179,-646,22.6,1604.4
4474350630,1,15,2,1,8,5,5,2,1,1,0,17639,7.2,19606,228,60,1899,2690,22.8,1763.9,14,0,0,5,8,9,0,0,0,0,15740,6.8,16916,208,48,-1899,-2690,20.8,1574.0
4525867970,0,15,17,0,3,8,5,0,0,0,0,14112,6.4,15898,216,28,-2834,-2773,21.6,1411.2,49,2,1,8,3,8,1,1,0,0,16946,7.0,18671,203,44,2834,2773,20.3,1694.6
4510666466,0,15,2,1,7,7,8,1,1,0,0,15970,6.8,17491,200,44,-336,-681,20.0,1597.0,17,4,0,7,7,4,0,0,0,0,16306,7.0,18172,220,40,336,681,22.0,1630.6
4500526206,1,24,7,0,13,3,15,2,1,1,0,20795,7.2,18944,249,48,6547,2553,24.9,2079.5,42,4,1,3,13,1,0,0,0,0,14248,6.6,16391,179,52,-6547,-2553,17.9,1424.8
4520303900,1,14,1,0,5,3,5,1,0,1,1,17531,7.4,19484,241,46,2351,1317,24.1,1753.1,12,2,1,3,5,3,1,1,0,0,15180,7.0,18167,223,44,-2351,-1317,22.3,1518.0
4526502680,1,12,2,1,9,7,10,1,1,0,0,18101,7.2,19775,213,74,1645,1489,21.3,1810.1,15,2,0,7,9,5,0,0,0,0,16456,6.8,18286,187,47,-1645,-1489,18.7,1645.6
4475518847,0,13,1,0,4,12,1,0,0,0,0,14738,6.6,16575,199,52,-4785,-3317,19.9,1473.8,30,1,1,12,4,15,1,1,0,0,19523,7.2,19892,220,65,4785,3317,22.0,1952.3
4482120064,0,17,1,0,3,7,3,0,0,0,0,15015,6.8,16974,209,53,-1996,-1804,20.9,1501.5,18,3,1,7,3,13,0,0,0,0,17011,7.2,18778,237,51,1996,1804,23.7,1701.1
4511838472,0,18,3,1,5,4,4,0,0,0,0,16510,7.0,17844,239,44,1066,528,23.9,1651.0,17,2,0,4,5,3,0,0,0,0,15444,7.0,17316,231,36,-1066,-528,23.1,1544.4
4518121833,1,13,2,1,7,12,5,1,1,0,0,16544,6.8,17779,194,56,-3011,-1199,19.4,1654.4,16,0,0,12,7,20,0,0,0,0,19555,7.0,18978,222,36,3011,1199,22.2,1955.5
4420933848,1,12,2,0,5,6,3,0,0,0,0,15897,6.8,18131,219,53,-453,659,21.9,1589.7,49,1,1,6,5,10,1,1,0,0,16350,7.0,17472,188,48,453,-659,18.8,1635.0
4521738824,0,16,3,1,4,7,5,1,1,0,0,16418,6.8,17454,237,50,217,72,23.7,1641.8,16,0,0,7,4,5,0,0,0,0,16201,6.6,17382,216,40,-217,-72,21.6,1620.1
4505526199,0,14,1,0,3,4,1,0,0,0,0,15087,7.0,17316,250,48,-523,-224,25.0,1508.7,14,1,1,4,3,7,0,0,0,0,15610,6.8,17540,203,52,523,224,20.3,1561.0
4515471946,1,16,7,1,7,4,9,0,0,0,0,16535,7.0,17582,230,33,443,-1176,23.0,1653.5,21,2,0,4,7,3,0,0,0,0,16092,7.0,18758,216,64,-443,1176,21.6,1609.2
4525188485,1,14,2,1,6,9,4,0,0,0,0,16978,6.8,17957,229,60,-1589,-2907,22.9,1697.8,34,1,0,9,6,11,1,0,1,0,18567,7.8,20864,193,75,1589,2907,19.3,1856.7
4417418392,1,18,2,1,14,2,14,1,1,0,0,19185,7.0,18543,196,48,5794,3899,19.6,1918.5,16,4,0,2,14,1,0,0,0,0,13391,6.0,14644,166,46,-5794,-3899,16.6,1339.1
4520667949,1,13,1,1,14,3,8,1,1,0,0,19085,7.2,19432,226,40,4784,3335,22.6,1908.5,14,1,0,3,14,2,0,0,0,0,14301,6.2,16097,178,47,-4784,-3335,17.8,1430.1
4504994778,0,11,2,1,9,11,10,0,0,0,0,16256,6.6,16283,154,44,-1114,-1440,15.4,1625.6,179,0,0,11,9,15,1,1,0,0,17370,7.0,17723,191,40,1114,1440,19.1,1737.0
4512184861,1,18,4,1,9,4,6,0,0,0,0,18417,7.2,19926,231,64,3910,3400,23.1,1841.7,17,3,0,4,9,3,2,1,1,0,14507,6.6,16526,206,51,-3910,-3400,20.6,1450.7
4474977192,0,16,1,0,5,11,4,0,0,0,0,16105,6.8,17502,214,35,-2047,-2555,21.4,1610.5,141,1,1,11,5,5,1,1,0,0,18152,7.6,20057,208,52,2047,2555,20.8,1815.2
4452942684,1,19,2,1,6,0,7,1,1,0,0,16742,7.4,19873,236,49,2805,2599,23.6,1674.2,15,2,0,0,6,0,0,0,0,0,13937,6.6,17274,254,56,-2805,-2599,25.4,1393.7
4518592520,1,14,2,1,7,1,4,1,1,0,0,16614,7.0,18570,221,50,3295,3468,22.1,1661.4,14,2,0,1,7,0,0,0,0,0,13319,6.4,15102,205,50,-3295,-3468,20.5,1331.9
4506039178,0,15,4,1,2,1,4,1,0,1,1,16437,6.8,18096,244,44,969,-409,24.4,1643.7,17,3,0,1,2,3,1,1,0,0,15468,7.0,18505,236,66,-969,409,23.6,1546.8
4465674600,0,20,1,1,4,9,1,1,1,0,0,16223,6.8,17597,222,63,-2086,-1696,22.2,1622.3,15,3,0,9,4,8,0,0,0,0,18309,7.0,19293,228,52,2086,1696,22.8,1830.9
4520745759,0,12,1,1,13,6,14,2,1,1,0,19234,6.8,17699,179,48,3274,1603,17.9,1923.4,18,2,0,6,13,6,0,0,0,0,15960,6.4,16096,206,40,-3274,-1603,20.6,1596.0
4456900643,0,29,5,1,10,4,9,1,0,1,0,17972,7.2,19155,206,44,2363,1314,20.6,1797.2,15,3,0,4,10,3,0,0,0,0,15609,6.8,17841,226,59,-2363,-1314,22.6,1560.9
4517900276,1,14,3,1,9,6,12,1,1,0,0,16574,6.6,17052,203,36,144,-227,20.3,1657.4,18,1,0,6,9,4,0,0,0,0,16430,6.8,17279,229,56,-144,227,22.9,1643.0
4518083698,1,16,2,1,2,6,6,0,0,0,0,15223,6.8,17348,213,64,-713,-897,21.3,1522.3,12,2,0,6,2,3,0,0,0,0,15936,6.8,18245,228,44,713,897,22.8,1593.6
4495034271,0,22,3,0,3,9,4,0,0,0,0,14930,6.6,16710,222,36,-1844,-1368,22.2,1493.0,37,4,1,9,3,9,1,1,0,0,16774,6.8,18078,212,36,1844,1368,21.2,1677.4
4522422210,0,18,1,0,2,5,1,0,0,0,0,15125,6.8,17716,241,56,-1770,-1069,24.1,1512.5,13,5,1,5,2,5,0,0,0,0,16895,7.0,18785,250,57,1770,1069,25.0,1689.5
4522005554,1,15,1,1,7,5,6,1,1,0,0,16891,7.0,18224,214,65,-51,373,21.4,1689.1,38,2,0,5,7,8,1,0,1,0,16942,6.8,17851,218,48,51,-373,21.8,1694.2
4509867417,1,37,3,1,8,4,14,1,1,0,0,18664,7.4,20054,233,63,3326,3001,23.3,1866.4,16,2,0,4,8,2,0,0,0,0,15338,6.6,17053,215,56,-3326,-3001,21.5,1533.8
4481745211,1,28,7,0,6,9,7,0,0,0,0,15377,6.6,16348,177,43,-1871,-1775,17.7,1537.7,21,7,1,9,6,6,0,0,0,0,17248,7.0,18123,227,32,1871,1775,22.7,1724.8
4517904549,1,18,2,0,3,5,3,1,1,0,0,15636,6.8,17293,220,63,-1086,-637,22.0,1563.6,40,4,1,5,3,10,1,0,1,0,16722,7.0,17930,216,51,1086,637,21.6,1672.2
4527403029,1,17,2,1,7,7,10,1,1,0,0,16866,6.8,18028,220,48,-808,-1078,22.0,1686.6,15,3,0,7,7,8,0,0,0,0,17674,7.2,19106,234,60,808,1078,23.4,1767.4
4486653289,0,12,0,1,3,3,4,0,0,0,0,14520,7.0,17410,182,64,-1127,-843,18.2,1452.0,16,2,0,3,3,1,0,0,0,0,15647,7.0,18253,234,60,1127,843,23.4,1564.7
4485702742,1,15,0,1,9,2,5,1,1,0,0,18079,7.2,19818,272,52,3854,2379,27.2,1807.9,15,1,0,2,9,1,0,0,0,0,14225,6.8,17439,230,41,-3854,-2379,23.0,1422.5
4489876149,1,48,1,1,7,9,7,1,1,0,0,16765,7.2,18366,213,57,-923,-229,21.3,1676.5,11,0,0,9,7,8,0,0,0,0,17688,7.0,18595,214,38,923,229,21.4,1768.8
4523429650,0,14,2,1,6,7,8,0,0,0,0,17318,7.0,18742,237,72,568,-205,23.7,1731.8,18,1,0,7,6,8,2,1,1,0,16750,7.4,18947,202,60,-568,205,20.2,1675.0
4518019885,0,15,1,0,0,9,0,0,0,0,0,13282,6.4,16226,194,60,-6225,-3975,19.4,1328.2,12,2,1,9,0,9,1,1,0,0,19507,7.4,20201,226,52,6225,3975,22.6,1950.7
4522430578,1,36,3,0,14,7,5,2,1,1,0,18135,7.0,19550,198,56,1490,1854,19.8,1813.5,11,0,1,7,14,7,0,0,0,0,16645,7.0,17696,180,43,-1490,-1854,18.0,1664.5
4520879353,0,53,2,0,3,6,3,0,0,0,0,14782,6.8,17600,238,44,-1454,-1276,23.8,1478.2,42,4,1,6,3,6,1,1,0,0,16236,7.2,18876,204,63,1454,1276,20.4,1623.6
4526764433,1,15,2,0,6,10,4,1,0,1,0,15649,6.8,17358,185,47,-2558,-828,18.5,1564.9,19,1,1,10,6,16,0,0,0,0,18207,7.2,18186,229,56,2558,828,22.9,1820.7
4524407688,1,18,1,1,2,1,2,1,1,0,0,15649,7.0,18530,269,56,1281,1111,26.9,1564.9,13,2,0,1,2,0,0,0,0,0,14368,7.0,17419,225,62,-1281,-1111,22.5,1436.8
4523847046,1,17,4,1,5,5,5,0,0,0,1,17333,6.8,16881,232,39,781,-1744,23.2,1733.3,18,1,0,5,5,4,1,0,1,0,16552,7.2,18625,234,52,-781,1744,23.4,1655.2
4480393322,1,17,2,1,8,3,10,1,1,0,0,17967,7.0,18074,240,43,3039,712,24.0,1796.7,17,2,0,3,8,3,0,0,0,0,14928,6.8,17362,211,53,-3039,-712,21.1,1492.8
4520750598,1,15,0,1,7,2,3,1,1,0,1,18662,7.4,19321,255,66,4088,2662,25.5,1866.2,16,2,0,2,7,2,0,0,0,0,14574,6.6,16659,209,64,-4088,-2662,20.9,1457.4
4522859590,1,15,1,1,11,4,10,0,0,0,1,19677,6.8,17356,217,45,6581,3949,21.7,1967.7,14,1,0,4,11,5,0,0,0,0,13096,5.8,13407,132,39,-6581,-3949,13.2,1309.6
4519579618,1,12,2,1,11,7,11,2,1,1,0,17788,7.0,17625,178,50,1655,2014,17.8,1778.8,17,2,0,7,11,12,0,0,0,0,16133,6.4,15611,195,22,-1655,-2014,19.5,1613.3
4457510743,0,56,4,0,3,7,3,0,0,0,0,14866,6.6,16219,208,43,-2140,-1892,20.8,1486.6,15,2,1,7,3,9,2,1,1,0,17006,6.8,18111,224,51,2140,1892,22.4,1700.6
4525826341,1,11,1,0,4,9,3,1,1,0,0,15386,7.0,17872,209,40,-2820,-1143,20.9,1538.6,134,3,1,9,4,11,0,0,0,0,18206,7.4,19015,229,40,2820,1143,22.9,1820.6
4435781298,1,22,2,0,6,6,4,0,0,0,0,15570,7.0,17682,180,49,-227,923,18.0,1557.0,14,4,1,6,6,5,1,1,0,0,15797,6.6,16759,227,36,227,-923,22.7,1579.7
4495445064,0,17,2,0,5,8,5,0,0,0,0,14803,6.8,17434,177,37,-2454,-1437,17.7,1480.3,37,4,1,8,5,6,1,1,0,0,17257,7.0,18871,219,52,2454,1437,21.9,1725.7
4451628627,0,15,1,0,2,10,1,1,0,1,0,13726,6.2,16098,184,52,-4474,-5216,18.4,1372.6,16,3,1,10,2,8,1,1,0,0,18200,7.6,21314,236,68,4474,5216,23.6,1820.0
4473597829,0,19,4,1,4,5,5,0,0,0,0,15435,6.8,17093,231,38,-1077,-2560,23.1,1543.5,16,5,0,5,4,1,0,0,0,0,16512,7.4,19653,249,75,1077,2560,24.9,1651.2
4486168054,0,23,1,1,5,11,6,0,0,0,0,15696,6.6,16453,195,42,-2942,-1785,19.5,1569.6,17,7,0,11,5,14,0,0,0,0,18638,7.0,18238,212,47,2942,1785,21.2,1863.8
4427951118,0,16,3,0,4,11,5,1,0,1,0,15372,6.8,17002,213,57,-2585,204,21.3,1537.2,18,2,1,11,4,12,1,1,0,0,17957,6.8,16798,209,40,2585,-204,20.9,1795.7
4521225250,0,14,2,0,8,10,11,1,1,0,0,17136,7.0,17495,207,54,-1632,562,20.7,1713.6,13,4,1,10,8,17,1,0,1,1,18768,6.8,16933,173,32,1632,-562,17.3,1876.8
4477860376,0,38,2,1,4,7,5,0,0,0,0,15346,6.6,17250,212,47,-1938,-1173,21.2,1534.6,16,5,0,7,4,7,1,1,0,0,17284,7.0,18423,225,64,1938,1173,22.5,1728.4
4521222405,0,24,3,0,5,7,7,0,0,0,0,15812,7.0,17291,227,40,-950,60,22.7,1581.2,18,7,1,7,5,7,1,1,0,0,16762,6.8,17231,233,51,950,-60,23.3,1676.2
4526400961,1,80,4,1,4,1,7,0,0,0,0,15736,7.2,18522,216,56,2112,2566,21.6,1573.6,17,2,0,1,4,2,1,1,0,0,13624,6.6,15956,197,60,-2112,-2566,19.7,1362.4
4521334344,0,13,2,1,5,6,4,0,0,0,0,15701,7.0,17899,212,42,-662,-951,21.2,1570.1,14,3,0,6,5,3,2,1,1,0,16363,7.0,18850,243,52,662,951,24.3,1636.3
4471506446,1,22,2,1,18,4,14,2,1,1,0,21416,7.6,21031,235,57,7482,6466,23.5,2141.6,16,0,0,4,18,3,0,0,0,0,13934,6.0,14565,144,39,-7482,-6466,14.4,1393.4
4525312884,1,16,2,1,7,3,7,1,1,0,0,17639,7.2,18319,247,47,2392,1200,24.7,1763.9,14,4,0,3,7,3,0,0,0,0,15247,6.8,17119,214,48,-2392,-1200,21.4,1524.7
4499724520,1,14,1,1,13,3,15,1,1,0,0,19814,7.6,20713,224,58,5468,5522,22.4,1981.4,10,0,0,3,13,3,0,0,0,0,14346,6.2,15191,197,32,-5468,-5522,19.7,1434.6
4519603672,1,14,3,1,6,4,7,0,0,0,0,16689,7.4,19570,233,48,-177,-38,23.3,1668.9,18,1,0,4,6,4,0,0,0,0,16866,7.2,19608,236,71,177,38,23.6,1686.6
4508218503,0,14,1,0,0,1,0,0,0,0,0,14713,7.0,17547,261,53,-388,-1004,26.1,1471.3,10,4,1,1,0,1,1,1,0,0,15101,7.0,18551,264,56,388,1004,26.4,1510.1
4527222548,1,21,3,0,10,3,12,2,1,1,0,18211,7.4,20198,209,61,3608,3085,20.9,1821.1,62,0,1,3,10,3,0,0,0,0,14603,6.8,17113,183,52,-3608,-3085,18.3,1460.3
4519777597,1,30,6,1,11,7,11,1,0,1,0,19063,7.2,19391,237,56,2411,875,23.7,1906.3,15,2,0,7,11,5,1,1,0,0,16652,7.2,18516,221,52,-2411,-875,22.1,1665.2
4526431738,0,12,4,0,3,8,3,0,0,0,0,14264,6.2,15870,201,28,-2234,-2021,20.1,1426.4,16,2,1,8,3,6,1,1,0,0,16498,6.8,17891,204,56,2234,2021,20.4,1649.8
4526991608,1,22,3,0,2,5,2,0,0,0,0,14981,7.2,17943,247,57,-274,-192,24.7,1498.1,14,3,1,5,2,7,0,0,0,0,15255,6.8,18135,214,44,274,192,21.4,1525.5
4525790279,1,20,2,0,1,5,1,0,0,0,0,14998,7.0,17794,246,48,-1431,269,24.6,1499.8,18,4,1,5,1,8,0,0,0,0,16429,6.8,17525,230,52,1431,-269,23.0,1642.9
4496561150,0,15,3,0,1,6,1,0,0,0,0,13126,6.6,17066,173,55,-3823,-2613,17.3,1312.6,27,3,1,6,1,3,2,1,1,0,16949,7.2,19679,234,63,3823,2613,23.4,1694.9
4517995576,0,37,2,1,6,5,5,1,0,1,0,16490,6.8,17576,225,48,-508,-1394,22.5,1649.0,15,2,0,5,6,3,1,1,0,0,16998,7.2,18970,257,72,508,1394,25.7,1699.8
4474939096,1,15,4,1,1,0,1,0,0,0,0,14812,6.6,17296,254,53,1221,-311,25.4,1481.2,37,3,0,0,1,0,1,1,0,0,13591,6.8,17607,214,60,-1221,311,21.4,1359.1
4474905504,1,19,2,1,4,1,8,1,1,0,0,15787,7.2,19141,223,70,1259,2317,22.3,1578.7,18,2,0,1,4,0,0,0,0,0,14528,6.4,16824,236,47,-1259,-2317,23.6,1452.8
4498093464,0,16,0,0,3,5,4,0,0,0,0,14535,6.6,16967,182,52,-2491,-1771,18.2,1453.5,11,3,1,5,3,5,1,1,0,0,17026,7.2,18738,241,55,2491,1771,24.1,1702.6
4521948875,1,16,4,0,5,8,7,1,1,0,0,15752,6.6,17113,201,48,-1763,-1864,20.1,1575.2,19,2,1,8,5,6,0,0,0,0,17515,7.2,18977,248,40,1763,1864,24.8,1751.5
4488573145,0,15,2,0,0,4,0,0,0,0,0,13720,6.6,16815,230,52,-2727,-4122,23.0,1372.0,38,2,1,4,0,1,1,1,0,0,16447,7.6,20937,263,69,2727,4122,26.3,1644.7
4492625917,1,37,2,1,5,3,5,0,0,0,0,16990,7.4,19634,248,54,2031,1449,24.8,1699.0,15,1,0,3,5,5,1,1,0,0,14959,7.0,18185,210,68,-2031,-1449,21.0,1495.9
4452983788,0,22,7,0,7,8,9,0,0,0,0,17543,7.2,18967,246,48,-144,-867,24.6,1754.3,53,5,1,8,7,10,2,1,1,0,17687,7.4,19834,225,64,144,867,22.5,1768.7
4524789573,0,14,1,1,6,4,7,0,0,0,0,16508,7.0,18227,204,47,489,-1163,20.4,1650.8,34,2,0,4,6,5,1,0,1,0,16019,7.2,19390,235,58,-489,1163,23.5,1601.9
4518185070,1,52,3,0,8,5,13,2,1,1,0,18398,7.0,19201,234,71,2087,650,23.4,1839.8,15,2,1,5,8,3,0,0,0,0,16311,7.0,18551,226,56,-2087,-650,22.6,1631.1
4452094519,1,43,4,1,4,3,2,1,0,1,1,16233,6.8,17972,210,52,1404,1286,21.0,1623.3,15,4,0,3,4,3,0,0,0,0,14829,6.8,16686,209,51,-1404,-1286,20.9,1482.9
4456181584,0,16,2,0,6,6,4,0,0,0,0,16968,7.2,18303,231,48,423,318,23.1,1696.8,13,3,1,6,6,8,2,1,1,0,16545,7.0,17985,219,48,-423,-318,21.9,1654.5
4448657505,1,129,4,1,8,7,8,1,1,0,0,17526,7.2,18287,220,45,307,-269,22.0,1752.6,43,2,0,7,8,7,0,0,0,0,17219,7.2,18556,225,52,-307,269,22.5,1721.9
4523529962,1,17,24,1,11,6,15,1,1,0,0,18205,7.0,18119,207,38,2002,1791,20.7,1820.5,40,4,0,6,11,9,0,0,0,0,16203,6.4,16328,208,36,-2002,-1791,20.8,1620.3
4525069847,0,15,5,0,5,4,6,1,0,1,1,17610,6.8,18110,232,57,1467,11,23.2,1761.0,46,1,1,4,5,6,1,1,0,0,16143,7.0,18099,222,56,-1467,-11,22.2,1614.3
4521525873,0,13,1,1,6,8,4,0,0,0,0,16112,6.8,17371,197,50,-554,-483,19.7,1611.2,17,3,0,8,6,10,1,1,0,0,16666,7.0,17854,206,41,554,483,20.6,1666.6
4443008526,0,19,4,1,8,8,2,0,0,0,0,16249,6.8,17245,189,41,-1276,-648,18.9,1624.9,16,0,0,8,8,11,0,0,0,0,17525,7.0,17893,193,42,1276,648,19.3,1752.5
4464520808,0,75,2,1,8,5,8,1,1,0,0,16801,7.2,19121,198,54,-209,417,19.8,1680.1,15,1,0,5,8,6,0,0,0,0,17010,7.0,18704,229,52,209,-417,22.9,1701.0
4459208674,1,19,3,0,3,4,1,1,1,0,0,15056,6.8,18397,225,51,-278,571,22.5,1505.6,15,2,1,4,3,7,0,0,0,0,15334,6.8,17826,208,59,278,-571,20.8,1533.4
4519205202,1,18,2,0,5,6,7,0,0,0,0,16003,6.6,17152,213,55,-954,-1007,21.3,1600.3,18,4,1,6,5,14,1,1,0,0,16957,7.0,18159,261,49,954,1007,26.1,1695.7
4526454387,0,14,4,0,5,6,7,1,1,0,0,16227,7.2,19425,221,68,131,735,22.1,1622.7,17,3,1,6,5,8,0,0,0,0,16096,7.0,18690,206,44,-131,-735,20.6,1609.6
4523092582,1,16,2,0,9,4,17,0,0,0,0,18149,7.0,18067,202,52,3036,1766,20.2,1814.9,15,4,1,4,9,5,1,1,0,0,15113,6.6,16301,222,40,-3036,-1766,22.2,1511.3
4511303658,0,14,4,0,7,4,7,1,1,0,0,16743,7.2,18562,215,45,1323,457,21.5,1674.3,13,0,1,4,7,8,0,0,0,0,15420,7.0,18105,209,52,-1323,-457,20.9,1542.0
4527033162,0,13,3,0,6,9,7,0,0,0,0,15827,6.8,17027,181,46,-2327,-2250,18.1,1582.7,17,2,1,9,6,5,2,1,1,0,18154,7.4,19277,251,60,2327,2250,25.1,1815.4
4511374041,0,15,3,0,7,12,6,2,1,1,0,17347,6.6,18118,222,63,-1305,-1101,22.2,1734.7,19,1,1,12,7,15,0,0,0,0,18652,7.4,19219,218,44,1305,1101,21.8,1865.2
4522061542,0,15,2,0,3,7,4,1,0,1,0,14665,6.8,17020,192,47,-1761,-1206,19.2,1466.5,16,3,1,7,3,10,1,1,0,0,16426,7.0,18226,213,52,1761,1206,21.3,1642.6
4491776589,1,19,1,0,4,10,3,0,0,0,0,14709,6.4,16206,209,29,-2923,-1079,20.9,1470.9,16,2,1,10,4,12,2,1,1,0,17632,6.8,17285,232,53,2923,1079,23.2,1763.2
4510883651,0,18,0,1,6,11,5,0,0,0,0,15246,6.4,15419,151,42,-4370,-4504,15.1,1524.6,16,5,0,11,6,12,1,1,0,0,19616,7.2,19923,235,51,4370,4504,23.5,1961.6
4520936512,1,16,2,1,4,6,2,0,0,0,0,14698,6.6,16713,192,51,-1341,-339,19.2,1469.8,14,1,0,6,4,9,2,1,1,0,16039,7.0,17052,197,56,1341,339,19.7,1603.9
4480057032,1,18,3,1,12,4,16,1,1,0,0,19351,7.4,20590,220,40,3969,3522,22.0,1935.1,14,2,0,4,12,4,0,0,0,0,15382,6.6,17068,221,48,-3969,-3522,22.1,1538.2
4521992457,0,16,0,1,7,4,10,1,1,0,0,16599,6.6,16723,201,40,1036,-663,20.1,1659.9,9,3,0,4,7,1,0,0,0,0,15563,6.8,17386,251,52,-1036,663,25.1,1556.3
4512772548,1,42,2,0,7,2,3,1,1,0,0,16669,7.0,18607,226,57,3370,4484,22.6,1666.9,14,3,1,2,7,2,0,0,0,0,13299,6.0,14123,194,28,-3370,-4484,19.4,1329.9
4457103291,0,11,3,0,5,9,5,0,0,0,0,14994,7.0,17924,188,48,-3155,-2773,18.8,1499.4,15,1,1,9,5,9,0,0,0,0,18149,7.4,20697,219,56,3155,2773,21.9,1814.9
4488597120,1,13,4,0,6,5,2,0,0,0,0,16589,7.0,18101,239,46,636,-419,23.9,1658.9,51,2,1,5,6,3,1,1,0,0,15953,7.2,18520,216,67,-636,419,21.6,1595.3
4469123840,1,40,5,0,4,4,5,1,0,1,0,15447,7.0,17708,201,43,63,261,20.1,1544.7,16,6,1,4,4,1,1,1,0,0,15384,6.8,17447,228,49,-63,-261,22.8,1538.4
4459421997,0,60,3,1,3,2,2,0,0,0,0,14863,7.0,18643,230,53,321,-260,23.0,1486.3,14,4,0,2,3,2,0,0,0,0,14542,7.0,18903,230,50,-321,260,23.0,1454.2
4518370041,0,19,4,1,6,6,8,2,1,1,0,17258,7.0,18225,239,58,1191,-311,23.9,1725.8,16,1,0,6,6,5,0,0,0,0,16067,6.8,18536,213,60,-1191,311,21.3,1606.7
4486554038,1,52,1,1,4,2,2,2,1,1,0,15897,7.0,19077,235,68,188,1159,23.5,1589.7,14,2,0,2,4,3,0,0,0,0,15709,6.6,17918,255,53,-188,-1159,25.5,1570.9
4521001903,1,17,2,0,6,4,7,1,1,0,0,16057,7.0,17977,231,44,172,-278,23.1,1605.7,16,2,1,4,6,7,1,0,1,0,15885,7.0,18255,242,56,-172,278,24.2,1588.5
4509679309,1,43,3,1,8,3,9,1,0,1,0,17370,7.4,19627,249,58,2279,2409,24.9,1737.0,12,1,0,3,8,7,1,1,0,0,15091,7.0,17218,229,42,-2279,-2409,22.9,1509.1
4455149960,0,15,4,0,3,5,2,2,1,1,0,15073,6.8,16649,234,44,-745,-1826,23.4,1507.3,42,2,1,5,3,3,0,0,0,0,15818,7.0,18475,200,66,745,1826,20.0,1581.8
4517700680,1,55,2,1,7,2,12,1,1,0,0,17340,7.2,19234,229,52,3125,1784,22.9,1734.0,16,1,0,2,7,2,0,0,0,0,14215,6.8,17450,219,50,-3125,-1784,21.9,1421.5
4522081916,1,19,4,0,9,9,11,1,1,0,0,18376,7.2,18388,238,46,653,462,23.8,1837.6,14,6,1,9,9,18,0,0,0,0,17723,7.0,17926,204,44,-653,-462,20.4,1772.3
4513226809,0,93,4,1,7,4,6,0,0,0,0,17129,6.8,17586,228,36,1440,247,22.8,1712.9,15,5,0,4,7,4,1,1,0,0,15689,7.0,17339,211,60,-1440,-247,21.1,1568.9
4522281462,0,28,4,0,9,10,10,0,0,0,0,17910,6.8,16867,207,45,88,-589,20.7,1791.0,42,4,1,10,9,11,1,0,1,0,17822,6.8,17456,197,44,-88,589,19.7,1782.2
4524771501,0,15,4,0,5,7,5,0,0,0,0,15562,7.2,17777,219,44,-1151,-753,21.9,1556.2,15,1,1,7,5,5,2,1,1,0,16713,7.2,18530,227,44,1151,753,22.7,1671.3
4450091892,0,18,3,1,11,9,13,1,1,0,0,18715,7.0,18626,223,52,1326,351,22.3,1871.5,13,3,0,9,11,9,0,0,0,0,17389,7.2,18275,208,50,-1326,-351,20.8,1738.9
4470465305,0,22,1,0,5,12,12,0,0,0,0,16220,7.0,17906,222,66,-4157,-1724,22.2,1622.0,15,1,1,12,5,24,1,1,0,0,20377,7.4,19630,257,52,4157,1724,25.7,2037.7
4525357856,1,53,2,1,4,5,4,0,0,0,0,15232,7.0,17793,209,51,-625,-945,20.9,1523.2,11,1,0,5,4,6,0,0,0,0,15857,7.2,18738,215,50,625,945,21.5,1585.7
4462715361,1,14,7,1,3,5,2,1,0,1,0,15929,7.2,18680,250,51,17,44,25.0,1592.9,35,2,0,5,3,3,1,1,0,0,15912,7.0,18636,203,76,-17,-44,20.3,1591.2
4526554592,1,13,5,0,4,10,8,0,0,0,0,14629,6.8,16283,183,52,-3259,-1518,18.3,1462.9,18,0,1,10,4,16,2,1,1,0,17888,7.0,17801,210,40,3259,1518,21.0,1788.8
4518528928,1,54,1,0,8,3,8,0,0,0,0,17101,7.0,17725,214,40,2294,1989,21.4,1710.1,18,3,1,3,8,6,2,1,1,0,14807,6.4,15736,182,48,-2294,-1989,18.2,1480.7
4518542421,1,16,4,0,11,11,9,1,1,0,0,19116,7.0,19104,220,56,1159,3144,22.0,1911.6,20,0,1,11,11,14,0,0,0,0,17957,6.4,15960,169,31,-1159,-3144,16.9,1795.7
4486520653,1,11,1,1,7,4,5,0,0,0,0,17052,6.8,17766,241,44,1475,-95,24.1,1705.2,36,2,0,4,7,5,1,1,0,0,15577,6.6,17861,206,60,-1475,95,20.6,1557.7
4522521033,0,16,3,1,8,13,6,0,0,0,0,17705,6.8,17690,201,44,-1291,-1067,20.1,1770.5,18,4,0,13,8,16,0,0,0,0,18996,7.2,18757,213,31,1291,1067,21.3,1899.6
4447643884,0,16,2,1,8,4,8,0,0,0,0,17531,6.8,18252,230,56,2236,288,23.0,1753.1,14,1,0,4,8,2,0,0,0,0,15295,6.8,17964,212,48,-2236,-288,21.2,1529.5
4519541867,0,18,4,0,1,8,0,0,0,0,0,14288,6.4,15711,237,36,-3358,-2837,23.7,1428.8,18,2,1,8,1,6,1,1,0,0,17646,7.2,18548,240,52,3358,2837,24.0,1764.6
4501540670,1,79,2,1,7,7,4,0,0,0,1,18053,7.4,19492,230,41,891,1526,23.0,1805.3,14,1,0,7,7,11,1,1,0,0,17162,7.0,17966,202,54,-891,-1526,20.2,1716.2
4511093393,0,32,7,0,3,9,3,0,0,0,0,15622,6.8,17546,246,50,-2461,-1626,24.6,1562.2,18,1,1,9,3,10,1,1,0,0,18083,7.2,19172,228,48,2461,1626,22.8,1808.3
4527661727,1,20,7,0,6,6,3,1,1,0,0,16662,7.0,18914,237,48,619,35,23.7,1666.2,21,4,1,6,6,7,0,0,0,0,16043,7.2,18879,212,48,-619,-35,21.2,1604.3
4423262467,1,15,2,1,7,5,12,0,0,0,0,16953,6.8,17147,199,65,1073,-541,19.9,1695.3,14,3,0,5,7,7,1,1,0,0,15880,7.0,17688,210,64,-1073,541,21.0,1588.0
4503152696,1,12,0,0,1,7,0,0,0,0,0,14983,6.8,17958,271,60,-1607,-1043,27.1,1498.3,12,1,1,7,1,10,1,1,0,0,16590,7.0,19001,212,54,1607,1043,21.2,1659.0
4519240372,0,16,1,1,6,10,4,0,0,0,0,16335,6.6,17339,192,45,-956,16,19.2,1633.5,18,4,0,10,6,11,1,0,1,0,17291,6.8,17323,202,32,956,-16,20.2,1729.1
4517973417,1,15,5,1,7,1,10,1,1,0,0,16932,7.2,19942,235,55,2699,2575,23.5,1693.2,53,5,0,1,7,1,0,0,0,0,14233,6.8,17367,242,52,-2699,-2575,24.2,1423.3
4524863981,0,19,2,0,4,11,3,0,0,0,0,15107,6.6,16753,200,41,-3799,-3285,20.0,1510.7,10,4,1,11,4,10,1,1,0,0,18906,7.2,20038,226,45,3799,3285,22.6,1890.6
4506455461,0,14,0,0,5,4,6,1,1,0,0,17129,7.2,18794,256,47,1004,211,25.6,1712.9,12,2,1,4,5,4,0,0,0,0,16125,6.8,18583,234,56,-1004,-211,23.4,1612.5
4474924285,1,13,1,1,2,3,1,0,0,0,0,15464,6.8,17569,237,64,209,250,23.7,1546.4,14,2,0,3,2,1,0,0,0,0,15255,6.8,17319,242,29,-209,-250,24.2,1525.5
4511388378,1,14,1,1,6,5,8,1,1,0,0,16693,7.0,18416,240,67,1722,1857,24.0,1669.3,13,2,0,5,6,2,0,0,0,0,14971,6.6,16559,193,52,-1722,-1857,19.3,1497.1
4517494677,0,18,6,0,8,5,9,0,0,0,0,17935,7.0,18860,226,55,2070,1331,22.6,1793.5,18,4,1,5,8,5,0,0,0,0,15865,6.8,17529,214,55,-2070,-1331,21.4,1586.5
4449306681,0,15,5,1,10,11,7,0,0,0,0,18027,6.8,18601,212,46,850,2442,21.2,1802.7,15,1,0,11,10,16,1,1,0,0,17177,6.4,16159,174,42,-850,-2442,17.4,1717.7
4475994865,1,20,5,1,11,3,12,1,1,0,0,18802,7.0,18095,224,51,3781,1725,22.4,1880.2,17,3,0,3,11,2,0,0,0,0,15021,6.6,16370,222,44,-3781,-1725,22.2,1502.1
4526016335,0,13,0,0,3,5,2,1,0,1,0,14686,7.0,17187,228,44,-1592,-2117,22.8,1468.6,16,2,1,5,3,3,1,1,0,0,16278,7.2,19304,247,47,1592,2117,24.7,1627.8
4519712655,0,73,0,1,9,8,10,0,0,0,0,17350,7.2,18836,202,45,620,874,20.2,1735.0,16,2,0,8,9,8,0,0,0,0,16730,6.6,17962,211,49,-620,-874,21.1,1673.0
4477496962,0,15,2,0,7,7,14,0,0,0,0,16750,6.6,17492,214,44,-2128,-1873,21.4,1675.0,18,4,1,7,7,3,2,1,1,1,18878,7.2,19365,236,72,2128,1873,23.6,1887.8
4521375330,0,15,1,0,5,4,4,0,0,0,0,15387,6.6,16280,196,41,-501,-934,19.6,1538.7,18,5,1,4,5,3,0,0,0,0,15888,6.6,17214,210,46,501,934,21.0,1588.8
4525957612,0,16,1,1,5,6,6,1,1,0,0,15907,6.6,16474,211,67,-393,-2719,21.1,1590.7,19,5,0,6,5,9,0,0,0,0,16300,7.0,19193,211,56,393,2719,21.1,1630.0
4494472776,0,16,2,1,4,8,5,0,0,0,0,16055,6.8,17241,252,50,-1176,-1456,25.2,1605.5,61,1,0,8,4,9,1,1,0,0,17231,7.0,18697,225,51,1176,1456,22.5,1723.1
4521814295,0,14,6,0,7,4,7,1,0,1,0,16806,6.8,17149,217,50,1904,892,21.7,1680.6,38,6,1,4,7,4,0,0,0,0,14902,6.4,16257,200,55,-1904,-892,20.0,1490.2
4512192023,0,18,4,0,4,7,5,0,0,0,0,15198,6.8,17177,219,38,-2876,-2715,21.9,1519.8,10,4,1,7,4,9,1,0,1,0,18074,7.2,19892,222,92,2876,2715,22.2,1807.4
4504019656,0,11,5,1,9,7,5,0,0,0,0,16880,7.0,17998,195,39,-296,872,19.5,1688.0,49,3,0,7,9,7,0,0,0,0,17176,6.8,17126,246,28,296,-872,24.6,1717.6
4510713167,0,11,2,1,3,3,3,1,1,0,0,14304,6.0,15110,199,56,-2083,-2549,19.9,1430.4,13,1,0,3,3,5,0,0,0,1,16387,6.8,17659,236,44,2083,2549,23.6,1638.7
4482233269,0,16,3,0,1,4,2,1,0,1,0,14526,6.8,17366,224,50,-1245,-1370,22.4,1452.6,16,4,1,4,1,4,1,1,0,0,15771,7.0,18736,241,53,1245,1370,24.1,1577.1
4461992783,0,60,1,1,6,8,6,0,0,0,0,16767,7.0,18062,228,53,-1221,-2380,22.8,1676.7,16,1,0,8,6,7,2,1,1,0,17988,7.4,20442,252,64,1221,2380,25.2,1798.8
4519236802,0,51,1,0,2,14,3,1,0,1,0,13612,6.4,15504,181,48,-6717,-4767,18.1,1361.2,14,5,1,14,2,17,1,1,0,0,20329,7.6,20271,226,56,6717,4767,22.6,2032.9
4489628926,0,16,3,0,3,3,3,0,0,0,0,14696,6.2,14840,185,50,-1033,-1797,18.5,1469.6,36,2,1,3,3,5,0,0,0,0,15729,6.8,16637,217,48,1033,1797,21.7,1572.9
4494104479,0,77,3,0,6,11,4,0,0,0,0,15838,7.0,18031,204,52,-2468,-1853,20.4,1583.8,86,5,1,11,6,9,1,1,0,0,18306,7.4,19884,219,80,2468,1853,21.9,1830.6
4510552697,1,15,2,1,7,9,7,2,1,1,0,16578,6.8,18186,220,50,-987,-741,22.0,1657.8,18,2,0,9,7,9,0,0,0,0,17565,7.4,18927,206,44,987,741,20.6,1756.5
4493672467,0,19,0,1,6,8,4,1,1,0,0,16455,7.2,18317,217,56,-411,374,21.7,1645.5,23,3,0,8,6,14,0,0,0,0,16866,7.2,17943,215,49,411,-374,21.5,1686.6
4515946724,1,16,1,0,6,4,6,0,0,0,0,17025,7.0,18219,211,59,1196,-85,21.1,1702.5,16,2,1,4,6,2,1,1,0,0,15829,7.0,18304,228,64,-1196,85,22.8,1582.9
4506715219,1,15,5,1,7,4,12,2,1,1,0,17915,7.0,18641,223,64,1110,-544,22.3,1791.5,13,2,0,4,7,6,0,0,0,0,16805,7.2,19185,235,72,-1110,544,23.5,1680.5
4494291659,0,13,0,1,1,7,2,0,0,0,0,13099,5.8,14520,191,28,-3521,-4416,19.1,1309.9,15,1,0,7,1,8,1,1,0,0,16620,7.2,18936,247,44,3521,4416,24.7,1662.0
4443464607,1,12,3,0,4,7,3,1,1,0,0,15586,7.0,18599,229,52,-1777,52,22.9,1558.6,24,0,1,7,4,7,0,0,0,0,17363,7.2,18547,244,49,1777,-52,24.4,1736.3
4467046961,1,46,2,1,10,2,13,2,1,1,0,19031,7.4,20293,212,71,4888,3753,21.2,1903.1,12,12,0,2,10,3,0,0,0,0,14143,6.8,16540,182,56,-4888,-3753,18.2,1414.3
4478513496,1,13,2,1,7,6,5,0,0,0,0,17131,7.2,19074,229,59,1692,205,22.9,1713.1,14,0,0,6,7,4,1,1,0,0,15439,7.0,18869,186,52,-1692,-205,18.6,1543.9
4526068721,1,14,4,1,3,2,4,1,1,0,0,16099,7.0,18334,227,60,348,-662,22.7,1609.9,17,2,0,2,3,1,0,0,0,0,15751,7.2,18996,247,64,-348,662,24.7,1575.1
4490139424,0,16,2,0,1,12,0,0,0,0,0,13291,6.4,15898,201,48,-5102,-3977,20.1,1329.1,41,3,1,12,1,18,2,1,1,0,18393,7.4,19875,227,52,5102,3977,22.7,1839.3
4483634862,0,14,1,0,5,12,5,0,0,0,0,15634,6.6,16435,222,40,-3194,-2675,22.2,1563.4,50,2,1,12,5,13,1,0,1,0,18828,7.2,19110,205,52,3194,2675,20.5,1882.8
4501476679,1,14,2,1,5,3,3,1,1,0,0,15930,7.2,18669,234,44,1713,2145,23.4,1593.0,17,1,0,3,5,3,0,0,0,0,14217,6.4,16524,188,44,-1713,-2145,18.8,1421.7
4460890614,0,12,5,1,7,4,8,0,0,0,0,17062,7.2,19299,238,58,1922,1870,23.8,1706.2,19,2,0,4,7,4,0,0,0,0,15140,6.8,17429,191,44,-1922,-1870,19.1,1514.0
4508126925,1,16,3,1,16,7,22,2,1,1,0,21512,7.2,19190,218,35,5514,3051,21.8,2151.2,18,2,0,7,16,9,0,0,0,0,15998,6.4,16139,196,47,-5514,-3051,19.6,1599.8
4519907649,1,16,3,1,13,5,18,1,1,0,0,19813,7.0,18543,236,32,4173,1912,23.6,1981.3,14,1,0,5,13,7,0,0,0,0,15640,6.6,16631,167,40,-4173,-1912,16.7,1564.0
4527898486,1,57,3,1,5,4,5,1,1,0,0,15965,7.0,18534,208,52,725,1773,20.8,1596.5,16,3,0,4,5,5,1,0,1,0,15240,6.8,16761,202,40,-725,-1773,20.2,1524.0
4524922890,0,43,3,0,5,12,7,0,0,0,0,15893,6.8,17285,202,35,-3909,-1904,20.2,1589.3,17,5,1,12,5,13,1,0,1,0,19802,7.2,19189,228,35,3909,1904,22.8,1980.2
4455128161,1,18,2,1,13,2,16,1,1,0,0,19773,7.6,20507,240,40,5622,3964,24.0,1977.3,13,3,0,2,13,4,0,0,0,0,14151,6.6,16543,203,64,-5622,-3964,20.3,1415.1
4491135325,0,20,0,0,8,12,11,0,0,0,0,17540,7.0,17368,182,54,-3563,-1320,18.2,1754.0,16,1,1,12,8,22,1,1,0,0,21103,7.2,18688,198,74,3563,1320,19.8,2110.3
4523026204,0,18,3,1,10,12,8,0,0,0,0,18494,7.0,19080,223,49,-790,-834,22.3,1849.4,13,4,0,12,10,9,1,1,0,0,19284,7.2,19914,237,48,790,834,23.7,1928.4
4521089901,0,12,1,0,6,6,10,1,1,0,0,16143,6.6,16617,204,56,-964,-2454,20.4,1614.3,13,1,1,6,6,3,1,0,1,0,17107,7.0,19071,241,56,964,2454,24.1,1710.7
4508098561,0,14,3,1,4,11,5,0,0,0,0,15613,6.8,17057,202,53,-2952,-2963,20.2,1561.3,16,2,0,11,4,8,1,1,0,0,18565,7.4,20020,221,63,2952,2963,22.1,1856.5
4515275420,0,17,4,0,2,9,3,0,0,0,0,14267,6.6,16538,204,43,-5571,-3921,20.4,1426.7,15,5,1,9,2,10,2,1,1,1,19838,7.6,20459,268,56,5571,3921,26.8,1983.8
4512127012,0,11,1,0,3,8,5,1,1,0,0,14527,6.4,16646,221,44,-4267,-2746,22.1,1452.7,15,2,1,8,3,8,1,0,1,1,18794,7.2,19392,238,68,4267,2746,23.8,1879.4
4467242137,0,15,2,1,3,4,6,0,0,0,0,14782,6.8,16677,213,49,-1464,-1509,21.3,1478.2,19,1,0,4,3,4,1,1,0,0,16246,7.0,18186,238,56,1464,1509,23.8,1624.6
4474787155,1,12,2,0,7,2,7,1,0,1,0,17731,7.6,20617,238,80,3339,3179,23.8,1773.1,11,1,1,2,7,2,1,1,0,0,14392,6.8,17438,236,46,-3339,-3179,23.6,1439.2
4525050175,1,15,2,1,4,1,6,1,1,0,0,15508,6.8,17062,217,48,1728,-337,21.7,1550.8,17,3,0,1,4,0,0,0,0,0,13780,6.8,17399,223,47,-1728,337,22.3,1378.0
4477391796,1,17,0,0,10,11,7,0,0,0,0,16915,7.0,19035,214,38,-1716,-1094,21.4,1691.5,10,2,1,11,10,11,2,1,1,0,18631,7.6,20129,238,60,1716,1094,23.8,1863.1
4517631475,0,16,1,0,5,10,6,0,0,0,0,15994,6.8,17730,211,50,-2028,-1740,21.1,1599.4,12,3,1,10,5,7,1,1,0,0,18022,7.2,19470,242,58,2028,1740,24.2,1802.2
4520614992,0,14,2,0,4,12,4,0,0,0,0,14920,6.8,17398,186,57,-6000,-3856,18.6,1492.0,16,4,1,12,4,15,1,1,0,0,20920,7.6,21254,246,60,6000,3856,24.6,2092.0
4447620478,0,16,2,1,7,9,8,1,1,0,0,16876,7.0,17943,223,38,31,-472,22.3,1687.6,37,4,0,9,7,12,0,0,0,0,16845,7.2,18415,207,27,-31,472,20.7,1684.5
4513917134,0,79,4,1,8,6,7,0,0,0,0,17809,7.0,18479,238,48,2278,2211,23.8,1780.9,15,3,0,6,8,8,0,0,0,0,15531,6.4,16268,189,44,-2278,-2211,18.9,1553.1
4470670940,1,18,3,1,6,6,7,0,0,0,0,16247,7.4,19667,218,52,266,1738,21.8,1624.7,14,5,0,6,6,8,1,1,0,0,15981,7.0,17929,213,56,-266,-1738,21.3,1598.1
4525005015,0,12,2,0,2,5,2,0,0,0,0,14119,6.6,16231,216,50,-2325,-2078,21.6,1411.9,38,2,1,5,2,9,1,1,0,0,16444,6.8,18309,235,46,2325,2078,23.5,1644.4
4515795123,1,21,2,1,8,7,9,0,0,0,0,17585,7.2,19364,213,56,1393,1671,21.3,1758.5,12,1,0,7,8,6,1,1,0,0,16192,7.0,17693,207,47,-1393,-1671,20.7,1619.2
4496300604,0,15,3,1,5,9,8,0,0,0,0,14998,6.2,15234,197,40,-2698,-3640,19.7,1499.8,16,2,0,9,5,11,1,1,0,0,17696,7.2,18874,232,44,2698,3640,23.2,1769.6
4522436299,0,15,8,1,2,5,3,0,0,0,0,15205,6.6,16968,248,44,-977,-1320,24.8,1520.5,23,3,0,5,2,8,0,0,0,0,16182,7.0,18288,186,64,977,1320,18.6,1618.2
4526634972,0,12,3,1,12,3,15,2,1,1,1,20668,7.6,20383,234,52,5767,3366,23.4,2066.8,15,1,0,3,12,6,0,0,0,0,14901,6.8,17017,183,71,-5767,-3366,18.3,1490.1
4503065925,1,13,3,1,9,1,15,1,1,0,0,18053,6.8,18267,247,51,4135,1375,24.7,1805.3,28,0,0,1,9,2,0,0,0,0,13918,6.6,16892,211,59,-4135,-1375,21.1,1391.8
4522867926,1,17,8,1,7,6,7,0,0,0,0,18248,7.2,19067,231,55,1989,1106,23.1,1824.8,37,2,0,6,7,3,1,1,0,0,16259,7.0,17961,215,55,-1989,-1106,21.5,1625.9
4508345813,0,13,1,1,6,11,9,0,0,0,0,15377,6.4,15779,191,32,-4853,-3538,19.1,1537.7,16,1,0,11,6,7,0,0,0,1,20230,7.0,19317,230,59,4853,3538,23.0,2023.0
4473172269,1,16,2,0,1,2,1,1,1,0,0,14314,7.0,17525,244,49,59,77,24.4,1431.4,11,2,1,2,1,1,0,0,0,0,14255,6.8,17448,224,49,-59,-77,22.4,1425.5
4487485538,0,18,1,0,3,9,1,1,0,1,0,14709,6.8,17193,207,56,-3224,-1270,20.7,1470.9,16,7,1,9,3,16,1,1,0,0,17933,7.2,18463,238,34,3224,1270,23.8,1793.3
4518832896,0,11,2,0,4,11,2,0,0,0,0,14993,6.6,17460,208,47,-2884,-2378,20.8,1499.3,15,0,1,11,4,8,1,1,0,0,17877,7.4,19838,226,38,2884,2378,22.6,1787.7
4525109552,1,16,4,0,4,5,2,0,0,0,0,14826,6.8,16660,204,49,-1596,-1318,20.4,1482.6,16,4,1,5,4,7,1,0,1,0,16422,7.0,17978,214,57,1596,1318,21.4,1642.2
4521984962,0,72,1,1,11,6,5,0,0,0,0,17264,7.2,18859,196,38,765,425,19.6,1726.4,15,9,0,6,11,4,2,1,1,0,16499,7.2,18434,212,56,-765,-425,21.2,1649.9
4503847672,0,18,1,0,5,2,5,1,1,0,0,15950,7.0,18633,247,44,1233,251,24.7,1595.0,14,2,1,2,5,2,0,0,0,0,14717,6.8,18382,204,60,-1233,-251,20.4,1471.7
4494464754,0,20,3,0,3,7,0,0,0,0,0,13452,6.4,15569,170,37,-3453,-720,17.0,1345.2,16,6,1,7,3,10,1,1,0,0,16905,6.6,16289,212,46,3453,720,21.2,1690.5
4523932560,1,20,3,0,9,5,8,2,1,1,0,17615,7.2,19117,218,48,2643,3340,21.8,1761.5,15,3,1,5,9,6,0,0,0,0,14972,6.4,15777,194,41,-2643,-3340,19.4,1497.2
4488609653,0,15,6,0,9,15,10,0,0,0,0,17793,7.0,18271,187,58,-1961,-392,18.7,1779.3,21,1,1,15,9,19,1,1,0,0,19754,7.0,18663,173,36,1961,392,17.3,1975.4
4526071907,0,14,3,0,8,2,12,0,0,0,0,16861,7.0,18373,227,40,1297,564,22.7,1686.1,13,3,1,2,8,3,0,0,0,0,15564,7.0,17809,230,52,-1297,-564,23.0,1556.4
4485823957,1,24,2,0,7,4,11,0,0,0,0,18113,7.2,19187,231,49,1350,524,23.1,1811.3,16,5,1,4,7,6,0,0,0,0,16763,7.0,18663,262,65,-1350,-524,26.2,1676.3
4472496029,0,15,2,1,6,6,5,1,1,0,0,15414,6.4,16960,188,43,-2545,-761,18.8,1541.4,17,2,0,6,6,5,1,0,1,1,17959,6.8,17721,225,51,2545,761,22.5,1795.9
4508715619,0,17,3,1,5,4,3,0,0,0,0,16199,7.0,18624,205,65,512,858,20.5,1619.9,14,6,0,4,5,4,0,0,0,0,15687,6.8,17766,218,61,-512,-858,21.8,1568.7
4518673555,0,16,5,0,3,7,4,0,0,0,0,15396,6.6,16586,218,36,-1193,-843,21.8,1539.6,21,3,1,7,3,7,1,0,1,0,16589,6.8,17429,238,36,1193,843,23.8,1658.9
4526865205,1,19,3,1,4,5,2,0,0,0,0,15538,6.8,18054,223,57,-450,-849,22.3,1553.8,33,3,0,5,4,6,0,0,0,0,15988,7.2,18903,189,56,450,849,18.9,1598.8
4427944005,0,20,2,0,7,8,6,1,0,1,0,15868,7.0,17111,199,51,-178,524,19.9,1586.8,42,7,1,8,7,6,1,1,0,0,16046,6.8,16587,178,47,178,-524,17.8,1604.6
4524177357,1,34,5,1,1,7,1,0,0,0,0,14745,6.8,17469,236,60,-2556,-325,23.6,1474.5,24,2,0,7,1,9,0,0,0,0,17301,7.0,17794,238,44,2556,325,23.8,1730.1
4524927159,0,14,1,1,5,9,4,0,0,0,0,15463,7.0,17005,206,60,-3386,-2729,20.6,1546.3,16,3,0,9,5,13,0,0,0,0,18849,7.0,19734,234,51,3386,2729,23.4,1884.9
4465441499,1,19,4,0,0,3,0,0,0,0,0,13674,6.8,17384,229,52,-1159,-157,22.9,1367.4,18,2,1,3,0,3,1,1,0,0,14833,6.8,17541,230,40,1159,157,23.0,1483.3
4515744642,1,19,4,0,2,6,2,0,0,0,0,14790,6.8,18612,223,71,-3075,-244,22.3,1479.0,16,0,1,6,2,7,1,1,0,0,17865,7.0,18856,266,47,3075,244,26.6,1786.5
4524112117,1,40,1,1,7,4,8,0,0,0,0,15818,6.6,16786,205,36,656,-439,20.5,1581.8,19,3,0,4,7,3,0,0,0,0,15162,6.8,17225,200,53,-656,439,20.0,1516.2
4492027887,1,17,2,0,8,11,6,1,0,1,0,15941,6.8,16613,180,37,-2440,-1603,18.0,1594.1,14,5,1,11,8,15,0,0,0,0,18381,6.8,18216,219,40,2440,1603,21.9,1838.1
4456463104,1,21,6,1,4,3,5,2,1,1,0,17003,6.8,18427,239,64,1634,546,23.9,1700.3,22,7,0,3,4,4,0,0,0,0,15369,7.0,17881,261,29,-1634,-546,26.1,1536.9
4525326887,1,40,4,1,9,6,16,0,0,0,0,17348,6.6,16417,191,40,1528,-104,19.1,1734.8,14,4,0,6,9,7,1,1,0,0,15820,6.6,16521,191,55,-1528,104,19.1,1582.0
4527314623,1,43,7,1,16,7,18,1,1,0,0,20271,7.2,19487,200,47,3243,1919,20.0,2027.1,19,1,0,7,16,8,0,0,0,0,17028,6.8,17568,235,34,-3243,-1919,23.5,1702.8
4481963149,1,12,2,0,9,2,8,1,1,0,0,17378,7.4,19405,253,44,3268,2650,25.3,1737.8,15,3,1,2,9,3,0,0,0,0,14110,6.4,16755,212,52,-3268,-2650,21.2,1411.0
4523562611,1,20,0,0,0,5,0,0,0,0,0,14849,7.0,17923,249,68,-2145,-1335,24.9,1484.9,17,4,1,5,0,7,1,1,0,0,16994,7.4,19258,245,68,2145,1335,24.5,1699.4
4524698989,0,17,2,1,5,5,4,1,1,0,0,15552,6.8,17498,239,25,-164,94,23.9,1555.2,15,2,0,5,5,6,1,0,1,0,15716,7.0,17404,203,62,164,-94,20.3,1571.6
4409386215,0,25,1,1,4,3,4,0,0,0,0,15838,6.8,18368,221,62,-348,-901,22.1,1583.8,17,4,0,3,4,4,1,1,0,0,16186,7.2,19269,261,66,348,901,26.1,1618.6
4518422789,1,18,2,0,8,3,9,2,1,1,0,17561,7.2,19417,222,49,2585,3290,22.2,1756.1,19,3,1,3,8,4,0,0,0,0,14976,6.4,16127,222,43,-2585,-3290,22.2,1497.6
4527664086,0,37,2,0,7,5,7,2,1,1,0,16058,6.6,16690,158,59,-683,-2098,15.8,1605.8,15,2,1,5,7,3,0,0,0,0,16741,7.4,18788,214,54,683,2098,21.4,1674.1
4522283833,1,13,1,0,4,5,7,0,0,0,0,15921,7.0,18190,217,48,-594,-353,21.7,1592.1,14,1,1,5,4,7,2,1,1,0,16515,7.2,18543,235,48,594,353,23.5,1651.5
4515886739,1,12,4,0,8,4,15,0,0,0,0,16894,7.2,18333,219,40,1077,1096,21.9,1689.4,16,1,1,4,8,4,0,0,0,0,15817,6.8,17237,208,63,-1077,-1096,20.8,1581.7
4502928407,1,19,1,0,14,10,24,1,1,0,0,20114,7.0,19069,220,34,2397,3292,22.0,2011.4,18,3,1,10,14,9,0,0,0,0,17717,6.4,15777,144,60,-2397,-3292,14.4,1771.7
4515777597,1,22,5,1,12,7,20,1,1,0,0,19070,7.0,17872,210,56,2247,1367,21.0,1907.0,17,6,0,7,12,9,0,0,0,0,16823,6.6,16505,205,38,-2247,-1367,20.5,1682.3
4468741090,0,17,8,1,10,5,17,1,1,0,0,19190,7.2,18615,202,34,3386,2410,20.2,1919.0,18,3,0,5,10,8,1,0,1,0,15804,6.4,16205,224,48,-3386,-2410,22.4,1580.4
4494648390,0,15,3,1,6,8,8,0,0,0,0,15697,6.8,16449,196,44,-1237,-285,19.6,1569.7,14,2,0,8,6,13,0,0,0,0,16934,6.4,16734,201,47,1237,285,20.1,1693.4
4487099602,1,33,1,1,9,5,8,0,0,0,0,16959,7.2,19195,199,43,1788,1922,19.9,1695.9,15,2,0,5,9,2,0,0,0,0,15171,6.6,17273,187,44,-1788,-1922,18.7,1517.1
4480327869,0,16,0,0,5,12,8,0,0,0,0,14888,6.4,15213,153,48,-5010,-4509,15.3,1488.8,20,3,1,12,5,10,1,1,0,0,19898,7.6,19722,218,56,5010,4509,21.8,1989.8
4527378192,0,44,5,1,9,8,9,1,1,0,0,17375,7.2,18906,210,46,-522,269,21.0,1737.5,16,0,0,8,9,7,1,0,1,1,17897,7.0,18637,190,46,522,-269,19.0,1789.7
4523838951,0,90,1,1,4,5,2,0,0,0,0,15246,7.0,17687,217,47,-671,-738,21.7,1524.6,18,4,0,5,4,2,1,1,0,0,15917,7.0,18425,227,56,671,738,22.7,1591.7
4475624024,1,71,5,0,6,4,6,0,0,0,0,16112,6.8,17631,207,42,922,146,20.7,1611.2,23,4,1,4,6,5,2,1,1,0,15190,7.0,17485,199,72,-922,-146,19.9,1519.0
4486229170,0,16,2,1,5,9,3,0,0,0,0,14953,6.6,17141,183,60,-3042,-3641,18.3,1495.3,18,0,0,9,5,5,1,1,0,0,17995,7.6,20782,224,75,3042,3641,22.4,1799.5
4447295063,0,14,3,1,10,3,16,0,0,0,0,19475,7.2,18887,233,51,4765,3054,23.3,1947.5,17,0,0,3,10,3,1,1,0,0,14710,6.6,15833,202,52,-4765,-3054,20.2,1471.0
4479934294,0,13,1,0,3,5,3,0,0,0,0,14622,7.2,18174,206,62,-1567,-713,20.6,1462.2,16,2,1,5,3,3,1,1,0,0,16189,7.2,18887,237,52,1567,713,23.7,1618.9
4500080040,1,39,3,1,9,6,8,1,1,0,0,17797,7.2,19126,220,48,2094,2788,22.0,1779.7,16,3,0,6,9,8,0,0,0,0,15703,6.8,16338,203,40,-2094,-2788,20.3,1570.3
4472741177,1,25,6,1,10,1,7,1,0,1,0,19336,7.8,21123,267,52,6221,6143,26.7,1933.6,18,1,0,1,10,1,1,1,0,0,13115,6.2,14980,205,40,-6221,-6143,20.5,1311.5
4508000311,1,15,2,0,2,3,2,1,0,1,0,13978,6.6,16429,180,44,-977,-1025,18.0,1397.8,12,4,1,3,2,1,0,0,0,0,14955,6.8,17454,218,56,977,1025,21.8,1495.5
4523720024,1,16,0,1,5,1,3,1,0,1,0,16472,6.8,18393,252,48,1820,806,25.2,1647.2,17,4,0,1,5,2,1,1,0,0,14652,6.8,17587,239,60,-1820,-806,23.9,1465.2
4525829956,0,15,4,1,2,7,1,1,1,0,0,14324,6.6,16757,211,49,-2638,-1671,21.1,1432.4,16,1,0,7,2,6,0,0,0,0,16962,6.8,18428,244,42,2638,1671,24.4,1696.2
4524668512,1,19,5,1,6,9,8,1,0,1,0,16711,7.0,17375,217,52,-927,-200,21.7,1671.1,18,3,0,9,6,10,1,1,0,0,17638,6.8,17575,229,46,927,200,22.9,1763.8
4484824395,1,14,4,1,8,5,16,1,1,0,0,17338,7.0,18403,214,54,1554,727,21.4,1733.8,16,3,0,5,8,6,0,0,0,0,15784,6.6,17676,239,48,-1554,-727,23.9,1578.4
4466166046,1,19,10,1,11,9,9,0,0,0,0,18581,7.2,19012,239,36,1433,508,23.9,1858.1,30,5,0,9,11,7,1,1,0,0,17148,7.0,18504,218,44,-1433,-508,21.8,1714.8
4507963275,0,15,3,0,1,4,2,0,0,0,0,14996,6.8,17555,232,55,-844,-1002,23.2,1499.6,38,2,1,4,1,5,1,1,0,0,15840,7.2,18557,230,64,844,1002,23.0,1584.0
4521868981,1,17,2,1,8,3,7,0,0,0,0,17840,6.8,18356,233,40,3047,1616,23.3,1784.0,19,6,0,3,8,3,1,1,0,0,14793,6.6,16740,229,54,-3047,-1616,22.9,1479.3
4520501575,0,17,1,1,8,8,9,0,0,0,0,17245,6.8,17559,207,32,-1300,-1355,20.7,1724.5,11,2,0,8,8,8,1,1,0,0,18545,7.0,18914,244,52,1300,1355,24.4,1854.5
4450477657,1,13,2,1,8,6,5,0,0,0,1,17952,7.0,18161,210,32,2123,2563,21.0,1795.2,15,3,0,6,8,8,1,1,0,0,15829,6.2,15598,192,32,-2123,-2563,19.2,1582.9
4523064318,0,40,7,0,6,7,4,2,1,1,1,17433,6.8,17931,221,48,263,342,22.1,1743.3,28,3,1,7,6,9,0,0,0,0,17170,7.0,17589,206,48,-263,-342,20.6,1717.0
4455410303,1,15,5,0,7,4,8,1,1,0,0,17325,7.0,18954,207,55,1243,1506,20.7,1732.5,17,1,1,4,7,4,0,0,0,0,16082,6.8,17448,218,59,-1243,-1506,21.8,1608.2
4492870986,1,16,2,1,9,3,12,1,1,0,1,20316,7.4,18784,230,70,5073,1803,23.0,2031.6,11,1,0,3,9,3,1,0,1,0,15243,6.4,16981,224,69,-5073,-1803,22.4,1524.3
4524290588,1,14,2,1,5,4,6,0,0,0,0,17066,6.8,17494,236,46,2833,220,23.6,1706.6,12,0,0,4,5,2,1,1,0,0,14233,7.0,17274,172,67,-2833,-220,17.2,1423.3
4441984502,0,18,5,1,4,11,4,0,0,0,0,15704,6.4,16313,206,46,-3874,-2608,20.6,1570.4,15,5,0,11,4,17,1,1,0,1,19578,7.4,18921,238,45,3874,2608,23.8,1957.8
4520495410,1,14,7,0,6,6,9,1,1,0,1,18409,6.8,18255,212,60,225,-216,21.2,1840.9,24,3,1,6,6,4,1,0,1,2,18184,7.0,18471,242,60,-225,216,24.2,1818.4
4461499793,0,16,3,1,4,4,3,0,0,0,0,16175,6.8,17305,253,48,684,-474,25.3,1617.5,12,1,0,4,4,4,0,0,0,0,15491,7.0,17779,232,46,-684,474,23.2,1549.1
4520915828,0,16,0,0,13,7,19,1,1,0,0,19609,7.0,17551,207,32,3454,175,20.7,1960.9,13,2,1,7,13,6,0,0,0,0,16155,6.8,17376,201,45,-3454,-175,20.1,1615.5
4452157467,1,27,6,0,5,6,10,1,1,0,0,15853,7.0,17700,204,55,-153,-962,20.4,1585.3,20,5,1,6,5,4,0,0,0,0,16006,6.8,18662,241,44,153,962,24.1,1600.6
4454960221,0,46,3,0,5,12,4,0,0,0,0,16141,7.2,19127,215,52,-3324,-1649,21.5,1614.1,18,2,1,12,5,8,1,1,0,0,19465,7.6,20776,236,58,3324,1649,23.6,1946.5
4526073509,1,20,6,0,9,5,8,0,0,0,0,17562,6.6,17442,203,50,1975,812,20.3,1756.2,19,3,1,5,9,5,1,1,0,0,15587,6.6,16630,208,42,-1975,-812,20.8,1558.7
4519118449,1,15,2,0,10,3,13,1,1,0,0,18290,7.6,20250,248,44,3943,4243,24.8,1829.0,15,2,1,3,10,4,0,0,0,0,14347,6.4,16007,200,51,-3943,-4243,20.0,1434.7
4501834987,1,18,4,1,5,4,5,1,1,0,0,16688,7.2,18714,226,60,859,128,22.6,1668.8,14,3,0,4,5,5,0,0,0,0,15829,7.0,18586,242,36,-859,-128,24.2,1582.9
4524038349,1,13,1,1,6,2,7,1,1,0,0,16363,7.0,18353,218,52,2216,1311,21.8,1636.3,20,3,0,2,6,2,0,0,0,0,14147,6.6,17042,211,56,-2216,-1311,21.1,1414.7
4523620825,1,14,4,1,13,3,13,1,1,0,2,22049,7.4,19632,243,51,8532,5876,24.3,2204.9,15,2,0,3,13,2,0,0,0,0,13517,5.8,13756,165,46,-8532,-5876,16.5,1351.7
4502131494,1,13,1,0,9,8,17,1,1,0,0,17923,7.0,17698,189,54,-37,-100,18.9,1792.3,14,1,1,8,9,9,0,0,0,0,17960,7.0,17798,202,60,37,100,20.2,1796.0
4514844957,0,20,1,1,5,9,7,0,0,0,0,15666,6.6,15541,188,48,-2484,-3235,18.8,1566.6,16,3,0,9,5,5,1,1,0,0,18150,7.2,18776,235,56,2484,3235,23.5,1815.0
4526023571,1,17,0,0,5,4,8,1,0,1,0,15040,6.8,18066,197,44,-1964,-963,19.7,1504.0,11,1,1,4,5,4,0,0,0,0,17004,7.2,19029,260,72,1964,963,26.0,1700.4
4502376872,0,18,1,0,5,9,6,0,0,0,0,14988,6.6,16513,200,40,-2824,-2021,20.0,1498.8,16,4,1,9,5,10,0,0,0,0,17812,6.8,18534,222,56,2824,2021,22.2,1781.2
4481808559,0,16,1,1,4,6,2,0,0,0,0,16463,7.2,18904,247,71,801,1090,24.7,1646.3,10,0,0,6,4,7,1,1,0,0,15662,6.8,17814,197,60,-801,-1090,19.7,1566.2
4515821204,0,19,2,0,4,7,3,0,0,0,0,15817,6.8,17535,210,55,-1059,-951,21.0,1581.7,15,4,1,7,4,9,2,1,1,0,16876,7.0,18486,214,49,1059,951,21.4,1687.6
4462889102,1,18,1,1,9,7,9,0,0,0,0,18236,6.8,17468,207,63,2481,1470,20.7,1823.6,27,2,0,7,9,10,0,0,0,0,15755,6.6,15998,184,35,-2481,-1470,18.4,1575.5
4498200376,1,118,2,1,4,4,4,0,0,0,0,15184,6.8,17480,201,52,-825,-616,20.1,1518.4,20,4,0,4,4,4,0,0,0,0,16009,7.2,18096,210,52,825,616,21.0,1600.9
4500361216,1,18,2,1,3,3,8,0,0,0,0,15667,7.0,17801,212,64,644,427,21.2,1566.7,62,3,0,3,3,5,1,1,0,0,15023,7.0,17374,194,64,-644,-427,19.4,1502.3
4523641234,0,18,1,0,6,8,6,1,1,0,0,16029,6.8,17293,198,48,-1350,-1765,19.8,1602.9,12,3,1,8,6,6,0,0,0,0,17379,7.2,19058,206,51,1350,1765,20.6,1737.9
4486645307,1,20,3,1,3,6,2,0,0,0,0,15098,6.6,16937,232,50,-100,-305,23.2,1509.8,15,4,0,6,3,4,1,1,0,0,15198,6.8,17242,178,41,100,305,17.8,1519.8
4520010999,0,18,3,0,3,7,3,1,1,0,0,15335,6.6,17368,234,60,-1716,-1601,23.4,1533.5,16,6,1,7,3,5,0,0,0,0,17051,7.2,18969,262,36,1716,1601,26.2,1705.1
4465543181,0,17,4,0,1,10,1,0,0,0,0,14453,6.8,17152,244,52,-2889,-2882,24.4,1445.3,21,2,1,10,1,6,1,1,0,0,17342,7.2,20034,216,55,2889,2882,21.6,1734.2
4500614731,1,39,3,0,3,5,3,0,0,0,0,15610,7.2,19049,246,57,-99,727,24.6,1561.0,16,1,1,5,3,7,0,0,0,0,15709,6.8,18322,234,48,99,-727,23.4,1570.9
4523683062,0,13,5,0,5,6,5,0,0,0,0,15307,7.0,18407,218,39,-1259,-360,21.8,1530.7,20,6,1,6,5,12,0,0,0,0,16566,7.2,18767,250,47,1259,360,25.0,1656.6
4462505118,0,16,2,0,8,9,9,0,0,0,0,16075,6.8,17316,200,45,-1778,-1128,20.0,1607.5,19,5,1,9,8,10,1,1,0,0,17853,7.0,18444,208,50,1778,1128,20.8,1785.3
4438188395,0,19,3,0,9,8,8,0,0,0,0,16823,6.8,17411,219,33,-1071,-1667,21.9,1682.3,18,2,1,8,9,10,1,1,0,0,17894,7.2,19078,210,63,1071,1667,21.0,1789.4
4453451524,0,39,4,1,4,7,9,0,0,0,0,15766,6.6,16789,220,48,-1590,-780,22.0,1576.6,22,5,0,7,4,11,1,1,0,0,17356,6.8,17569,235,52,1590,780,23.5,1735.6
4526009569,0,37,2,0,1,9,3,0,0,0,0,13719,6.4,16024,202,43,-4492,-4085,20.2,1371.9,16,3,1,9,1,8,0,0,0,0,18211,7.6,20109,219,75,4492,4085,21.9,1821.1
4496870934,0,11,2,1,4,7,5,0,0,0,0,15312,6.6,16387,203,48,-1844,-2222,20.3,1531.2,16,0,0,7,4,10,0,0,0,0,17156,7.2,18609,227,48,1844,2222,22.7,1715.6
4522805623,1,18,2,1,10,8,13,1,0,1,0,18426,7.2,18454,192,46,1493,202,19.2,1842.6,31,4,0,8,10,7,0,0,0,0,16933,7.0,18252,185,53,-1493,-202,18.5,1693.3
4523720139,0,13,2,1,1,1,0,1,0,1,0,14737,7.0,18532,229,59,92,728,22.9,1473.7,11,2,0,1,1,0,0,0,0,0,14645,6.8,17804,199,59,-92,-728,19.9,1464.5
4463251548,1,14,7,1,9,9,13,2,1,1,0,17125,6.8,16776,191,52,-206,-363,19.1,1712.5,17,1,0,9,9,7,0,0,0,0,17331,6.6,17139,204,48,206,363,20.4,1733.1
4520745739,0,13,0,0,1,4,1,0,0,0,0,14878,7.0,18414,235,60,-1653,-1289,23.5,1487.8,13,1,1,4,1,4,1,1,0,0,16531,7.2,19703,258,64,1653,1289,25.8,1653.1
4526942362,1,14,0,1,12,7,10,2,1,1,0,18820,7.4,19789,207,71,1991,2474,20.7,1882.0,11,1,0,7,12,7,0,0,0,0,16829,6.8,17315,207,40,-1991,-2474,20.7,1682.9
4527220222,1,18,5,0,9,7,11,1,0,1,0,17578,7.2,18250,209,43,1641,1439,20.9,1757.8,18,4,1,7,9,10,0,0,0,0,15937,7.0,16811,175,56,-1641,-1439,17.5,1593.7
4508074123,1,17,3,1,10,6,8,0,0,0,0,18093,7.4,18871,222,42,1864,1877,22.2,1809.3,18,3,0,6,10,7,1,1,0,0,16229,6.6,16994,189,62,-1864,-1877,18.9,1622.9
4524338050,0,12,2,1,6,9,6,0,0,0,0,16325,6.4,16171,199,48,-852,-2912,19.9,1632.5,14,0,0,9,6,4,1,1,0,0,17177,7.2,19083,203,71,852,2912,20.3,1717.7
4454163991,0,12,4,0,5,8,5,1,1,0,0,15999,7.0,18592,241,48,-2450,-1839,24.1,1599.9,54,2,1,8,5,6,0,0,0,0,18449,7.2,20431,255,63,2450,1839,25.5,1844.9
4462050605,1,15,2,0,11,9,9,1,0,1,1,19754,7.0,18453,227,48,1379,246,22.7,1975.4,16,0,1,9,11,15,1,1,0,0,18375,7.2,18207,215,60,-1379,-246,21.5,1837.5
4525764211,0,11,0,0,2,6,2,0,0,0,0,14756,6.8,17221,217,50,-1942,-407,21.7,1475.6,10,3,1,6,2,6,1,1,0,0,16698,6.6,17628,212,69,1942,407,21.2,1669.8
4461046174,0,15,1,1,9,10,8,1,1,0,0,17136,6.8,17077,203,34,-1154,-93,20.3,1713.6,15,2,0,10,9,13,0,0,0,0,18290,6.6,17170,189,64,1154,93,18.9,1829.0
4465044945,1,15,2,0,13,3,13,1,0,1,0,20943,7.6,21575,235,64,6081,4748,23.5,2094.3,13,1,1,3,13,5,1,1,0,0,14862,6.6,16827,197,48,-6081,-4748,19.7,1486.2
4519842459,1,15,3,1,11,4,15,0,0,0,0,19432,7.2,19227,228,43,3857,2660,22.8,1943.2,19,2,0,4,11,6,1,1,0,0,15575,6.6,16567,210,53,-3857,-2660,21.0,1557.5
4520661562,1,20,4,1,10,3,8,1,0,1,0,17555,7.2,19037,242,36,3066,2297,24.2,1755.5,20,1,0,3,10,5,0,0,0,0,14489,6.8,16740,203,43,-3066,-2297,20.3,1448.9
4477292734,0,16,2,0,2,11,5,0,0,0,0,14486,6.4,15896,207,51,-3576,-3516,20.7,1448.6,88,3,1,11,2,11,1,0,1,0,18062,7.2,19412,205,56,3576,3516,20.5,1806.2
4491158196,1,18,3,1,10,7,12,1,0,1,1,19262,7.0,18021,223,44,1497,1555,22.3,1926.2,13,7,0,7,10,7,1,1,0,1,17765,6.6,16466,211,45,-1497,-1555,21.1,1776.5
4492470174,1,37,3,1,8,0,9,1,1,0,0,16977,7.4,19499,199,39,3115,2163,19.9,1697.7,14,1,0,0,8,0,0,0,0,0,13862,6.8,17336,217,67,-3115,-2163,21.7,1386.2
4522036239,1,17,3,1,11,3,11,1,0,1,0,18479,7.4,19708,232,48,3187,1811,23.2,1847.9,16,5,0,3,11,2,1,1,0,0,15292,6.8,17897,258,50,-3187,-1811,25.8,1529.2
4514072089,0,48,1,0,6,6,7,0,0,0,0,15867,7.0,17569,210,48,-430,159,21.0,1586.7,17,1,1,6,6,5,1,0,1,0,16297,6.8,17410,203,40,430,-159,20.3,1629.7
4515683822,0,13,2,0,6,8,7,1,1,0,0,16326,6.8,17923,236,40,-1114,-417,23.6,1632.6,33,2,1,8,6,12,0,0,0,0,17440,7.0,18340,241,47,1114,417,24.1,1744.0
4499966434,0,27,1,0,7,3,7,0,0,0,0,18284,7.2,19460,224,66,2748,2277,22.4,1828.4,16,3,1,3,7,2,1,1,0,0,15536,7.0,17183,211,66,-2748,-2277,21.1,1553.6
4513165995,1,17,7,1,7,4,6,1,1,0,0,17018,7.2,19495,238,40,1463,1571,23.8,1701.8,17,6,0,4,7,4,0,0,0,0,15555,7.0,17924,219,55,-1463,-1571,21.9,1555.5
4520842765,1,17,5,0,4,2,2,2,1,1,0,14729,6.8,18508,228,40,-17,588,22.8,1472.9,17,5,1,2,4,1,0,0,0,0,14746,6.8,17920,192,69,17,-588,19.2,1474.6
4523319289,1,13,2,0,3,5,5,1,1,0,0,15597,7.2,18348,249,55,200,532,24.9,1559.7,10,1,1,5,3,2,0,0,0,0,15397,7.0,17816,203,60,-200,-532,20.3,1539.7
4523527200,0,14,2,0,3,8,3,0,0,0,0,15505,6.8,17721,227,61,-1249,-853,22.7,1550.5,84,4,1,8,3,5,1,1,0,0,16754,7.2,18574,214,44,1249,853,21.4,1675.4
4525587151,1,16,3,1,14,7,11,1,1,0,0,20433,7.4,19171,219,45,4836,2713,21.9,2043.3,15,1,0,7,14,7,0,0,0,0,15597,6.4,16458,165,43,-4836,-2713,16.5,1559.7
4494811413,1,14,3,1,12,6,17,2,1,1,1,19993,7.0,17656,203,34,3439,913,20.3,1999.3,12,2,0,6,12,8,0,0,0,0,16554,6.8,16743,209,68,-3439,-913,20.9,1655.4
4523715592,0,14,2,0,4,7,4,0,0,0,0,15018,6.6,17474,200,50,-1910,-1781,20.0,1501.8,36,2,1,7,4,6,0,0,0,0,16928,7.2,19255,227,43,1910,1781,22.7,1692.8
4527045215,1,57,6,0,5,6,5,2,1,1,0,14875,6.8,17019,194,48,-1641,-602,19.4,1487.5,17,4,1,6,5,5,0,0,0,0,16516,6.8,17621,217,44,1641,602,21.7,1651.6
4513704975,0,12,2,0,3,11,4,0,0,0,0,14738,6.4,17148,197,63,-4199,-3186,19.7,1473.8,16,3,1,11,3,7,1,1,0,0,18937,7.6,20334,241,56,4199,3186,24.1,1893.7
4524367614,1,13,0,1,5,10,6,0,0,0,0,15366,6.8,16496,200,40,-2698,-2969,20.0,1536.6,17,0,0,10,5,8,2,1,1,0,18064,7.2,19465,221,52,2698,2969,22.1,1806.4
4470330490,0,41,4,1,5,3,5,1,1,0,0,15704,7.2,18000,213,59,1208,1363,21.3,1570.4,19,4,0,3,5,3,0,0,0,0,14496,6.8,16637,209,52,-1208,-1363,20.9,1449.6
4519478233,1,15,1,1,9,7,10,2,1,1,0,17208,7.2,18913,201,53,423,1071,20.1,1720.8,12,1,0,7,9,7,0,0,0,0,16785,7.0,17842,222,46,-423,-1071,22.2,1678.5
4484137639,0,14,1,1,5,4,2,0,0,0,0,15895,7.2,18881,229,57,688,872,22.9,1589.5,22,3,0,4,5,3,0,0,0,0,15207,7.0,18009,231,44,-688,-872,23.1,1520.7
4507103661,1,13,1,1,8,7,6,1,0,1,1,18271,6.8,18004,223,46,1656,95,22.3,1827.1,13,0,0,7,8,6,1,1,0,0,16615,7.0,17909,226,54,-1656,-95,22.6,1661.5
4482606346,0,16,4,1,8,6,11,1,1,0,0,17570,7.2,18879,222,47,1365,1563,22.2,1757.0,17,1,0,6,8,7,0,0,0,0,16205,6.8,17316,220,52,-1365,-1563,22.0,1620.5
4519787212,1,19,2,0,5,6,5,2,1,1,0,15594,7.0,18180,201,56,-1328,333,20.1,1559.4,23,4,1,6,5,7,0,0,0,0,16922,6.8,17847,227,60,1328,-333,22.7,1692.2
4511896350,1,37,0,0,6,4,8,0,0,0,0,16463,7.2,18961,221,60,354,816,22.1,1646.3,15,1,1,4,6,1,0,0,0,0,16109,7.0,18145,225,48,-354,-816,22.5,1610.9
4464555183,1,80,15,1,10,6,12,0,0,0,0,18951,7.0,17892,204,47,2896,1330,20.4,1895.1,34,2,0,6,10,7,0,0,0,0,16055,6.8,16562,196,40,-2896,-1330,19.6,1605.5
4456615224,0,16,3,0,3,5,2,0,0,0,0,15631,7.2,18436,252,53,-704,-1028,25.2,1563.1,16,1,1,5,3,4,1,1,0,0,16335,7.4,19464,229,72,704,1028,22.9,1633.5
4432850060,1,19,3,1,9,6,11,0,0,0,0,17561,7.0,19152,207,68,2134,1500,20.7,1756.1,15,4,0,6,9,2,1,1,0,0,15427,7.0,17652,204,48,-2134,-1500,20.4,1542.7
4461203281,0,17,3,0,1,9,2,0,0,0,0,13570,6.2,15620,194,52,-6578,-4807,19.4,1357.0,21,3,1,9,1,8,2,1,1,1,20148,7.2,20427,267,63,6578,4807,26.7,2014.8
4524853879,0,12,5,1,5,6,8,1,1,0,0,15999,6.6,17033,234,44,-415,-498,23.4,1599.9,16,1,0,6,5,8,0,0,0,0,16414,7.0,17531,226,48,415,498,22.6,1641.4
4471979738,0,17,1,1,12,8,10,1,1,0,0,19079,7.0,18774,206,58,1330,854,20.6,1907.9,16,1,0,8,12,7,0,0,0,0,17749,7.0,17920,212,48,-1330,-854,21.2,1774.9
4455505854,0,41,6,1,9,4,10,1,1,0,0,17405,6.8,18506,187,46,1996,860,18.7,1740.5,20,5,0,4,9,3,0,0,0,0,15409,7.0,17646,236,40,-1996,-860,23.6,1540.9
4465145737,1,14,0,1,8,5,9,0,0,0,0,17759,7.2,18407,232,44,2450,216,23.2,1775.9,52,2,0,5,8,5,1,1,0,0,15309,6.8,18191,174,60,-2450,-216,17.4,1530.9
4526117420,1,15,5,1,4,3,3,0,0,0,0,16275,7.4,19461,244,60,846,1138,24.4,1627.5,16,2,0,3,4,1,0,0,0,0,15429,7.2,18323,233,60,-846,-1138,23.3,1542.9
4521352083,0,31,4,0,4,9,3,1,1,0,0,15367,6.6,17109,214,54,-2572,-2642,21.4,1536.7,45,0,1,9,4,12,1,0,1,0,17939,7.0,19751,198,70,2572,2642,19.8,1793.9
4511026023,1,16,6,0,6,5,7,1,0,1,0,16106,6.8,18229,216,47,-443,396,21.6,1610.6,16,3,1,5,6,6,1,1,0,0,16549,7.0,17833,240,59,443,-396,24.0,1654.9
4478222063,1,18,3,0,7,5,9,0,0,0,0,16518,6.6,17024,202,44,238,275,20.2,1651.8,147,3,1,5,7,9,0,0,0,0,16280,6.6,16749,210,42,-238,-275,21.0,1628.0
4511234219,0,13,1,0,4,9,8,0,0,0,0,17071,6.8,17610,205,48,-1763,-2184,20.5,1707.1,13,2,1,9,4,10,1,1,0,0,18834,7.4,19794,236,56,1763,2184,23.6,1883.4
4510119055,1,88,4,1,8,4,4,1,1,0,0,17763,7.0,18822,246,48,2183,263,24.6,1776.3,14,1,0,4,8,6,0,0,0,0,15580,7.0,18559,212,68,-2183,-263,21.2,1558.0
4524910590,0,12,2,0,5,8,7,0,0,0,0,15513,6.6,17308,203,43,-1791,507,20.3,1551.3,11,0,1,8,5,14,2,1,1,0,17304,6.8,16801,225,41,1791,-507,22.5,1730.4
4522149954,0,18,1,1,8,8,13,0,0,0,0,17833,7.0,18351,191,61,1256,301,19.1,1783.3,15,1,0,8,8,7,0,0,0,0,16577,7.0,18050,193,43,-1256,-301,19.3,1657.7
4514792667,0,14,2,1,3,7,3,0,0,0,0,14110,6.4,15832,162,48,-2566,-2246,16.2,1411.0,15,2,0,7,3,3,0,0,0,0,16676,6.8,18078,228,47,2566,2246,22.8,1667.6
4516234243,1,40,5,1,2,1,3,0,0,0,0,14895,6.8,17420,236,52,773,320,23.6,1489.5,16,3,0,1,2,0,1,1,0,0,14122,6.8,17100,212,48,-773,-320,21.2,1412.2
4454688114,0,17,4,0,2,9,2,0,0,0,0,14366,6.6,16510,221,55,-3046,-1990,22.1,1436.6,21,4,1,9,2,15,1,1,0,0,17412,7.2,18500,222,44,3046,1990,22.2,1741.2
4478918776,0,11,2,0,2,4,5,1,0,1,0,14613,6.8,17026,233,47,-2539,-943,23.3,1461.3,13,5,1,4,2,7,1,1,0,0,17152,7.0,17969,234,47,2539,943,23.4,1715.2
4524031619,0,19,5,1,3,7,4,1,1,0,0,15311,6.8,16384,234,46,-1768,-963,23.4,1531.1,15,3,0,7,3,12,1,0,1,0,17079,6.6,17347,217,44,1768,963,21.7,1707.9
4497712191,1,13,4,0,4,5,7,0,0,0,0,16301,7.2,19215,254,62,-27,394,25.4,1630.1,18,2,1,5,4,6,1,1,0,0,16328,7.2,18821,234,46,27,-394,23.4,1632.8
4520650822,0,16,3,1,3,3,3,1,1,0,0,15471,7.0,17472,233,56,-390,-502,23.3,1547.1,19,4,0,3,3,5,1,0,1,0,15861,6.8,17974,240,47,390,502,24.0,1586.1
4473315873,1,11,2,1,12,3,10,1,1,0,0,19402,7.4,19955,242,44,5650,4520,24.2,1940.2,13,2,0,3,12,4,0,0,0,0,13752,6.4,15435,188,40,-5650,-4520,18.8,1375.2
4412240530,1,34,2,1,9,3,6,0,0,0,0,17484,7.4,20325,230,50,1128,858,23.0,1748.4,15,3,0,3,9,2,1,1,0,0,16356,7.4,19467,226,80,-1128,-858,22.6,1635.6
4438138890,1,18,0,0,6,8,6,0,0,0,0,16590,7.0,18284,213,49,544,75,21.3,1659.0,12,1,1,8,6,7,0,0,0,0,16046,7.0,18209,182,44,-544,-75,18.2,1604.6
4521258237,1,54,4,1,7,3,8,0,0,0,0,17552,7.4,19684,233,53,2098,2184,23.3,1755.2,14,2,0,3,7,3,2,1,1,0,15454,6.8,17500,236,46,-2098,-2184,23.6,1545.4
4524894613,0,18,2,1,8,2,8,1,0,1,0,17847,7.0,18916,207,60,3060,1838,20.7,1784.7,15,2,0,2,8,3,0,0,0,0,14787,6.6,17078,221,60,-3060,-1838,22.1,1478.7
4472513003,1,15,3,0,11,7,17,1,1,0,0,18078,6.8,18102,192,64,1328,1106,19.2,1807.8,16,2,1,7,11,6,0,0,0,0,16750,6.8,16996,197,39,-1328,-1106,19.7,1675.0
4515493524,0,12,5,1,7,3,5,0,0,0,0,17019,7.2,19372,236,46,1175,963,23.6,1701.9,18,4,0,3,7,3,2,1,1,0,15844,6.8,18409,231,69,-1175,-963,23.1,1584.4
4484161363,0,17,3,0,11,11,13,1,1,0,0,18614,7.0,18540,208,48,-558,-1482,20.8,1861.4,17,2,1,11,11,15,0,0,0,0,19172,7.6,20022,227,52,558,1482,22.7,1917.2
4519425704,1,15,7,1,11,5,12,0,0,0,0,18480,6.8,17912,201,42,2532,1229,20.1,1848.0,14,3,0,5,11,10,0,0,0,0,15948,6.6,16683,203,51,-2532,-1229,20.3,1594.8
4513532408,1,85,6,1,6,3,5,2,1,1,0,18596,7.0,19244,254,71,4633,3451,25.4,1859.6,16,2,0,3,6,3,0,0,0,0,13963,6.6,15793,192,33,-4633,-3451,19.2,1396.3
4452789398,1,27,0,0,5,3,7,0,0,0,0,16239,7.2,18466,189,60,906,1767,18.9,1623.9,11,3,1,3,5,3,1,1,0,0,15333,6.6,16699,221,60,-906,-1767,22.1,1533.3
4520872847,0,16,4,0,7,8,7,1,1,0,0,16019,6.6,16667,174,50,-388,-619,17.4,1601.9,18,3,1,8,7,8,0,0,0,0,16407,6.8,17286,207,45,388,619,20.7,1640.7
4524577264,0,16,5,0,4,5,7,0,0,0,0,15820,7.0,18001,242,58,-758,-392,24.2,1582.0,16,3,1,5,4,4,2,1,1,0,16578,7.2,18393,229,52,758,392,22.9,1657.8
4482394402,1,19,3,0,8,9,10,0,0,0,0,17054,7.0,17591,211,40,-891,-633,21.1,1705.4,14,2,1,9,8,13,1,1,0,0,17945,7.0,18224,219,32,891,633,21.9,1794.5
4464462624,0,14,3,1,3,5,2,0,0,0,0,14745,6.8,17586,213,44,-1815,-671,21.3,1474.5,41,5,0,5,3,5,1,1,0,0,16560,7.0,18257,211,76,1815,671,21.1,1656.0
4413342803,0,36,1,1,1,9,0,0,0,0,0,13860,6.4,16122,203,49,-5214,-3160,20.3,1386.0,13,4,0,9,1,10,1,0,1,1,19074,7.2,19282,233,43,5214,3160,23.3,1907.4
4499650964,1,14,2,0,8,5,9,0,0,0,0,18886,7.2,20642,240,72,3634,3559,24.0,1888.6,17,0,1,5,8,7,0,0,0,0,15252,6.8,17083,175,50,-3634,-3559,17.5,1525.2
4523557396,0,20,1,1,8,8,11,0,0,0,0,16922,7.0,17511,191,44,118,-532,19.1,1692.2,17,6,0,8,8,12,1,1,0,0,16804,7.0,18043,193,62,-118,532,19.3,1680.4
4467751536,0,14,3,0,4,6,2,0,0,0,0,14360,6.6,16876,175,39,-3424,-1550,17.5,1436.0,17,5,1,6,4,4,1,1,0,1,17784,7.2,18426,207,48,3424,1550,20.7,1778.4
4448051945,1,18,4,1,7,2,7,1,1,0,0,16896,7.0,18664,246,52,2438,1105,24.6,1689.6,13,3,0,2,7,2,0,0,0,0,14458,6.6,17559,211,52,-2438,-1105,21.1,1445.8
4527198639,0,16,1,1,4,9,2,0,0,0,0,15285,6.8,16734,194,49,-974,-815,19.4,1528.5,40,3,0,9,4,12,1,1,0,0,16259,6.6,17549,184,33,974,815,18.4,1625.9
4467814898,0,14,1,0,2,9,1,0,0,0,0,14048,6.4,16395,209,36,-4004,-3300,20.9,1404.8,14,5,1,9,2,9,2,1,1,0,18052,7.2,19695,237,56,4004,3300,23.7,1805.2
4486550579,1,19,1,1,13,5,13,1,1,0,1,21132,7.6,19941,217,56,6289,3996,21.7,2113.2,15,3,0,5,13,6,0,0,0,0,14843,6.4,15945,179,32,-6289,-3996,17.9,1484.3
4494125131,1,13,1,1,1,4,0,1,1,0,0,14894,6.6,16548,244,44,-2094,-2508,24.4,1489.4,12,1,0,4,1,7,0,0,0,0,16988,7.0,19056,230,66,2094,2508,23.0,1698.8
4462606052,0,22,4,1,8,10,11,0,0,0,0,16756,6.8,16405,192,48,-1429,-1521,19.2,1675.6,22,6,0,10,8,11,1,0,1,0,18185,6.8,17926,209,60,1429,1521,20.9,1818.5
4521086709,1,12,4,0,9,2,13,1,1,0,0,18442,7.0,18882,256,56,4401,2408,25.6,1844.2,18,2,1,2,9,5,0,0,0,0,14041,6.6,16474,193,47,-4401,-2408,19.3,1404.1
4525152845,0,14,1,0,4,12,3,0,0,0,0,14456,6.6,17039,212,46,-4680,-3190,21.2,1445.6,15,1,1,12,4,14,2,1,1,0,19136,7.6,20229,220,64,4680,3190,22.0,1913.6
4500092661,0,17,4,0,4,8,5,1,1,0,0,15591,7.0,17848,228,59,-1951,-1575,22.8,1559.1,19,4,1,8,4,6,0,0,0,0,17542,7.4,19423,236,42,1951,1575,23.6,1754.2
4495708028,0,13,1,0,5,9,5,0,0,0,0,16841,6.8,17341,234,46,-1482,-724,23.4,1684.1,16,1,1,9,5,11,1,1,0,0,18323,7.0,18065,199,52,1482,724,19.9,1832.3
4511072996,0,13,1,1,8,10,14,1,1,0,0,17275,6.8,16684,204,55,-604,-1254,20.4,1727.5,37,5,0,10,8,16,0,0,0,0,17879,7.0,17938,186,52,604,1254,18.6,1787.9
4443034912,1,14,0,1,12,4,5,1,0,1,2,20018,7.6,20654,226,44,6489,4212,22.6,2001.8,13,1,0,4,12,0,1,1,0,0,13529,6.6,16442,172,37,-6489,-4212,17.2,1352.9
4519116832,0,19,1,1,9,9,11,0,0,0,0,17459,6.8,17338,226,44,-531,-1077,22.6,1745.9,84,1,0,9,9,11,0,0,0,0,17990,7.2,18415,200,43,531,1077,20.0,1799.0
4524666891,1,16,3,1,8,8,4,0,0,0,0,17240,7.0,18845,248,48,699,944,24.8,1724.0,17,3,0,8,8,6,1,1,0,0,16541,6.8,17901,179,57,-699,-944,17.9,1654.1
4488286080,1,21,5,0,1,8,0,1,1,0,0,14019,6.6,17177,206,64,-3720,-2126,20.6,1401.9,22,6,1,8,1,10,0,0,0,0,17739,7.4,19303,251,33,3720,2126,25.1,1773.9
4517973662,0,18,3,1,4,5,5,1,1,0,0,15101,6.8,17275,205,53,-654,-97,20.5,1510.1,15,3,0,5,4,10,0,0,0,0,15755,7.0,17372,212,48,654,97,21.2,1575.5
4441440280,0,36,1,0,8,4,6,0,0,0,0,17235,7.0,18992,214,52,2203,2404,21.4,1723.5,14,0,1,4,8,5,1,1,0,0,15032,6.6,16588,205,44,-2203,-2404,20.5,1503.2
4506349624,1,24,4,0,6,6,4,0,0,0,0,17388,7.2,19549,250,60,1994,230,25.0,1738.8,37,3,1,6,6,2,1,1,0,0,15394,7.2,19319,205,63,-1994,-230,20.5,1539.4
4509531529,0,14,7,0,4,4,7,1,1,0,0,16157,6.8,18679,239,64,-521,97,23.9,1615.7,23,3,1,4,4,3,0,0,0,0,16678,7.0,18582,255,57,521,-97,25.5,1667.8
4480560501,1,15,4,0,6,4,7,0,0,0,0,16041,6.8,18070,223,48,550,1023,22.3,1604.1,86,3,1,4,6,5,1,1,0,0,15491,6.6,17047,214,40,-550,-1023,21.4,1549.1
4497596162,1,15,1,1,12,2,14,1,0,1,0,18242,7.0,17997,195,58,4484,2878,19.5,1824.2,18,3,0,2,12,1,0,0,0,0,13758,6.2,15119,199,32,-4484,-2878,19.9,1375.8
4518736479,0,14,0,1,7,7,6,0,0,0,0,17345,7.0,19182,226,56,179,953,22.6,1734.5,18,0,0,7,7,5,0,0,0,0,17166,7.0,18229,252,44,-179,-953,25.2,1716.6
4477518558,1,19,1,0,9,8,13,1,1,0,0,17813,6.8,17461,202,66,986,549,20.2,1781.3,15,2,1,8,9,13,0,0,0,0,16827,6.6,16912,216,39,-986,-549,21.6,1682.7
4509363345,0,40,2,1,6,8,9,0,0,0,0,16185,6.8,17924,204,40,-2100,-925,20.4,1618.5,14,20,0,8,6,12,2,1,1,1,18285,7.0,18849,199,40,2100,925,19.9,1828.5
4510888904,0,18,2,0,8,13,5,0,0,0,0,16077,6.8,16712,180,48,-3056,-2462,18.0,1607.7,17,4,1,13,8,12,0,0,0,0,19133,7.2,19174,223,38,3056,2462,22.3,1913.3
4518167002,1,16,3,1,6,3,4,1,1,0,0,16508,6.6,17714,243,45,2024,1979,24.3,1650.8,14,2,0,3,6,4,1,0,1,0,14484,6.4,15735,213,40,-2024,-1979,21.3,1448.4
4524045722,1,33,2,1,9,4,8,1,0,1,0,18829,7.2,18693,233,52,4141,2833,23.3,1882.9,12,1,0,4,9,3,0,0,0,0,14688,6.6,15860,198,51,-4141,-2833,19.8,1468.8
4516698364,1,15,2,0,5,4,7,0,0,0,0,15936,7.0,18030,205,43,554,-702,20.5,1593.6,28,0,1,4,5,4,0,0,0,0,15382,7.0,18732,179,68,-554,702,17.9,1538.2
4524415638,0,15,2,1,5,6,4,0,0,0,0,15109,7.0,18112,213,43,-1493,-382,21.3,1510.9,98,3,0,6,5,2,1,1,0,0,16602,7.0,18494,230,52,1493,382,23.0,1660.2
4503340964,1,16,5,1,7,10,4,0,0,0,0,16805,7.0,18285,229,55,-1785,-1131,22.9,1680.5,19,2,0,10,7,12,2,1,1,0,18590,7.4,19416,248,56,1785,1131,24.8,1859.0
4496960681,0,21,8,0,1,12,1,0,0,0,0,13525,6.4,15625,210,46,-5423,-4119,21.0,1352.5,39,6,1,12,1,14,1,1,0,0,18948,7.4,19744,206,46,5423,4119,20.6,1894.8
4521937261,0,16,2,0,3,8,4,2,1,1,0,15209,6.6,16256,191,60,-2752,-2286,19.1,1520.9,17,4,1,8,3,9,0,0,0,0,17961,7.2,18542,241,52,2752,2286,24.1,1796.1
4522582067,0,15,0,0,6,9,8,0,0,0,0,15591,6.6,16788,204,35,-2322,-2808,20.4,1559.1,15,1,1,9,6,7,1,1,0,0,17913,7.2,19596,216,60,2322,2808,21.6,1791.3
4518695015,1,17,1,0,6,10,4,0,0,0,0,16149,6.8,17146,212,44,-1286,-848,21.2,1614.9,17,2,1,10,6,14,0,0,0,0,17435,7.0,17994,190,35,1286,848,19.0,1743.5
4521066118,0,15,3,0,1,7,2,1,1,0,0,13449,6.6,16281,205,45,-4357,-4959,20.5,1344.9,54,4,1,7,1,9,0,0,0,0,17806,7.6,21240,226,79,4357,4959,22.6,1780.6
4517064230,1,13,2,1,9,7,10,1,0,1,0,16983,6.8,17424,183,40,422,-308,18.3,1698.3,15,2,0,7,9,6,1,1,0,0,16561,7.0,17732,200,64,-422,308,20.0,1656.1
4517934356,0,83,4,1,5,9,3,0,0,0,0,16259,6.4,16804,224,43,-1501,-2063,22.4,1625.9,39,4,0,9,5,7,1,1,0,0,17760,7.2,18867,240,60,1501,2063,24.0,1776.0
4527289759,1,18,2,0,2,4,1,0,0,0,0,13995,7.0,17605,176,71,-1171,-854,17.6,1399.5,51,5,1,4,2,6,1,1,0,0,15166,7.0,18459,218,64,1171,854,21.8,1516.6
4438038380,0,17,2,1,7,5,10,0,0,0,0,17098,7.2,18682,229,58,1733,862,22.9,1709.8,55,2,0,5,7,4,1,1,0,0,15365,6.8,17820,206,63,-1733,-862,20.6,1536.5
4475988049,1,52,1,1,10,5,11,0,0,0,0,17741,6.8,18253,230,40,2405,1439,23.0,1774.1,12,5,0,5,10,6,1,1,0,0,15336,6.8,16814,199,40,-2405,-1439,19.9,1533.6
4474395162,0,17,2,0,8,5,8,0,0,0,0,16752,7.0,18737,229,32,583,751,22.9,1675.2,14,2,1,5,8,5,1,1,0,0,16169,7.0,17986,201,55,-583,-751,20.1,1616.9
4488817314,0,16,3,1,12,9,20,0,0,0,0,19098,7.0,18390,230,36,1769,2294,23.0,1909.8,16,2,0,9,12,14,1,1,0,0,17329,6.4,16096,166,60,-1769,-2294,16.6,1732.9
4524429055,0,19,2,1,4,0,2,2,1,1,0,16124,7.4,18986,244,76,2186,1319,24.4,1612.4,18,3,0,0,4,0,0,0,0,0,13938,6.8,17667,241,51,-2186,-1319,24.1,1393.8
4493030469,0,13,1,0,8,6,8,0,0,0,0,17251,6.6,17267,192,63,339,876,19.2,1725.1,16,0,1,6,8,7,0,0,0,0,16912,6.4,16391,203,48,-339,-876,20.3,1691.2
4439238044,1,16,1,1,8,6,10,1,1,0,1,18519,7.2,18555,223,48,1840,144,22.3,1851.9,17,0,0,6,8,6,1,0,1,0,16679,7.2,18411,214,52,-1840,-144,21.4,1667.9
4503713069,1,17,0,1,4,2,4,0,0,0,0,14673,6.4,16034,183,47,-110,-1469,18.3,1467.3,14,3,0,2,4,3,2,1,1,0,14783,6.8,17503,214,56,110,1469,21.4,1478.3
4500655120,0,18,0,0,2,6,1,1,1,0,0,14555,6.6,16722,232,44,-2459,-2110,23.2,1455.5,61,6,1,6,2,10,0,0,0,0,17014,7.2,18832,243,60,2459,2110,24.3,1701.4
4524115285,0,34,3,0,4,9,3,0,0,0,0,13670,6.2,15417,166,30,-6282,-4301,16.6,1367.0,14,2,1,9,4,8,1,1,0,1,19952,7.2,19718,233,65,6282,4301,23.3,1995.2
4516264231,1,17,4,1,5,9,8,0,0,0,0,16426,7.0,18382,231,60,-642,-397,23.1,1642.6,16,3,0,9,5,6,1,1,0,0,17068,7.0,18779,193,59,642,397,19.3,1706.8
4505841827,0,105,1,1,6,6,4,1,0,1,0,16970,6.8,17984,236,56,-153,79,23.6,1697.0,13,4,0,6,6,9,1,1,0,0,17123,7.0,17905,223,55,153,-79,22.3,1712.3
4516392840,0,9,3,1,7,7,6,1,0,1,0,17634,7.2,18416,237,52,825,-1367,23.7,1763.4,14,0,0,7,7,4,1,1,0,0,16809,7.0,19783,215,59,-825,1367,21.5,1680.9
4517507024,0,18,6,0,5,6,6,1,1,0,0,15826,6.8,17837,235,52,-1177,-1157,23.5,1582.6,18,4,1,6,5,4,0,0,0,0,17003,7.4,18994,242,49,1177,1157,24.2,1700.3
4466226469,1,19,2,1,2,7,2,1,1,0,0,15222,7.0,17812,231,64,-1586,410,23.1,1522.2,17,5,0,7,2,14,1,0,1,0,16808,6.8,17402,211,64,1586,-410,21.1,1680.8
4523988363,1,12,2,0,6,10,4,1,0,1,0,15292,6.8,17766,190,47,-2888,-1772,19.0,1529.2,12,2,1,10,6,11,1,1,0,0,18180,7.2,19538,231,42,2888,1772,23.1,1818.0
4524842008,0,19,3,0,4,6,7,1,1,0,0,14931,6.4,16059,199,46,-2698,-2458,19.9,1493.1,17,2,1,6,4,11,1,0,1,0,17629,7.0,18517,239,49,2698,2458,23.9,1762.9
4515999834,1,16,1,1,10,10,13,0,0,0,0,17917,6.8,17997,199,44,-1074,-1029,19.9,1791.7,18,2,0,10,10,9,1,1,0,0,18991,7.2,19026,233,56,1074,1029,23.3,1899.1
4521993716,0,13,2,0,7,5,9,0,0,0,0,16542,6.8,17667,214,44,798,-1263,21.4,1654.2,22,2,1,5,7,4,1,1,0,0,15744,7.2,18930,195,76,-798,1263,19.5,1574.4
4395442745,1,24,4,1,9,7,16,0,0,0,0,18000,7.0,18178,204,40,796,290,20.4,1800.0,15,4,0,7,9,17,0,0,0,0,17204,6.8,17888,187,64,-796,-290,18.7,1720.4
4471001241,1,19,5,0,6,3,4,0,0,0,0,16335,6.8,17761,236,33,1167,489,23.6,1633.5,87,2,1,3,6,1,1,1,0,0,15168,6.8,17272,206,52,-1167,-489,20.6,1516.8
4523726698,0,20,22,0,3,11,7,0,0,0,0,13511,5.8,14048,164,39,-5427,-4559,16.4,1351.1,40,3,1,11,3,14,1,1,0,0,18938,7.2,18607,239,57,5427,4559,23.9,1893.8
4518530813,0,23,3,0,11,6,12,0,0,0,0,17944,7.0,17835,214,30,901,144,21.4,1794.4,21,7,1,6,11,5,0,0,0,0,17043,6.8,17691,230,53,-901,-144,23.0,1704.3
4459705547,1,39,3,0,9,5,8,1,1,0,0,16997,7.8,20958,222,52,1176,3600,22.2,1699.7,11,2,1,5,9,9,1,0,1,0,15821,6.8,17358,196,46,-1176,-3600,19.6,1582.1
4485783788,0,15,0,1,4,4,6,0,0,0,0,15711,7.4,19278,210,57,-204,1135,21.0,1571.1,19,0,0,4,4,4,1,1,0,0,15915,7.0,18143,229,58,204,-1135,22.9,1591.5
4516489308,0,14,2,0,4,8,6,0,0,0,0,14291,6.8,16706,178,44,-3378,-2082,17.8,1429.1,14,1,1,8,4,10,1,1,0,0,17669,7.2,18788,233,45,3378,2082,23.3,1766.9
4459966924,1,15,3,1,5,1,5,0,0,0,0,16618,7.2,19643,250,52,2263,1451,25.0,1661.8,16,1,0,1,5,1,0,0,0,0,14355,6.8,18192,243,52,-2263,-1451,24.3,1435.5
4410019021,1,19,5,1,4,6,3,1,1,0,0,15373,6.4,16354,228,54,-1323,-1422,22.8,1537.3,19,3,0,6,4,5,0,0,0,0,16696,7.0,17776,216,59,1323,1422,21.6,1669.6
4484818396,0,15,3,1,3,3,1,1,1,0,0,15848,7.0,18490,251,60,1259,720,25.1,1584.8,20,1,0,3,3,2,0,0,0,0,14589,6.8,17770,220,43,-1259,-720,22.0,1458.9
4522689643,0,17,1,1,4,6,3,1,1,0,0,16061,7.2,18335,228,73,-299,454,22.8,1606.1,12,2,0,6,4,5,0,0,0,0,16360,6.6,17881,225,37,299,-454,22.5,1636.0
4450553888,0,12,4,0,10,8,9,1,1,0,0,17344,7.0,18253,184,48,706,766,18.4,1734.4,21,2,1,8,10,7,1,0,1,0,16638,6.6,17487,206,40,-706,-766,20.6,1663.8
4524499414,0,17,2,0,3,3,3,0,0,0,0,14731,7.0,17886,204,52,-1148,708,20.4,1473.1,19,3,1,3,3,4,1,1,0,0,15879,6.8,17178,237,52,1148,-708,23.7,1587.9
4486440363,0,38,1,1,3,11,5,0,0,0,0,14496,6.4,16377,215,48,-5003,-4682,21.5,1449.6,56,0,0,11,3,17,1,1,0,0,19499,7.6,21059,208,83,5003,4682,20.8,1949.9
4508183655,1,12,6,0,6,1,10,0,0,0,0,16702,7.2,18943,234,56,1868,1041,23.4,1670.2,20,2,1,1,6,1,1,1,0,0,14834,7.0,17902,230,60,-1868,-1041,23.0,1483.4
4520578411,0,18,4,0,2,5,3,1,1,0,0,15474,7.4,19351,244,72,-902,385,24.4,1547.4,51,2,1,5,2,7,1,0,1,0,16376,7.2,18966,237,56,902,-385,23.7,1637.6
4459502847,0,16,1,0,8,4,10,1,0,1,0,16696,7.0,17832,206,44,865,1006,20.6,1669.6,10,1,1,4,8,3,0,0,0,0,15831,6.6,16826,220,39,-865,-1006,22.0,1583.1
4516329473,1,15,2,1,3,2,3,1,1,0,0,16095,7.0,18658,254,53,1287,603,25.4,1609.5,13,1,0,2,3,2,0,0,0,0,14808,6.6,18055,241,51,-1287,-603,24.1,1480.8
4446742734,1,17,2,1,10,3,11,1,1,0,0,17959,7.2,19184,222,44,3136,1557,22.2,1795.9,34,2,0,3,10,1,0,0,0,0,14823,6.8,17627,221,48,-3136,-1557,22.1,1482.3
4499965552,1,18,1,1,10,2,8,1,1,0,1,20127,7.2,19673,251,60,6148,3541,25.1,2012.7,13,2,0,2,10,1,0,0,0,0,13979,6.4,16132,196,50,-6148,-3541,19.6,1397.9
4527621723,1,46,0,1,10,2,7,2,1,1,3,19557,7.0,18070,191,51,4380,3242,19.1,1955.7,9,2,0,2,10,4,0,0,0,1,15177,6.0,14828,184,49,-4380,-3242,18.4,1517.7
4473264225,0,18,1,1,6,15,9,0,0,0,0,16205,6.4,15951,171,44,-3719,-3695,17.1,1620.5,42,3,0,15,6,14,1,1,0,0,19924,7.4,19646,216,48,3719,3695,21.6,1992.4
4516088555,1,16,5,1,8,0,7,2,1,1,3,20685,8.0,21642,279,58,7761,5818,27.9,2068.5,20,1,0,0,8,0,0,0,0,0,12924,6.4,15824,201,44,-7761,-5818,20.1,1292.4
4518449661,0,15,1,0,3,7,4,0,0,0,0,15598,6.8,17735,220,69,-1293,-260,22.0,1559.8,25,1,1,7,3,6,1,1,0,0,16891,7.0,17995,237,42,1293,260,23.7,1689.1
4520980725,1,13,3,1,16,7,26,1,1,0,0,19776,7.0,17806,191,46,2806,-579,19.1,1977.6,11,3,0,7,16,11,0,0,0,0,16970,7.2,18385,197,58,-2806,579,19.7,1697.0
4484733667,0,16,2,1,3,3,4,0,0,0,0,14951,6.8,17903,225,44,-1036,-942,22.5,1495.1,17,1,0,3,3,3,1,1,0,0,15987,7.2,18845,252,58,1036,942,25.2,1598.7
4522151939,0,17,7,0,7,7,6,0,0,0,0,16230,6.8,17336,216,40,-4,-139,21.6,1623.0,14,3,1,7,7,5,0,0,0,0,16234,7.0,17475,177,63,4,139,17.7,1623.4
4477326347,1,24,1,1,4,3,3,1,0,1,0,16422,6.8,18048,242,54,1571,560,24.2,1642.2,16,2,0,3,4,3,1,1,0,0,14851,7.0,17488,211,56,-1571,-560,21.1,1485.1
4520786519,0,19,8,0,5,4,5,1,1,0,0,16221,7.0,18135,241,49,1457,1939,24.1,1622.1,22,2,1,4,5,9,0,0,0,0,14764,6.6,16196,205,43,-1457,-1939,20.5,1476.4
4481910360,0,20,2,1,5,3,12,2,1,1,0,15229,6.8,16903,160,48,-174,-70,16.0,1522.9,16,4,0,3,5,2,0,0,0,0,15403,6.6,16973,235,40,174,70,23.5,1540.3
4518851187,0,15,2,0,1,6,1,0,0,0,0,13427,6.8,16472,211,44,-3175,-1845,21.1,1342.7,16,4,1,6,1,5,1,1,0,0,16602,7.0,18317,217,64,3175,1845,21.7,1660.2
4467416577,0,17,2,0,2,7,3,1,0,1,0,13889,6.8,16427,205,47,-3012,-1300,20.5,1388.9,12,2,1,7,2,10,1,1,0,0,16901,7.2,17727,195,48,3012,1300,19.5,1690.1
4451574648,1,20,4,0,7,7,9,0,0,0,0,16946,6.8,17971,217,55,380,1750,21.7,1694.6,16,1,1,7,7,10,2,1,1,0,16566,6.6,16221,230,36,-380,-1750,23.0,1656.6
4526590515,1,12,1,1,12,5,11,1,1,0,0,17465,7.2,18926,176,53,1968,1173,17.6,1746.5,17,2,0,5,12,3,0,0,0,0,15497,6.8,17753,197,57,-1968,-1173,19.7,1549.7
4523946957,0,13,0,1,11,8,9,0,0,0,0,17802,7.0,17107,183,48,1124,1058,18.3,1780.2,15,2,0,8,11,10,1,1,0,0,16678,6.8,16049,190,46,-1124,-1058,19.0,1667.8
4505443029,1,40,1,1,2,4,2,1,1,0,0,14938,6.8,17538,246,42,-353,-370,24.6,1493.8,11,2,0,4,2,6,0,0,0,0,15291,7.0,17908,230,41,353,370,23.0,1529.1
4519580848,0,42,6,0,4,8,4,0,0,0,0,15194,6.8,17750,220,41,-2143,-1251,22.0,1519.4,19,2,1,8,4,6,1,0,1,0,17337,7.2,19001,205,48,2143,1251,20.5,1733.7
4489972241,1,20,3,1,7,6,12,1,1,0,1,17854,6.8,16635,195,44,-49,-1803,19.5,1785.4,17,3,0,6,7,6,1,0,1,1,17903,6.8,18438,238,56,49,1803,23.8,1790.3
4479461412,0,12,3,1,8,9,8,0,0,0,0,16957,6.6,17005,220,28,-206,-1872,22.0,1695.7,15,0,0,9,8,5,0,0,0,0,17163,7.2,18877,204,48,206,1872,20.4,1716.3
4520677506,0,16,4,0,5,12,3,0,0,0,0,15140,6.4,15745,198,39,-3371,-2094,19.8,1514.0,19,4,1,12,5,15,1,1,0,0,18511,7.0,17839,217,52,3371,2094,21.7,1851.1
4518474732,1,18,1,1,10,5,8,1,1,0,0,18297,7.2,19476,242,48,2709,1259,24.2,1829.7,13,0,0,5,10,7,0,0,0,0,15588,6.8,18217,214,60,-2709,-1259,21.4,1558.8
4463158250,0,16,2,0,8,9,10,1,1,0,0,16262,6.8,17436,186,59,-867,62,18.6,1626.2,12,4,1,9,8,11,0,0,0,0,17129,7.0,17374,212,44,867,-62,21.2,1712.9
4523305351,1,16,6,0,5,4,6,1,0,1,0,16033,6.8,17303,211,51,1073,103,21.1,1603.3,17,2,1,4,5,2,1,1,0,0,14960,6.8,17200,225,50,-1073,-103,22.5,1496.0
4436517463,1,13,0,1,5,4,6,0,0,0,0,15895,7.0,18344,239,38,42,367,23.9,1589.5,18,5,0,4,5,7,1,1,0,0,15853,6.8,17977,258,48,-42,-367,25.8,1585.3
4459832099,1,18,1,1,9,3,6,2,1,1,0,19155,7.6,20750,251,88,4526,2759,25.1,1915.5,14,4,0,3,9,3,0,0,0,0,14629,7.0,17991,192,48,-4526,-2759,19.2,1462.9
4516376461,0,9,1,0,0,9,0,0,0,0,0,12756,6.4,16250,190,54,-4949,-4010,19.0,1275.6,15,2,1,9,0,7,2,1,1,0,17705,7.4,20260,253,52,4949,4010,25.3,1770.5
4497655000,0,17,3,0,2,6,2,0,0,0,0,15141,7.2,18537,230,62,-2506,-1979,23.0,1514.1,41,4,1,6,2,9,1,1,0,0,17647,7.6,20516,250,70,2506,1979,25.0,1764.7
4470756095,0,15,1,1,2,9,1,0,0,0,0,14980,6.4,16246,232,51,-2432,-1788,23.2,1498.0,18,1,0,9,2,17,1,1,0,0,17412,7.0,18034,219,59,2432,1788,21.9,1741.2
4526057851,0,15,2,0,3,7,1,0,0,0,0,15311,6.8,18263,229,60,-1731,-1553,22.9,1531.1,82,1,1,7,3,4,1,1,0,0,17042,7.4,19816,238,63,1731,1553,23.8,1704.2
4434706257,1,13,1,1,14,2,16,0,0,0,0,19339,7.4,18982,197,39,5578,3447,19.7,1933.9,18,1,0,2,14,2,0,0,0,0,13761,6.2,15535,179,48,-5578,-3447,17.9,1376.1
4498211277,1,44,4,0,4,3,6,1,1,0,0,16031,7.0,18664,223,60,687,510,22.3,1603.1,16,8,1,3,4,1,0,0,0,0,15344,6.6,18154,254,44,-687,-510,25.4,1534.4
4461136941,1,14,6,1,4,5,5,0,0,0,0,15165,6.8,17251,218,49,-1286,-1695,21.8,1516.5,14,4,0,5,4,5,1,1,0,0,16451,7.2,18946,244,52,1286,1695,24.4,1645.1
4444221942,0,18,1,0,9,4,13,0,0,0,0,18856,7.2,19293,236,45,3002,2378,23.6,1885.6,13,1,1,4,9,6,2,1,1,0,15854,6.8,16915,217,56,-3002,-2378,21.7,1585.4
4521042540,1,14,2,1,8,7,7,1,1,0,0,18271,7.4,19689,223,55,938,181,22.3,1827.1,10,1,0,7,8,6,1,0,1,0,17333,7.2,19508,204,52,-938,-181,20.4,1733.3
4521764642,0,18,3,1,5,10,8,0,0,0,0,14839,6.8,16702,208,32,-2574,-1057,20.8,1483.9,20,4,0,10,5,17,1,1,0,0,17413,7.0,17759,227,29,2574,1057,22.7,1741.3
4499573481,1,19,1,0,8,8,14,0,0,0,0,16907,6.8,17497,185,44,-47,487,18.5,1690.7,16,0,1,8,8,8,0,0,0,0,16954,6.6,17010,219,32,47,-487,21.9,1695.4
4407656540,1,15,3,0,7,7,9,0,0,0,0,16712,7.0,18681,190,64,-424,308,19.0,1671.2,15,2,1,7,7,7,0,0,0,0,17136,7.2,18373,203,52,424,-308,20.3,1713.6
4465302034,0,18,5,0,7,13,6,0,0,0,0,16851,6.8,17624,215,52,-2174,-117,21.5,1685.1,17,3,1,13,7,17,0,0,0,0,19025,7.0,17741,211,52,2174,117,21.1,1902.5
4459570157,1,14,2,1,6,7,8,1,0,1,1,19056,7.4,19650,232,72,2638,2423,23.2,1905.6,16,1,0,7,6,12,0,0,0,0,16418,6.8,17227,204,37,-2638,-2423,20.4,1641.8
4513159115,0,13,1,0,5,4,4,0,0,0,0,15977,7.0,18445,205,48,898,732,20.5,1597.7,18,2,1,4,5,2,0,0,0,0,15079,7.0,17713,215,44,-898,-732,21.5,1507.9
4491480186,0,17,2,0,10,8,11,0,0,0,0,17982,7.2,18544,204,51,372,160,20.4,1798.2,15,2,1,8,10,8,1,1,0,0,17610,7.0,18384,223,50,-372,-160,22.3,1761.0
4447213073,1,15,5,1,9,6,15,1,1,0,0,17653,7.2,18042,218,40,1931,92,21.8,1765.3,16,3,0,6,9,6,0,0,0,0,15722,7.0,17950,205,44,-1931,-92,20.5,1572.2
4495813537,1,16,4,1,8,4,9,1,0,1,0,18001,7.2,19477,233,55,2111,1390,23.3,1800.1,16,6,0,4,8,5,1,1,0,0,15890,6.8,18087,228,71,-2111,-1390,22.8,1589.0
4527093291,0,10,2,0,4,9,2,0,0,0,0,14010,6.4,15841,170,45,-3956,-2930,17.0,1401.0,15,2,1,9,4,9,1,1,0,0,17966,7.0,18771,207,62,3956,2930,20.7,1796.6
4525242680,1,16,3,0,4,11,3,1,1,0,0,15786,6.6,17495,217,55,-4406,-2504,21.7,1578.6,20,5,1,11,4,15,0,0,0,1,20192,7.2,19999,233,68,4406,2504,23.3,2019.2
4517934723,0,38,3,0,8,12,6,0,0,0,0,16760,7.2,18264,217,36,-1302,73,21.7,1676.0,146,3,1,12,8,8,1,1,0,0,18062,7.0,18191,199,36,1302,-73,19.9,1806.2
4516699298,0,46,2,0,6,12,8,0,0,0,0,16038,6.4,16019,209,36,-3674,-3098,20.9,1603.8,12,1,1,12,6,16,2,1,1,0,19712,7.6,19117,205,68,3674,3098,20.5,1971.2
4470019953,1,16,4,1,6,5,7,1,0,1,0,16678,7.2,19110,248,53,1401,1740,24.8,1667.8,19,3,0,5,6,6,1,1,0,0,15277,6.8,17370,233,34,-1401,-1740,23.3,1527.7
4476300394,1,16,7,1,6,2,6,1,0,1,0,16399,7.4,18784,235,62,2036,2773,23.5,1639.9,177,2,0,2,6,2,1,1,0,0,14363,6.6,16011,221,48,-2036,-2773,22.1,1436.3
4519347430,1,13,3,0,4,5,4,0,0,0,0,15126,6.8,17342,207,38,-568,-345,20.7,1512.6,11,4,1,5,4,2,0,0,0,0,15694,6.8,17687,231,53,568,345,23.1,1569.4
4476255781,1,14,3,1,15,7,16,0,0,0,0,20036,7.2,19646,178,80,4060,3619,17.8,2003.6,17,3,0,7,15,8,0,0,0,0,15976,6.4,16027,192,44,-4060,-3619,19.2,1597.6
4465778231,1,25,3,0,11,8,11,0,0,0,0,17666,6.8,16963,193,48,-184,-835,19.3,1766.6,13,2,1,8,11,12,0,0,0,0,17850,7.0,17798,234,52,184,835,23.4,1785.0
4522653633,0,37,1,1,1,3,1,0,0,0,0,14859,6.8,17412,225,51,-520,-1073,22.5,1485.9,10,13,0,3,1,3,1,1,0,0,15379,7.0,18485,228,60,520,1073,22.8,1537.9
4497828505,0,79,0,0,6,10,4,0,0,0,0,17034,7.2,18358,210,60,-370,555,21.0,1703.4,14,4,1,10,6,11,1,1,0,0,17404,6.8,17803,201,47,370,-555,20.1,1740.4
4451606008,0,51,3,1,6,5,12,1,0,1,0,18187,7.2,19397,257,40,1909,1010,25.7,1818.7,15,4,0,5,6,4,1,1,0,0,16278,7.0,18387,248,52,-1909,-1010,24.8,1627.8
4527579335,1,39,6,1,6,7,4,1,1,0,0,16211,7.2,18576,207,47,-706,-306,20.7,1621.1,18,6,0,7,6,5,0,0,0,0,16917,7.0,18882,239,55,706,306,23.9,1691.7
4480073298,0,85,3,0,2,6,3,0,0,0,0,14735,7.0,17898,219,51,-2204,-1476,21.9,1473.5,22,4,1,6,2,5,1,0,1,0,16939,7.2,19374,243,52,2204,1476,24.3,1693.9
4522051549,0,16,3,1,8,11,8,0,0,0,0,17739,6.6,16482,215,55,377,-597,21.5,1773.9,22,4,0,11,8,12,2,1,1,0,17362,6.8,17079,197,44,-377,597,19.7,1736.2
4523545639,1,18,1,1,9,8,15,0,0,0,0,18809,7.0,18415,225,39,2309,1211,22.5,1880.9,15,1,0,8,9,8,1,1,0,0,16500,7.0,17204,185,55,-2309,-1211,18.5,1650.0
4475336164,1,15,3,1,6,8,6,0,0,0,0,16450,6.6,17381,224,40,-57,-1339,22.4,1645.0,15,3,0,8,6,5,0,0,0,0,16507,7.2,18720,220,44,57,1339,22.0,1650.7
4491896790,0,18,4,0,5,4,7,0,0,0,0,15881,6.8,17469,239,44,76,98,23.9,1588.1,15,5,1,4,5,6,1,1,0,0,15805,6.8,17371,249,52,-76,-98,24.9,1580.5
4500906460,0,14,1,0,1,3,0,0,0,0,0,14351,6.6,17173,218,60,-982,-1614,21.8,1435.1,19,0,1,3,1,2,1,1,0,0,15333,7.4,18787,219,48,982,1614,21.9,1533.3
4498278588,0,12,1,0,4,6,0,0,0,0,0,15922,7.2,19022,248,64,-1454,-616,24.8,1592.2,36,3,1,6,4,8,0,0,0,0,17376,7.2,19638,207,68,1454,616,20.7,1737.6
4473962566,1,17,2,0,9,7,10,1,1,0,0,17205,7.0,18124,218,40,721,2077,21.8,1720.5,16,1,1,7,9,11,0,0,0,0,16484,6.4,16047,212,39,-721,-2077,21.2,1648.4
4499940691,1,16,3,1,9,2,5,0,0,0,0,17139,7.2,19137,223,51,3037,2694,22.3,1713.9,14,2,0,2,9,2,1,1,0,0,14102,6.6,16443,213,41,-3037,-2694,21.3,1410.2
4520954808,0,11,3,1,8,8,6,0,0,0,0,16488,7.0,17386,208,41,-870,-1120,20.8,1648.8,15,0,0,8,8,7,1,1,0,0,17358,7.2,18506,241,48,870,1120,24.1,1735.8
4467685567,0,40,0,0,2,8,2,0,0,0,0,14200,6.6,17304,191,52,-3805,-2093,19.1,1420.0,15,2,1,8,2,9,1,1,0,0,18005,7.0,19397,230,60,3805,2093,23.0,1800.5
4527045294,0,16,4,0,6,11,8,0,0,0,0,16536,6.8,16917,232,41,-2018,-2401,23.2,1653.6,76,4,1,11,6,12,1,1,0,0,18554,7.0,19318,232,48,2018,2401,23.2,1855.4
4520035137,1,13,4,1,7,3,11,0,0,0,0,17802,7.4,19422,239,40,1070,1731,23.9,1780.2,14,2,0,3,7,3,1,0,1,1,16732,7.0,17691,211,64,-1070,-1731,21.1,1673.2
4508648628,0,30,1,0,3,9,2,1,0,1,0,14423,7.2,17518,188,59,-2911,-286,18.8,1442.3,12,1,1,9,3,12,0,0,0,0,17334,6.8,17804,201,38,2911,286,20.1,1733.4
4512338231,1,13,4,1,7,5,5,1,1,0,0,16790,7.6,19460,241,62,651,1744,24.1,1679.0,13,3,0,5,7,10,0,0,0,0,16139,6.8,17716,186,65,-651,-1744,18.6,1613.9
4514596756,0,25,4,0,8,4,8,1,0,1,0,18057,7.0,18682,231,52,3152,2104,23.1,1805.7,16,2,1,4,8,4,0,0,0,0,14905,6.4,16578,211,40,-3152,-2104,21.1,1490.5
4518395320,0,18,6,0,8,9,11,1,0,1,0,17147,6.8,17510,194,48,-1546,-1047,19.4,1714.7,18,6,1,9,8,12,1,1,0,0,18693,6.8,18557,244,55,1546,1047,24.4,1869.3
4501326958,1,22,1,0,11,5,8,1,1,0,0,18128,7.2,18825,205,41,1851,2008,20.5,1812.8,13,0,1,5,11,9,0,0,0,0,16277,6.8,16817,211,50,-1851,-2008,21.1,1627.7
4523105272,1,15,4,0,4,4,5,1,1,0,0,16180,7.0,18032,210,68,476,100,21.0,1618.0,14,3,1,4,4,2,1,0,1,0,15704,6.8,17932,232,56,-476,-100,23.2,1570.4
4526046259,0,65,2,0,5,6,6,1,1,0,0,16787,7.0,18246,248,47,-240,-694,24.8,1678.7,17,24,1,6,5,8,1,0,1,0,17027,7.2,18940,216,63,240,694,21.6,1702.7
4527767522,1,18,4,0,6,2,8,1,1,0,0,16055,7.0,18838,208,64,583,439,20.8,1605.5,38,5,1,2,6,1,0,0,0,0,15472,7.2,18399,259,54,-583,-439,25.9,1547.2
4470854778,0,20,5,0,6,3,5,1,0,1,1,18017,7.2,18923,228,68,2459,834,22.8,1801.7,18,2,1,3,6,3,1,1,0,0,15558,6.8,18089,220,51,-2459,-834,22.0,1555.8
4513824717,0,18,5,0,6,3,7,0,0,0,0,16485,7.0,18759,222,44,1097,711,22.2,1648.5,14,1,1,3,6,1,1,1,0,0,15388,7.0,18048,240,63,-1097,-711,24.0,1538.8
4502349733,0,18,3,0,1,2,1,0,0,0,0,13449,6.6,16803,189,48,-1641,-500,18.9,1344.9,14,2,1,2,1,4,0,0,0,0,15090,7.0,17303,224,52,1641,500,22.4,1509.0
4527408690,1,15,4,1,13,3,11,0,0,0,0,19536,7.6,20584,217,58,5452,4510,21.7,1953.6,17,2,0,3,13,3,0,0,0,0,14084,6.4,16074,178,44,-5452,-4510,17.8,1408.4
4487298777,0,13,7,0,2,9,3,0,0,0,0,13860,6.8,16225,195,39,-4138,-3792,19.5,1386.0,40,3,1,9,2,7,1,0,1,0,17998,7.4,20017,229,52,4138,3792,22.9,1799.8
4490705012,1,15,2,0,10,10,11,0,0,0,0,17528,6.8,17194,197,34,-541,546,19.7,1752.8,15,4,1,10,10,11,1,1,0,0,18069,6.6,16648,223,36,541,-546,22.3,1806.9
4456179027,0,55,0,0,4,3,2,0,0,0,0,15335,6.8,18648,230,40,-188,270,23.0,1533.5,11,3,1,3,4,2,1,1,0,0,15523,7.0,18378,248,60,188,-270,24.8,1552.3
4488501189,1,14,3,0,11,5,10,0,0,0,0,18582,7.0,18818,217,39,3039,2255,21.7,1858.2,14,4,1,5,11,8,0,0,0,0,15543,6.6,16563,203,28,-3039,-2255,20.3,1554.3
4520893771,1,15,16,1,3,2,4,2,1,1,0,15698,7.0,18088,253,56,-451,-1374,25.3,1569.8,43,5,0,2,3,1,0,0,0,0,16149,7.2,19462,255,75,451,1374,25.5,1614.9
4480690705,1,15,3,0,8,7,14,0,0,0,0,17989,7.0,18476,254,48,267,427,25.4,1798.9,20,3,1,7,8,11,0,0,0,0,17722,7.0,18049,219,60,-267,-427,21.9,1772.2
4511901984,0,19,3,0,3,4,5,0,0,0,0,17200,7.0,18695,237,57,1266,612,23.7,1720.0,14,1,1,4,3,3,1,1,0,0,15934,7.0,18083,239,55,-1266,-612,23.9,1593.4
4463150629,1,20,5,1,10,7,16,1,1,0,0,18247,7.0,18886,225,36,1348,1158,22.5,1824.7,38,5,0,7,10,10,1,0,1,0,16899,6.6,17728,224,68,-1348,-1158,22.4,1689.9
4522855501,1,20,6,1,13,4,7,1,1,0,1,20587,7.4,19713,229,48,5920,2703,22.9,2058.7,16,3,0,4,13,3,0,0,0,0,14667,6.8,17010,168,58,-5920,-2703,16.8,1466.7
4459264476,0,17,2,0,1,11,2,0,0,0,0,13196,6.4,15515,194,49,-5525,-5585,19.4,1319.6,13,3,1,11,1,8,0,0,0,0,18721,7.8,21100,252,55,5525,5585,25.2,1872.1
4525014650,0,17,3,0,3,4,4,0,0,0,0,15179,6.8,17410,237,53,-657,-81,23.7,1517.9,65,1,1,4,3,4,2,1,1,0,15836,7.0,17491,237,52,657,81,23.7,1583.6
4521085561,0,41,0,0,2,9,3,0,0,0,0,14525,7.0,18541,214,72,-3207,-1327,21.4,1452.5,27,17,1,9,2,9,1,1,0,0,17732,7.2,19868,241,52,3207,1327,24.1,1773.2
4441400812,1,14,5,0,4,4,3,1,0,1,1,16790,6.8,18508,242,45,1814,619,24.2,1679.0,20,3,1,4,4,5,1,1,0,0,14976,6.8,17889,185,47,-1814,-619,18.5,1497.6
4505809782,1,37,0,0,10,5,15,1,1,0,0,18786,7.2,18509,235,60,2480,1699,23.5,1878.6,15,1,1,5,10,8,1,0,1,0,16306,6.8,16810,221,40,-2480,-1699,22.1,1630.6
4504128321,1,15,3,1,10,6,9,0,0,0,0,18288,7.2,19569,245,41,2569,1891,24.5,1828.8,127,4,0,6,10,4,1,0,1,0,15719,6.8,17678,220,41,-2569,-1891,22.0,1571.9
4421752887,0,17,3,1,4,5,7,0,0,0,0,15574,6.8,17216,236,47,14,-309,23.6,1557.4,35,3,0,5,4,6,2,1,1,0,15560,6.8,17525,224,44,-14,309,22.4,1556.0
4524327775,1,23,2,1,6,3,8,0,0,0,0,16050,7.0,17867,195,44,2041,1289,19.5,1605.0,37,2,0,3,6,1,0,0,0,0,14009,6.4,16578,202,44,-2041,-1289,20.2,1400.9
4472131666,1,17,4,1,5,3,3,0,0,0,0,16400,7.4,18900,255,62,2247,1439,25.5,1640.0,41,4,0,3,5,1,1,1,0,0,14153,7.0,17461,202,54,-2247,-1439,20.2,1415.3
4494953738,1,19,8,0,2,4,2,0,0,0,0,14843,7.0,18146,236,43,-620,-147,23.6,1484.3,22,3,1,4,2,5,0,0,0,0,15463,7.0,18293,236,50,620,147,23.6,1546.3
4520593786,1,37,3,0,1,5,1,1,0,1,0,15007,6.8,17592,251,55,-1933,15,25.1,1500.7,16,3,1,5,1,10,1,1,0,1,16940,7.0,17577,215,44,1933,-15,21.5,1694.0
4520364684,0,22,7,0,7,16,11,0,0,0,0,16461,6.4,15402,177,52,-5941,-4097,17.7,1646.1,17,2,1,16,7,18,2,1,1,2,22402,7.2,19499,241,48,5941,4097,24.1,2240.2
4525068217,0,16,25,0,5,7,5,0,0,0,0,16763,7.2,19010,252,48,-729,-620,25.2,1676.3,43,5,1,7,5,6,2,1,1,0,17492,7.2,19630,241,61,729,620,24.1,1749.2
4527715781,0,12,2,0,4,5,5,2,1,1,0,15131,6.8,18216,214,61,-727,343,21.4,1513.1,17,4,1,5,4,2,0,0,0,0,15858,6.8,17873,248,48,727,-343,24.8,1585.8
4473512482,0,44,3,0,5,14,7,0,0,0,0,15755,6.4,16436,203,39,-4136,-3444,20.3,1575.5,11,6,1,14,5,12,1,1,0,0,19891,7.4,19880,222,52,4136,3444,22.2,1989.1
4459430310,0,14,4,0,0,5,0,1,0,1,0,13776,6.8,16664,218,60,-2765,-2677,21.8,1377.6,19,3,1,5,0,6,1,1,0,0,16541,7.2,19341,256,53,2765,2677,25.6,1654.1
4510144910,1,16,6,0,5,6,5,0,0,0,0,16571,7.2,19112,212,66,-528,1756,21.2,1657.1,19,3,1,6,5,7,2,1,1,0,17099,6.6,17356,210,49,528,-1756,21.0,1709.9
4495269641,0,16,1,0,5,8,4,1,0,1,0,15383,6.8,17243,227,28,-1524,-827,22.7,1538.3,11,3,1,8,5,11,0,0,0,0,16907,7.0,18070,186,39,1524,827,18.6,1690.7
4526048930,0,18,3,0,4,10,7,0,0,0,0,14595,6.4,15889,181,44,-4266,-4094,18.1,1459.5,13,6,1,10,4,7,1,1,0,0,18861,7.6,19983,245,52,4266,4094,24.5,1886.1
4522599017,0,13,4,1,6,5,7,0,0,0,0,16053,6.8,18228,216,48,611,381,21.6,1605.3,20,1,0,5,6,5,1,1,0,0,15442,6.8,17847,208,46,-611,-381,20.8,1544.2
4486954946,1,18,5,1,10,6,11,1,1,0,0,18895,7.2,18495,245,44,3409,1964,24.5,1889.5,18,4,0,6,10,8,0,0,0,0,15486,6.8,16531,180,40,-3409,-1964,18.0,1548.6
4512954515,0,22,5,0,7,6,14,1,1,0,0,16644,6.8,17295,238,48,60,-325,23.8,1664.4,21,6,1,6,7,11,0,0,0,0,16584,6.8,17620,229,44,-60,325,22.9,1658.4
4507083643,1,15,1,1,11,8,15,2,1,1,0,17640,6.6,17082,164,45,1252,-271,16.4,1764.0,14,3,0,8,11,11,0,0,0,0,16388,6.8,17353,176,52,-1252,271,17.6,1638.8
4513365614,0,16,1,0,5,5,8,0,0,0,0,15851,6.8,17366,206,56,-808,-1655,20.6,1585.1,38,6,1,5,5,6,0,0,0,0,16659,7.2,19021,241,44,808,1655,24.1,1665.9
4523452574,1,16,7,1,6,5,5,1,0,1,0,16953,7.2,18804,238,64,1491,533,23.8,1695.3,21,4,0,5,6,4,1,1,0,0,15462,7.0,18271,213,55,-1491,-533,21.3,1546.2
4457601167,1,89,2,1,8,5,7,0,0,0,0,16463,6.8,16852,207,37,-185,-1442,20.7,1646.3,14,2,0,5,8,3,2,1,1,0,16648,7.0,18294,228,55,185,1442,22.8,1664.8
4507620786,1,15,1,0,8,7,10,1,1,0,0,17765,7.2,19108,242,52,2312,2522,24.2,1776.5,14,3,1,7,8,5,0,0,0,0,15453,6.6,16586,170,40,-2312,-2522,17.0,1545.3
4522856174,1,16,6,1,8,1,12,0,0,0,0,17734,7.4,19335,207,52,3135,2622,20.7,1773.4,16,5,0,1,8,2,0,0,0,0,14599,6.6,16713,228,60,-3135,-2622,22.8,1459.9
4510968439,1,13,0,1,3,3,3,1,1,0,0,15271,7.0,18226,236,55,-455,-767,23.6,1527.1,11,2,0,3,3,3,0,0,0,0,15726,7.2,18993,258,59,455,767,25.8,1572.6
4526163863,0,31,3,0,2,7,2,0,0,0,0,15739,7.0,18212,256,53,-1257,-91,25.6,1573.9,16,1,1,7,2,10,1,1,0,0,16996,6.8,18303,234,48,1257,91,23.4,1699.6
4489726898,1,15,1,1,3,0,3,1,1,0,0,15429,6.8,18375,218,64,1453,1251,21.8,1542.9,12,1,0,0,3,0,0,0,0,0,13976,6.6,17124,231,64,-1453,-1251,23.1,1397.6
4517772897,0,12,3,1,3,9,3,0,0,0,0,14220,6.4,16333,203,41,-3673,-2973,20.3,1422.0,18,2,0,9,3,9,1,1,0,0,17893,7.4,19306,234,58,3673,2973,23.4,1789.3
4454750369,0,35,3,0,7,10,9,1,1,0,1,18244,7.0,18223,205,60,-173,-989,20.5,1824.4,14,0,1,10,7,9,0,0,0,0,18417,7.0,19212,210,52,173,989,21.0,1841.7
4492487479,0,13,3,0,7,5,7,0,0,0,0,16514,7.2,18198,211,52,1232,1358,21.1,1651.4,14,2,1,5,7,3,1,1,0,0,15282,6.6,16840,215,48,-1232,-1358,21.5,1528.2
4525023714,0,59,1,1,4,7,5,1,1,0,0,15424,6.8,17357,211,44,-1933,-2906,21.1,1542.4,12,3,0,7,4,3,0,0,0,0,17357,7.6,20263,256,55,1933,2906,25.6,1735.7
4524820601,1,11,1,1,9,11,11,0,0,0,0,17322,6.4,16229,182,52,-956,-1451,18.2,1732.2,14,1,0,11,9,12,1,1,0,0,18278,6.8,17680,207,49,956,1451,20.7,1827.8
4497964264,1,18,2,1,6,8,3,1,1,0,0,15809,7.2,18321,239,53,-1065,502,23.9,1580.9,15,5,0,8,6,8,1,0,1,0,16874,7.0,17819,235,44,1065,-502,23.5,1687.4
4510743297,0,39,6,1,9,6,7,0,0,0,0,18466,7.6,19801,218,68,2220,2300,21.8,1846.6,11,2,0,6,9,7,1,1,0,0,16246,7.0,17501,185,52,-2220,-2300,18.5,1624.6
4470994961,0,27,5,0,8,13,8,0,0,0,0,17238,7.0,17907,204,49,-2693,-709,20.4,1723.8,15,4,1,13,8,9,0,0,0,0,19931,7.2,18616,228,49,2693,709,22.8,1993.1
4436047173,0,17,1,1,9,6,11,0,0,0,0,17416,7.2,18429,208,44,-367,-1771,20.8,1741.6,13,4,0,6,9,6,1,1,0,0,17783,7.4,20200,243,68,367,1771,24.3,1778.3
4450382199,0,18,2,1,7,8,7,0,0,0,1,18000,6.8,17798,210,48,1157,-173,21.0,1800.0,56,5,0,8,7,10,0,0,0,0,16843,7.0,17971,190,53,-1157,173,19.0,1684.3
4467275928,1,17,3,1,6,4,8,1,1,0,0,15142,6.2,14696,178,46,-566,-3406,17.8,1514.2,20,0,0,4,6,2,0,0,0,0,15708,7.0,18102,246,48,566,3406,24.6,1570.8
4526464882,0,40,2,0,5,8,6,0,0,0,0,16530,7.4,19242,231,51,-1347,-1433,23.1,1653.0,13,15,1,8,5,6,1,1,0,0,17877,7.6,20675,231,79,1347,1433,23.1,1787.7
4467282089,1,15,3,1,8,4,6,1,0,1,0,17522,7.2,18612,257,42,2392,511,25.7,1752.2,19,5,0,4,8,1,0,0,0,0,15130,7.0,18101,222,69,-2392,-511,22.2,1513.0
4521772648,0,13,2,1,6,4,7,0,0,0,0,16517,7.0,18263,216,57,954,570,21.6,1651.7,16,3,0,4,6,5,1,1,0,0,15563,6.6,17693,216,44,-954,-570,21.6,1556.3
4517932062,0,14,5,1,7,10,11,1,0,1,0,17759,7.2,18043,246,36,-695,-2159,24.6,1775.9,15,1,0,10,7,6,0,0,0,0,18454,7.4,20202,214,64,695,2159,21.4,1845.4
4520635359,1,16,1,1,7,17,8,1,0,1,0,16239,6.4,16109,202,52,-4876,-3481,20.2,1623.9,17,3,0,17,7,19,1,1,0,0,21115,7.2,19590,230,56,4876,3481,23.0,2111.5
4512183773,1,15,3,1,2,5,1,1,0,1,0,14534,7.0,17364,224,60,-2269,-1616,22.4,1453.4,16,3,0,5,2,7,1,1,0,0,16803,7.0,18980,250,64,2269,1616,25.0,1680.3
4506509939,1,15,5,1,7,5,5,1,1,0,0,17301,7.4,19661,251,51,1000,885,25.1,1730.1,19,2,0,5,7,9,0,0,0,0,16301,7.2,18776,220,59,-1000,-885,22.0,1630.1
4505307600,1,19,6,1,5,9,5,0,0,0,0,14630,6.6,16527,177,28,-2167,-2045,17.7,1463.0,18,4,0,9,5,10,1,1,0,0,16797,7.0,18572,214,41,2167,2045,21.4,1679.7
4524327069,1,16,2,0,6,4,11,0,0,0,0,17438,7.2,18793,249,71,2152,1936,24.9,1743.8,18,3,1,4,6,7,2,1,1,0,15286,6.8,16857,227,41,-2152,-1936,22.7,1528.6
4458567616,0,20,1,0,6,12,2,0,0,0,0,16425,6.8,17934,205,60,-4561,-1835,20.5,1642.5,11,1,1,12,6,16,1,1,0,0,20986,7.6,19769,271,60,4561,1835,27.1,2098.6
4485800348,0,14,0,1,6,6,6,0,0,0,0,15715,6.6,16563,188,44,-826,-979,18.8,1571.5,12,1,0,6,6,7,1,0,1,0,16541,7.0,17542,237,36,826,979,23.7,1654.1
4489696117,0,13,2,1,9,6,9,1,1,0,0,16738,6.8,16893,198,44,91,-1992,19.8,1673.8,14,1,0,6,9,5,0,0,0,0,16647,7.2,18885,224,55,-91,1992,22.4,1664.7
4525968792,0,12,3,0,11,9,13,1,1,0,0,17378,6.8,17926,167,46,202,1030,16.7,1737.8,14,0,1,9,11,9,1,0,1,0,17176,7.0,16896,203,42,-202,-1030,20.3,1717.6
4525013818,1,14,1,0,8,8,7,0,0,0,0,16072,6.6,16342,214,42,-1247,-835,21.4,1607.2,21,2,1,8,8,12,1,1,0,0,17319,6.6,17177,229,41,1247,835,22.9,1731.9
4524141985,0,18,2,0,2,3,3,0,0,0,0,14510,6.8,17801,247,36,-1456,-251,24.7,1451.0,79,3,1,3,2,5,2,1,1,0,15966,7.0,18052,252,56,1456,251,25.2,1596.6
4479804307,1,16,2,1,10,6,12,1,1,0,0,18439,7.2,18689,223,39,1894,99,22.3,1843.9,12,4,0,6,10,5,0,0,0,0,16545,7.0,18590,203,48,-1894,-99,20.3,1654.5
4450463200,1,12,1,1,6,7,4,1,1,0,1,17149,6.8,17815,196,54,770,-46,19.6,1714.9,10,1,0,7,6,7,0,0,0,0,16379,7.0,17861,202,34,-770,46,20.2,1637.9
4408530058,0,19,2,0,6,10,7,0,0,0,0,15258,6.8,17586,179,50,-3222,-1976,17.9,1525.8,15,4,1,10,6,11,1,1,0,0,18480,7.2,19562,240,56,3222,1976,24.0,1848.0
4491850412,1,19,4,0,4,2,7,0,0,0,0,15796,6.8,17499,234,46,640,-120,23.4,1579.6,16,6,1,2,4,4,0,0,0,0,15156,7.0,17619,236,49,-640,120,23.6,1515.6
4522461341,0,15,13,0,3,9,1,1,1,0,0,14711,6.8,18284,204,52,-3559,-1400,20.4,1471.1,42,3,1,9,3,7,0,0,0,0,18270,7.2,19684,256,43,3559,1400,25.6,1827.0
4524766949,1,14,4,0,9,8,8,0,0,0,0,17087,6.8,17623,190,33,442,-145,19.0,1708.7,14,1,1,8,9,7,1,0,1,0,16645,6.8,17768,186,51,-442,145,18.6,1664.5
4516543999,1,15,2,0,4,5,2,0,0,0,0,15523,7.0,17886,228,53,-2472,174,22.8,1552.3,18,3,1,5,4,5,1,1,0,1,17995,7.0,17712,243,49,2472,-174,24.3,1799.5
4525596664,1,15,3,1,4,4,7,0,0,0,0,14781,6.6,16316,209,32,165,267,20.9,1478.1,14,2,0,4,4,8,1,1,0,0,14616,6.4,16049,185,48,-165,-267,18.5,1461.6
4450648028,0,11,2,0,6,6,10,1,1,0,0,17173,7.2,18789,232,54,386,-200,23.2,1717.3,18,2,1,6,6,8,0,0,0,0,16787,7.2,18989,202,55,-386,200,20.2,1678.7
4486088051,0,14,3,0,7,8,9,0,0,0,0,16122,6.8,17858,196,39,-1673,-327,19.6,1612.2,16,1,1,8,7,8,0,0,0,0,17795,7.0,18185,231,52,1673,327,23.1,1779.5
4457802737,1,20,1,1,6,1,9,0,0,0,0,17687,7.0,18128,232,60,4039,1819,23.2,1768.7,16,2,0,1,6,1,0,0,0,0,13648,6.6,16309,217,52,-4039,-1819,21.7,1364.8
4527239272,1,15,0,1,11,5,11,2,1,1,0,17058,7.2,18736,178,49,2107,2032,17.8,1705.8,26,1,0,5,11,1,0,0,0,0,14951,6.6,16704,211,48,-2107,-2032,21.1,1495.1
4477234655,0,17,4,1,2,7,3,0,0,0,0,14269,6.6,16548,196,58,-2153,-1519,19.6,1426.9,16,4,0,7,2,8,0,0,0,0,16422,7.0,18067,211,39,2153,1519,21.1,1642.2
4527285889,0,12,3,0,2,8,3,0,0,0,0,13337,6.0,14550,158,44,-5735,-5547,15.8,1333.7,94,2,1,8,2,6,2,1,1,1,19072,7.6,20097,232,68,5735,5547,23.2,1907.2
4496506174,0,12,3,0,4,5,4,1,1,0,0,15297,6.6,17644,201,48,-502,-413,20.1,1529.7,20,3,1,5,4,7,0,0,0,0,15799,7.0,18057,209,52,502,413,20.9,1579.9
4519807061,1,18,3,0,12,4,16,1,1,0,0,19726,7.4,19180,246,48,5020,3785,24.6,1972.6,13,2,1,4,12,6,0,0,0,0,14706,6.4,15395,192,48,-5020,-3785,19.2,1470.6
4524458385,1,16,7,1,5,5,5,0,0,0,0,15722,6.8,16349,222,34,679,471,22.2,1572.2,16,3,0,5,5,5,0,0,0,0,15043,6.4,15878,181,48,-679,-471,18.1,1504.3
4519568140,0,16,0,0,4,8,5,0,0,0,0,14763,6.6,16159,205,44,-3584,-2457,20.5,1476.3,11,5,1,8,4,13,1,1,0,0,18347,7.0,18616,254,54,3584,2457,25.4,1834.7
4520734931,0,42,4,0,3,5,4,0,0,0,0,15314,7.0,18205,233,52,-1659,-1566,23.3,1531.4,18,5,1,5,3,5,0,0,0,0,16973,7.4,19771,253,60,1659,1566,25.3,1697.3
4493142787,0,14,4,1,5,8,5,0,0,0,0,15542,6.6,16959,188,59,-2118,-2048,18.8,1554.2,70,3,0,8,5,8,1,1,0,0,17660,7.2,19007,238,44,2118,2048,23.8,1766.0
4524264644,1,19,4,1,7,3,13,1,1,0,0,16632,6.8,16709,212,32,1722,1010,21.2,1663.2,20,5,0,3,7,4,0,0,0,0,14910,6.2,15699,224,44,-1722,-1010,22.4,1491.0
4491431889,0,15,3,1,8,9,8,0,0,0,0,17802,7.2,18241,226,55,-201,-14,22.6,1780.2,18,4,0,9,8,11,1,1,0,0,18003,6.8,18255,203,52,201,14,20.3,1800.3
4526560120,0,14,2,1,4,6,2,0,0,0,0,13829,6.4,16293,171,48,-2523,-2080,17.1,1382.9,15,1,0,6,4,6,1,1,0,0,16352,6.8,18373,222,52,2523,2080,22.2,1635.2
4524361228,0,15,3,0,1,7,2,0,0,0,0,13519,6.4,15833,188,53,-4115,-2985,18.8,1351.9,18,2,1,7,1,9,1,1,0,0,17634,7.0,18818,251,47,4115,2985,25.1,1763.4
4520027447,1,14,3,1,8,5,5,1,1,0,0,16523,7.2,18718,193,56,1357,614,19.3,1652.3,17,2,0,5,8,2,0,0,0,0,15166,6.8,18104,208,52,-1357,-614,20.8,1516.6
4524668362,0,15,1,1,10,6,17,0,0,0,0,17634,6.6,16665,193,35,2031,1004,19.3,1763.4,18,1,0,6,10,6,0,0,0,0,15603,6.4,15661,196,38,-2031,-1004,19.6,1560.3
4524125396,0,14,0,0,3,11,3,0,0,0,0,13998,6.4,16659,171,59,-4911,-2529,17.1,1399.8,43,2,1,11,3,13,1,1,0,0,18909,7.4,19188,236,53,4911,2529,23.6,1890.9
4427502264,1,17,1,0,9,3,9,1,1,0,1,18695,7.2,19263,245,56,4298,2299,24.5,1869.5,13,2,1,3,9,2,1,0,1,0,14397,6.8,16964,190,56,-4298,-2299,19.0,1439.7
4484713894,0,16,1,0,11,5,10,0,0,0,0,18874,7.2,19652,224,41,3091,2498,22.4,1887.4,21,1,1,5,11,7,0,0,0,0,15783,6.6,17154,215,37,-3091,-2498,21.5,1578.3
4525380642,0,17,1,0,15,7,13,1,0,1,0,20066,7.2,19018,209,40,4646,3861,20.9,2006.6,18,2,1,7,15,7,0,0,0,0,15420,6.0,15157,193,33,-4646,-3861,19.3,1542.0
4521897707,1,17,4,1,6,2,9,0,0,0,0,16415,7.2,18271,230,43,1374,1225,23.0,1641.5,17,4,0,2,6,2,1,1,0,0,15041,6.8,17046,217,51,-1374,-1225,21.7,1504.1
4506003362,1,40,4,1,8,1,8,1,0,1,0,18691,7.2,20672,228,76,5359,4990,22.8,1869.1,18,2,0,1,8,2,1,1,0,0,13332,6.4,15682,208,36,-5359,-4990,20.8,1333.2
4515924024,1,37,1,0,11,9,11,0,0,0,0,17971,7.2,18271,162,71,152,-486,16.2,1797.1,16,0,1,9,11,9,0,0,0,0,17819,7.2,18757,192,48,-152,486,19.2,1781.9
4526486021,0,14,5,0,8,9,11,0,0,0,0,17149,7.0,18495,218,39,-1258,-725,21.8,1714.9,36,1,1,9,8,8,1,1,0,0,18407,7.4,19220,214,68,1258,725,21.4,1840.7
4507962788,1,19,2,1,3,6,2,2,1,1,0,15032,6.8,18187,207,65,-1920,-363,20.7,1503.2,15,3,0,6,3,8,0,0,0,0,16952,7.0,18550,246,53,1920,363,24.6,1695.2
4480147413,0,20,1,0,11,13,12,1,0,1,0,18315,6.6,17665,232,40,-337,-1295,23.2,1831.5,14,5,1,13,11,14,1,1,0,0,18652,7.2,18960,197,56,337,1295,19.7,1865.2
4478654416,1,16,1,1,12,9,17,0,0,0,0,18722,7.2,18687,212,69,941,2107,21.2,1872.2,19,2,0,9,12,7,1,1,0,0,17781,6.6,16580,225,34,-941,-2107,22.5,1778.1
4515708683,1,46,1,0,4,10,4,1,1,0,0,15593,6.8,16199,204,4,-3101,-2897,20.4,1559.3,13,1,1,10,4,8,0,0,0,0,18694,7.0,19096,223,48,3101,2897,22.3,1869.4
4517827670,0,19,1,1,4,8,5,0,0,0,0,14232,6.6,15999,197,41,-3089,-3265,19.7,1423.2,16,5,0,8,4,7,1,1,0,0,17321,7.2,19264,251,46,3089,3265,25.1,1732.1
4526110016,0,14,2,0,3,7,2,0,0,0,0,14415,6.8,17890,213,61,-3505,-1473,21.3,1441.5,18,3,1,7,3,9,1,1,0,0,17920,7.2,19363,226,70,3505,1473,22.6,1792.0
4497646663,0,80,4,0,2,9,1,0,0,0,0,13867,6.2,15515,206,31,-3975,-4232,20.6,1386.7,17,3,1,9,2,9,0,0,0,0,17842,7.0,19747,237,44,3975,4232,23.7,1784.2
4520326449,1,18,5,1,8,7,10,0,0,0,0,17409,6.8,18491,259,40,2006,617,25.9,1740.9,39,4,0,7,8,4,1,1,0,0,15403,7.0,17874,183,52,-2006,-617,18.3,1540.3
4522843315,1,18,0,1,9,8,7,0,0,0,0,16908,6.8,17271,196,31,-363,-191,19.6,1690.8,40,2,0,8,9,9,1,1,0,0,17271,6.8,17462,187,68,363,191,18.7,1727.1
4520969352,0,15,0,1,12,7,17,2,1,1,0,18292,7.0,18884,216,48,789,1319,21.6,1829.2,12,2,0,7,12,6,0,0,0,0,17503,6.8,17565,220,56,-789,-1319,22.0,1750.3
4494451554,1,19,2,0,7,5,9,1,1,0,0,16847,7.0,17670,209,43,505,-1017,20.9,1684.7,14,4,1,5,7,5,0,0,0,0,16342,7.2,18687,212,68,-505,1017,21.2,1634.2
4457806317,0,15,1,1,14,6,14,1,1,0,0,20136,7.4,19337,225,43,4322,3830,22.5,2013.6,16,1,0,6,14,8,0,0,0,0,15814,6.4,15507,186,33,-4322,-3830,18.6,1581.4
4524469439,1,16,2,1,8,10,7,1,1,0,0,16576,7.0,17437,226,34,-1147,-1294,22.6,1657.6,16,6,0,10,8,11,0,0,0,0,17723,7.2,18731,210,35,1147,1294,21.0,1772.3
4456611080,1,14,4,0,4,5,6,1,1,0,0,16353,6.8,18091,240,68,246,217,24.0,1635.3,16,4,1,5,4,7,0,0,0,0,16107,6.8,17874,227,43,-246,-217,22.7,1610.7
4502297992,0,16,15,1,6,7,6,2,1,1,0,16940,6.8,17580,222,39,90,-819,22.2,1694.0,40,2,0,7,6,5,0,0,0,0,16850,7.0,18399,219,48,-90,819,21.9,1685.0
4484045621,1,40,1,1,10,7,16,2,1,1,0,18989,7.2,19584,201,67,2545,1695,20.1,1898.9,40,3,0,7,10,11,0,0,0,0,16444,7.0,17889,212,38,-2545,-1695,21.2,1644.4
4468732592,1,16,5,1,7,4,10,0,0,0,0,18342,7.4,20325,224,75,2587,2759,22.4,1834.2,164,2,0,4,7,3,1,1,0,0,15755,6.6,17566,213,54,-2587,-2759,21.3,1575.5
4522325538,1,15,3,1,9,1,8,0,0,0,0,17786,7.0,19149,233,52,3404,2513,23.3,1778.6,16,2,0,1,9,1,0,0,0,0,14382,6.6,16636,206,51,-3404,-2513,20.6,1438.2
4510983130,0,13,0,0,1,11,1,0,0,0,0,12926,6.2,14637,164,55,-7952,-5684,16.4,1292.6,14,3,1,11,1,12,2,1,1,1,20878,7.4,20321,254,44,7952,5684,25.4,2087.8
4525594004,0,22,3,1,12,10,16,1,0,1,0,19784,7.0,18582,241,41,1680,473,24.1,1978.4,19,5,0,10,12,16,0,0,0,0,18104,7.0,18109,197,35,-1680,-473,19.7,1810.4
4417883002,0,34,1,0,4,6,6,0,0,0,0,15829,6.8,17626,185,68,-869,-814,18.5,1582.9,17,1,1,6,4,2,1,1,0,0,16698,6.8,18440,231,56,869,814,23.1,1669.8
4522587007,1,17,2,0,4,7,5,0,0,0,0,16171,7.0,18471,240,57,-758,920,24.0,1617.1,12,1,1,7,4,8,0,0,0,0,16929,6.8,17551,208,57,758,-920,20.8,1692.9
4521417680,0,20,4,0,11,7,8,0,0,0,0,17625,7.0,18727,212,43,817,2322,21.2,1762.5,18,5,1,7,11,7,1,0,1,0,16808,6.6,16405,209,49,-817,-2322,20.9,1680.8
4456434155,1,21,1,1,11,7,15,0,0,0,0,17446,7.0,18714,186,49,900,1093,18.6,1744.6,14,1,0,7,11,8,1,1,0,0,16546,6.8,17621,220,58,-900,-1093,22.0,1654.6
4477076121,0,14,2,0,4,8,3,0,0,0,0,16138,7.0,17604,217,51,-1531,-2275,21.7,1613.8,20,3,1,8,4,7,0,0,0,0,17669,7.4,19879,228,44,1531,2275,22.8,1766.9
4523110333,1,18,4,1,6,7,10,2,1,1,0,17259,7.0,19074,236,67,-214,1004,23.6,1725.9,84,3,0,7,6,8,0,0,0,0,17473,7.0,18070,225,46,214,-1004,22.5,1747.3
4447747806,1,15,0,1,9,5,8,0,0,0,0,18192,6.8,18534,229,44,3518,2843,22.9,1819.2,12,0,0,5,9,7,1,1,0,0,14674,6.4,15691,188,32,-3518,-2843,18.8,1467.4
4525200443,1,17,2,1,6,7,5,1,1,0,0,16230,6.8,17203,190,59,-726,-1249,19.0,1623.0,16,1,0,7,6,12,0,0,0,0,16956,7.2,18452,230,53,726,1249,23.0,1695.6
4521433925,1,18,2,0,5,5,5,0,0,0,0,15191,6.6,16443,193,49,-1344,-2597,19.3,1519.1,14,1,1,5,5,4,1,1,0,0,16535,7.0,19040,207,76,1344,2597,20.7,1653.5
4505100164,1,16,1,1,11,5,12,1,1,0,0,18890,7.2,19229,223,40,2708,682,22.3,1889.0,16,4,0,5,11,4,0,0,0,0,16182,7.2,18547,230,47,-2708,-682,23.0,1618.2
4510120989,1,18,5,1,8,6,11,1,1,0,0,17287,7.0,18312,224,45,886,684,22.4,1728.7,45,3,0,6,8,8,0,0,0,0,16401,6.8,17628,228,32,-886,-684,22.8,1640.1
4509809215,1,14,1,1,7,6,11,0,0,0,0,18027,7.0,17905,217,59,2394,873,21.7,1802.7,142,3,0,6,7,5,1,1,0,0,15633,6.8,17032,219,53,-2394,-873,21.9,1563.3
4527522353,1,17,7,0,10,7,9,1,1,0,0,17712,7.0,19043,207,42,2370,3795,20.7,1771.2,18,3,1,7,10,6,0,0,0,0,15342,6.4,15248,186,38,-2370,-3795,18.6,1534.2
4444095470,0,15,5,0,3,8,2,0,0,0,0,15453,7.2,18464,209,63,-664,615,20.9,1545.3,18,3,1,8,3,8,1,1,0,0,16117,7.0,17849,180,48,664,-615,18.0,1611.7
4500263204,0,17,2,0,7,8,5,1,0,1,0,17241,7.0,18072,242,48,-136,-583,24.2,1724.1,15,5,1,8,7,7,1,1,0,0,17377,7.4,18655,234,48,136,583,23.4,1737.7
4415361150,0,12,1,1,9,10,3,0,0,0,0,15974,6.6,16903,175,36,-1008,-1516,17.5,1597.4,15,3,0,10,9,9,1,1,0,0,16982,7.0,18419,184,56,1008,1516,18.4,1698.2
4525303042,0,17,0,1,8,9,8,0,0,0,0,16640,6.6,16726,222,43,-1939,-2911,22.2,1664.0,14,1,0,9,8,15,2,1,1,0,18579,7.4,19637,233,56,1939,2911,23.3,1857.9
4510127229,1,16,4,1,10,5,14,0,0,0,0,18538,7.2,19030,247,44,1806,632,24.7,1853.8,16,2,0,5,10,5,1,1,0,0,16732,7.0,18398,216,64,-1806,-632,21.6,1673.2
4515310852,1,13,6,0,4,1,4,0,0,0,0,15809,7.0,19160,245,51,1219,1641,24.5,1580.9,16,3,1,1,4,0,1,1,0,0,14590,7.0,17519,244,62,-1219,-1641,24.4,1459.0
4516544412,1,16,4,0,10,4,9,1,0,1,2,20236,7.0,18603,257,36,6161,5326,25.7,2023.6,12,1,1,4,10,6,1,1,0,0,14075,5.8,13277,146,40,-6161,-5326,14.6,1407.5
4520805255,1,16,1,0,1,3,2,0,0,0,0,14889,6.8,17345,256,48,-819,-1709,25.6,1488.9,23,1,1,3,1,4,0,0,0,0,15708,7.0,19054,246,62,819,1709,24.6,1570.8
4519982625,0,16,1,1,4,6,2,0,0,0,0,15416,7.2,18403,214,51,-2219,-677,21.4,1541.6,15,3,0,6,4,7,2,1,1,0,17635,7.2,19080,237,56,2219,677,23.7,1763.5
4519429379,1,37,3,1,6,4,5,0,0,0,0,17180,7.0,19599,258,64,1748,1496,25.8,1718.0,11,2,0,4,6,1,1,1,0,0,15432,7.0,18103,236,50,-1748,-1496,23.6,1543.2
4516294607,0,15,1,0,7,8,7,0,0,0,0,15707,6.8,16724,206,38,-968,-1029,20.6,1570.7,18,2,1,8,7,7,2,1,1,0,16675,6.8,17753,218,43,968,1029,21.8,1667.5
4524526472,0,16,1,0,5,8,5,1,1,0,0,15938,6.8,17247,196,49,-950,-650,19.6,1593.8,103,1,1,8,5,8,0,0,0,0,16888,6.8,17897,185,65,950,650,18.5,1688.8
4524900918,0,17,1,0,6,8,4,0,0,0,0,16046,6.6,16986,203,48,-1112,-942,20.3,1604.6,15,3,1,8,6,7,0,0,0,0,17158,7.0,17928,220,56,1112,942,22.0,1715.8
4450708282,1,13,2,0,11,4,9,1,0,1,0,17666,7.4,19949,218,45,2405,3251,21.8,1766.6,16,3,1,4,11,4,1,1,0,0,15261,6.6,16698,204,45,-2405,-3251,20.4,1526.1
4515249145,1,17,4,1,9,8,9,1,1,0,0,17375,6.8,18035,217,50,238,368,21.7,1737.5,21,4,0,8,9,11,0,0,0,0,17137,6.8,17667,207,40,-238,-368,20.7,1713.7
4524709324,1,16,1,1,5,6,5,1,1,0,0,15706,6.6,17219,228,43,-469,-1237,22.8,1570.6,19,5,0,6,5,4,0,0,0,0,16175,7.0,18456,229,56,469,1237,22.9,1617.5
4481270727,0,17,2,0,8,7,8,0,0,0,0,16585,7.0,18064,207,54,-627,-998,20.7,1658.5,13,2,1,7,8,4,0,0,0,0,17212,7.2,19062,222,64,627,998,22.2,1721.2
4465934197,1,16,4,1,6,3,7,0,0,0,0,16434,6.8,18132,216,77,1545,1824,21.6,1643.4,19,2,0,3,6,3,1,1,0,0,14889,6.4,16308,233,40,-1545,-1824,23.3,1488.9
4511522189,0,17,6,1,5,5,4,1,1,0,0,15706,6.8,18183,219,48,-578,-1149,21.9,1570.6,21,2,0,5,5,2,0,0,0,0,16284,7.2,19332,240,60,578,1149,24.0,1628.4
4497671680,0,82,3,1,5,4,7,0,0,0,0,16035,6.6,17246,193,44,408,165,19.3,1603.5,15,2,0,4,5,6,1,1,0,0,15627,6.8,17081,224,56,-408,-165,22.4,1562.7
4524615690,0,17,3,0,5,7,8,1,1,0,0,15680,6.8,17983,201,58,-638,1771,20.1,1568.0,17,4,1,7,5,12,0,0,0,0,16318,6.6,16212,219,28,638,-1771,21.9,1631.8
4478166027,1,46,5,1,9,5,10,0,0,0,0,17413,7.0,17940,229,25,1221,-172,22.9,1741.3,15,0,0,5,9,7,0,0,0,0,16192,7.0,18112,213,67,-1221,172,21.3,1619.2
4459403995,1,20,1,0,4,9,3,0,0,0,0,15582,6.8,17281,212,56,-2058,-2051,21.2,1558.2,12,6,1,9,4,11,0,0,0,0,17640,7.2,19332,224,54,2058,2051,22.4,1764.0
4518236753,0,18,1,1,4,12,7,0,0,0,0,15233,6.6,16168,208,39,-3184,-2345,20.8,1523.3,13,3,0,12,4,14,0,0,0,0,18417,7.0,18513,218,44,3184,2345,21.8,1841.7
4517802077,1,18,6,1,7,3,12,1,1,0,0,15494,6.6,15724,165,38,1515,857,16.5,1549.4,15,3,0,3,7,2,0,0,0,0,13979,6.4,14867,186,49,-1515,-857,18.6,1397.9
4524995748,0,20,1,0,2,7,3,1,1,0,0,14358,6.6,16775,225,53,-2031,-1121,22.5,1435.8,17,2,1,7,2,6,0,0,0,0,16389,7.0,17896,223,37,2031,1121,22.3,1638.9
4519613119,0,14,1,0,10,7,7,0,0,0,0,18923,7.4,20387,241,59,1219,1356,24.1,1892.3,15,1,1,7,10,8,1,1,0,0,17704,7.0,19031,207,70,-1219,-1356,20.7,1770.4
4517709660,1,21,2,0,8,9,9,0,0,0,0,17334,6.8,16960,213,45,-729,-192,21.3,1733.4,16,6,1,9,8,12,1,1,0,0,18063,6.8,17152,219,43,729,192,21.9,1806.3
4525777305,1,24,3,1,7,2,9,2,1,1,0,17231,6.6,17207,240,47,3203,1830,24.0,1723.1,13,0,0,2,7,2,0,0,0,0,14028,6.2,15377,186,52,-3203,-1830,18.6,1402.8
4489499692,0,19,3,1,7,4,8,1,0,1,0,16333,7.2,18737,204,44,517,585,20.4,1633.3,16,3,0,4,7,4,1,1,0,0,15816,6.8,18152,234,60,-517,-585,23.4,1581.6
4501831991,1,13,2,0,8,6,9,0,0,0,0,16880,7.2,18007,217,55,1313,1407,21.7,1688.0,16,2,1,6,8,6,0,0,0,0,15567,6.4,16600,181,52,-1313,-1407,18.1,1556.7
4511649703,1,62,2,1,6,1,8,2,1,1,0,16601,7.0,18535,231,44,1799,442,23.1,1660.1,15,0,0,1,6,1,0,0,0,0,14802,6.8,18093,231,72,-1799,-442,23.1,1480.2
4500738372,1,20,3,0,6,3,5,0,0,0,0,16737,7.4,19857,243,64,1204,2004,24.3,1673.7,16,4,1,3,6,2,1,1,0,0,15533,6.8,17853,250,48,-1204,-2004,25.0,1553.3
4505648249,1,13,1,1,7,8,12,1,1,0,0,16200,6.6,17810,202,42,-927,-736,20.2,1620.0,13,3,0,8,7,11,1,0,1,0,17127,7.2,18546,207,57,927,736,20.7,1712.7
4508408940,0,35,3,0,3,6,2,1,1,0,0,13879,6.6,16319,148,62,-2967,-3336,14.8,1387.9,14,2,1,6,3,2,0,0,0,0,16846,7.2,19655,223,69,2967,3336,22.3,1684.6
4486160462,0,14,0,1,3,2,3,1,0,1,0,14424,6.6,17499,201,48,-541,-66,20.1,1442.4,9,0,0,2,3,2,0,0,0,0,14965,6.8,17565,234,60,541,66,23.4,1496.5
4527181514,1,42,1,1,3,1,2,0,0,0,0,16019,7.4,20401,262,76,1577,2582,26.2,1601.9,15,18,0,1,3,1,1,1,0,0,14442,7.0,17819,232,56,-1577,-2582,23.2,1444.2
4509643983,0,15,4,1,5,6,9,0,0,0,0,15885,6.6,16674,203,40,-75,-1566,20.3,1588.5,14,2,0,6,5,1,2,1,1,0,15960,7.0,18240,211,68,75,1566,21.1,1596.0
4523960363,0,21,0,0,5,7,7,0,0,0,0,15661,6.4,15375,208,39,-945,-2334,20.8,1566.1,13,4,1,7,5,5,0,0,0,0,16606,7.0,17709,234,36,945,2334,23.4,1660.6
4502905880,1,28,3,1,7,12,9,0,0,0,0,17185,6.6,16416,200,32,-2557,-2229,20.0,1718.5,17,3,0,12,7,19,2,1,1,0,19742,7.2,18645,210,37,2557,2229,21.0,1974.2
4526941683,1,14,1,0,3,1,3,0,0,0,0,15704,7.0,17817,246,50,789,-175,24.6,1570.4,20,1,1,1,3,2,1,1,0,0,14915,6.8,17992,232,72,-789,175,23.2,1491.5
4524684326,1,17,3,1,6,3,6,1,1,0,0,16628,6.8,17323,230,56,2050,687,23.0,1662.8,16,1,0,3,6,2,0,0,0,0,14578,6.6,16636,195,43,-2050,-687,19.5,1457.8
4447643758,1,17,3,0,1,1,2,0,0,0,0,14649,7.0,17790,229,55,-444,-877,22.9,1464.9,19,4,1,1,1,1,1,0,1,0,15093,7.0,18667,247,55,444,877,24.7,1509.3
4517529654,1,22,15,1,7,3,9,1,0,1,0,16723,7.0,17883,233,34,1489,604,23.3,1672.3,41,5,0,3,7,3,0,0,0,0,15234,7.0,17279,228,65,-1489,-604,22.8,1523.4
4523130201,1,41,6,0,7,5,10,1,1,0,0,16583,7.2,17389,222,44,840,385,22.2,1658.3,17,5,1,5,7,4,0,0,0,0,15743,6.8,17004,213,48,-840,-385,21.3,1574.3
4523270245,1,15,0,1,3,2,4,0,0,0,0,15719,7.4,19029,230,60,753,263,23.0,1571.9,13,0,0,2,3,3,1,1,0,0,14966,7.2,18766,236,63,-753,-263,23.6,1496.6
4523056314,1,15,3,1,10,8,8,1,1,0,0,17618,7.0,18069,212,48,975,1131,21.2,1761.8,26,0,0,8,10,4,0,0,0,0,16643,6.8,16938,196,45,-975,-1131,19.6,1664.3
4524284970,1,16,3,0,3,2,4,1,1,0,0,14867,7.0,17875,205,52,-178,738,20.5,1486.7,18,3,1,2,3,2,0,0,0,0,15045,6.8,17137,245,49,178,-738,24.5,1504.5
4471718204,1,16,1,1,17,4,20,1,1,0,1,21703,7.2,19827,202,48,7605,3993,20.2,2170.3,15,0,0,4,17,2,1,0,1,0,14098,6.4,15834,177,56,-7605,-3993,17.7,1409.8
4484154962,0,18,3,1,8,10,7,0,0,0,0,16180,6.6,16639,185,36,-2807,-2956,18.5,1618.0,16,3,0,10,8,17,0,0,0,0,18987,7.4,19595,236,61,2807,2956,23.6,1898.7
4421745805,0,17,4,0,3,10,3,0,0,0,0,14788,6.4,15674,194,37,-3231,-3010,19.4,1478.8,17,3,1,10,3,14,1,1,0,0,18019,7.4,18684,220,46,3231,3010,22.0,1801.9
4471351121,0,12,2,0,6,9,6,1,1,0,0,17023,7.0,17635,224,60,-355,-126,22.4,1702.3,19,0,1,9,6,11,0,0,0,0,17378,6.8,17761,209,39,355,126,20.9,1737.8
4470469734,0,19,3,0,3,3,1,1,0,1,0,15229,7.0,18526,242,44,511,-29,24.2,1522.9,17,5,1,3,3,0,1,1,0,0,14718,7.0,18555,209,74,-511,29,20.9,1471.8
4521865491,1,11,2,1,14,6,15,0,0,0,0,21087,7.6,20108,215,36,5260,2633,21.5,2108.7,39,1,0,6,14,5,1,1,0,0,15827,7.0,17475,193,48,-5260,-2633,19.3,1582.7
4461601023,1,18,1,1,10,4,6,2,1,1,0,18288,7.6,20765,234,68,3184,3874,23.4,1828.8,14,1,0,4,10,5,0,0,0,0,15104,6.8,16891,209,54,-3184,-3874,20.9,1510.4
4522402589,0,14,3,1,7,12,9,0,0,0,0,16000,6.4,16324,190,44,-2111,-2875,19.0,1600.0,16,4,0,12,7,11,0,0,0,0,18111,7.2,19199,221,51,2111,2875,22.1,1811.1
4509866681,1,9,4,1,6,5,6,0,0,0,0,17594,7.0,18431,237,42,2264,1006,23.7,1759.4,20,3,0,5,6,5,0,0,0,0,15330,6.8,17425,190,55,-2264,-1006,19.0,1533.0
4520732095,0,13,2,1,4,8,3,0,0,0,0,15325,6.8,17018,215,31,-1931,-1572,21.5,1532.5,16,2,0,8,4,16,1,1,0,0,17256,7.2,18590,220,52,1931,1572,22.0,1725.6
4494108610,0,10,2,0,2,13,2,0,0,0,0,14198,6.4,15730,195,41,-4030,-2539,19.5,1419.8,17,1,1,13,2,15,0,0,0,0,18228,7.0,18269,198,43,4030,2539,19.8,1822.8
4526563599,0,12,1,1,2,8,0,0,0,0,0,14021,6.2,15684,200,55,-3792,-3472,20.0,1402.1,17,2,0,8,2,8,1,1,0,0,17813,7.2,19156,236,43,3792,3472,23.6,1781.3
4525991755,0,17,3,1,3,11,3,0,0,0,0,15273,6.6,16831,227,41,-2111,-1607,22.7,1527.3,22,2,0,11,3,11,1,1,0,0,17384,6.8,18438,218,48,2111,1607,21.8,1738.4
4464812857,1,11,4,0,8,4,9,1,1,0,0,17397,7.2,19011,244,52,2598,4512,24.4,1739.7,23,0,1,4,8,7,0,0,0,0,14799,5.8,14499,186,49,-2598,-4512,18.6,1479.9
4523432190,1,41,1,1,3,7,4,0,0,0,0,15715,7.0,18159,246,54,-1235,-956,24.6,1571.5,17,17,0,7,3,4,1,1,0,0,16950,7.2,19115,252,52,1235,956,25.2,1695.0
4523747922,0,16,3,0,2,6,3,0,0,0,0,14752,6.8,17935,228,61,-2181,-1293,22.8,1475.2,17,3,1,6,2,8,1,1,0,0,16933,7.2,19228,252,52,2181,1293,25.2,1693.3
4524720967,1,15,2,1,12,2,23,0,0,0,0,17628,6.2,14939,184,28,4007,970,18.4,1762.8,17,2,0,2,12,3,0,0,0,0,13621,6.2,13969,183,44,-4007,-970,18.3,1362.1
4501240960,1,16,2,0,5,5,6,1,1,0,0,16046,6.8,17207,234,41,699,18,23.4,1604.6,14,0,1,5,5,6,0,0,0,0,15347,6.6,17189,199,52,-699,-18,19.9,1534.7
4468744263,0,22,4,0,7,6,11,0,0,0,0,16587,6.8,17801,216,44,-674,909,21.6,1658.7,20,6,1,6,7,8,0,0,0,0,17261,6.6,16892,219,34,674,-909,21.9,1726.1
4517673973,1,49,1,1,8,2,10,1,1,0,1,18590,6.6,18032,237,48,3618,1086,23.7,1859.0,13,3,0,2,8,1,0,0,0,0,14972,6.6,16946,238,43,-3618,-1086,23.8,1497.2
4521258257,1,18,6,1,4,4,3,0,0,0,0,15936,6.8,16572,229,44,218,-1933,22.9,1593.6,42,5,0,4,4,5,1,1,0,0,15718,7.0,18505,243,52,-218,1933,24.3,1571.8
4525028786,1,17,2,1,4,4,3,1,0,1,0,15222,7.0,18238,228,40,712,1633,22.8,1522.2,14,2,0,4,4,5,1,1,0,0,14510,6.8,16605,198,32,-712,-1633,19.8,1451.0
4483768232,1,16,4,1,5,6,5,1,0,1,0,16023,6.8,17244,207,60,1299,-918,20.7,1602.3,14,4,0,6,5,7,1,1,0,0,14724,7.0,18162,173,50,-1299,918,17.3,1472.4
4518344857,1,30,4,0,6,8,10,1,1,0,0,16162,7.0,18095,211,48,-1636,-872,21.1,1616.2,18,3,1,8,6,14,0,0,0,0,17798,7.2,18967,226,60,1636,872,22.6,1779.8
4525533039,1,17,4,1,5,3,4,2,1,1,0,16187,6.8,18182,239,60,1408,1663,23.9,1618.7,23,3,0,3,5,3,0,0,0,0,14779,6.6,16519,204,60,-1408,-1663,20.4,1477.9
4505940402,1,15,1,0,3,3,6,0,0,0,0,14127,6.6,16566,186,44,-1171,-1157,18.6,1412.7,16,3,1,3,3,4,1,1,0,0,15298,6.6,17723,233,60,1171,1157,23.3,1529.8
4524909030,0,52,0,0,6,4,7,1,0,1,0,16159,6.6,16943,208,44,1656,1298,20.8,1615.9,17,1,1,4,6,4,0,0,0,0,14503,6.4,15645,200,36,-1656,-1298,20.0,1450.3
4489725249,0,21,6,1,7,12,11,1,0,1,0,16867,6.8,16680,209,52,-1883,-873,20.9,1686.7,20,4,0,12,7,13,1,1,0,0,18750,7.0,17553,226,34,1883,873,22.6,1875.0
4496613107,0,19,5,1,4,5,7,0,0,0,0,16254,7.2,18913,248,60,-329,-230,24.8,1625.4,14,6,0,5,4,5,0,0,0,0,16583,7.2,19143,272,47,329,230,27.2,1658.3
4527328845,0,19,3,1,2,7,3,0,0,0,0,14695,6.8,16615,222,49,-2240,-4314,22.2,1469.5,17,2,0,7,2,2,1,1,0,0,16935,7.4,20929,249,77,2240,4314,24.9,1693.5
4504912203,0,39,7,1,3,4,3,0,0,0,0,14623,6.4,16060,200,36,-1585,-2306,20.0,1462.3,37,6,0,4,3,6,1,1,0,0,16208,6.8,18366,253,52,1585,2306,25.3,1620.8
4521542969,1,13,3,1,6,4,10,2,1,1,0,17086,7.0,17746,229,54,1838,-689,22.9,1708.6,14,3,0,4,6,7,0,0,0,0,15248,7.2,18435,231,51,-1838,689,23.1,1524.8
4511964473,0,16,3,1,5,7,7,1,1,0,0,15399,6.4,16243,196,48,-2164,-2554,19.6,1539.9,18,3,0,7,5,8,0,0,0,0,17563,7.0,18797,214,63,2164,2554,21.4,1756.3
4523348814,0,18,3,1,7,3,6,1,0,1,0,16300,7.0,18376,226,47,286,-12,22.6,1630.0,16,7,0,3,7,2,1,1,0,0,16014,6.8,18388,239,56,-286,12,23.9,1601.4
4524259924,0,18,4,1,7,7,9,1,0,1,0,16517,6.6,16968,182,50,473,446,18.2,1651.7,18,2,0,7,7,7,1,1,0,0,16044,6.6,16522,183,42,-473,-446,18.3,1604.4
4523706574,0,15,5,0,5,11,4,0,0,0,0,14975,6.4,15932,194,44,-3359,-2255,19.4,1497.5,17,4,1,11,5,8,1,1,0,0,18334,7.0,18187,221,60,3359,2255,22.1,1833.4
4527312388,1,14,0,1,10,9,10,1,1,0,0,18616,7.4,19395,213,76,1885,1082,21.3,1861.6,8,2,0,9,10,9,0,0,0,0,16731,7.0,18313,189,45,-1885,-1082,18.9,1673.1
4514312367,0,11,1,0,3,9,5,0,0,0,0,14347,6.4,15496,182,53,-3221,-2950,18.2,1434.7,18,1,1,9,3,14,1,1,0,0,17568,7.2,18446,192,70,3221,2950,19.2,1756.8
4520968733,1,61,3,0,5,7,5,0,0,0,0,16343,6.8,18250,233,52,77,239,23.3,1634.3,17,4,1,7,5,9,1,1,0,0,16266,6.8,18011,203,52,-77,-239,20.3,1626.6
4452001720,0,13,4,0,2,13,3,0,0,0,0,12798,5.4,12111,187,4,-8472,-8242,18.7,1279.8,16,1,1,13,2,16,1,1,0,1,21270,7.6,20353,224,64,8472,8242,22.4,2127.0
4467978443,0,18,3,0,7,6,10,1,0,1,0,15948,6.6,16134,185,39,-361,-1022,18.5,1594.8,19,2,1,6,7,7,0,0,0,0,16309,6.8,17156,196,44,361,1022,19.6,1630.9
4468947344,1,19,3,1,3,5,2,1,1,0,0,15530,6.8,17181,221,60,196,-183,22.1,1553.0,29,2,0,5,3,4,1,0,1,0,15334,7.0,17364,202,52,-196,183,20.2,1533.4
4523546666,1,16,1,0,5,3,6,0,0,0,0,16169,7.2,18880,235,60,561,740,23.5,1616.9,14,0,1,3,5,3,0,0,0,0,15608,7.0,18140,235,59,-561,-740,23.5,1560.8
4512583390,1,15,4,1,9,2,11,0,0,0,0,18442,7.4,19414,248,51,2680,1700,24.8,1844.2,19,3,0,2,9,1,2,1,1,0,15762,7.0,17714,240,52,-2680,-1700,24.0,1576.2
4454995485,0,32,3,0,7,8,7,0,0,0,0,16650,7.2,17869,212,53,-1213,-1099,21.2,1665.0,16,5,1,8,7,6,1,1,0,0,17863,7.2,18968,229,59,1213,1099,22.9,1786.3
4478080352,0,16,1,0,0,8,0,0,0,0,0,12988,6.2,14678,153,78,-5264,-4627,15.3,1298.8,21,5,1,8,0,10,2,1,1,0,18252,7.2,19305,273,44,5264,4627,27.3,1825.2
4491631842,1,31,5,1,4,4,4,1,1,0,0,16095,7.0,18669,241,65,-262,-375,24.1,1609.5,24,3,0,4,4,2,0,0,0,0,16357,7.2,19044,257,55,262,375,25.7,1635.7
4513818469,0,15,1,0,4,8,8,0,0,0,0,15503,6.8,18406,204,52,-2892,-2716,20.4,1550.3,14,1,1,8,4,6,2,1,1,0,18395,7.6,21122,261,72,2892,2716,26.1,1839.5
4478267936,0,16,3,0,6,5,7,0,0,0,0,17065,7.0,18634,220,50,1019,327,22.0,1706.5,18,1,1,5,6,7,1,1,0,0,16046,7.0,18307,233,50,-1019,-327,23.3,1604.6
4442484650,0,13,2,0,2,9,1,0,0,0,0,13569,6.0,14129,165,52,-3535,-3197,16.5,1356.9,15,0,1,9,2,11,2,1,1,0,17104,7.0,17326,215,44,3535,3197,21.5,1710.4
4495258112,0,17,2,0,9,10,6,1,1,0,0,16954,6.8,16923,197,49,-1073,210,19.7,1695.4,19,3,1,10,9,16,0,0,0,0,18027,6.6,16713,176,51,1073,-210,17.6,1802.7
4457538069,0,15,3,0,0,9,0,1,1,0,0,13850,6.8,16985,217,60,-4513,-2787,21.7,1385.0,22,5,1,9,0,15,0,0,0,0,18363,7.4,19772,246,53,4513,2787,24.6,1836.3
4465307866,1,16,2,1,9,6,10,1,0,1,0,17704,7.0,18715,197,64,1792,1373,19.7,1770.4,14,1,0,6,9,2,1,1,0,0,15912,6.6,17342,205,48,-1792,-1373,20.5,1591.2
4523812506,0,15,0,1,6,6,12,1,1,0,0,16434,6.8,18059,214,58,428,-939,21.4,1643.4,13,1,0,6,6,2,1,0,1,0,16006,7.2,18998,184,63,-428,939,18.4,1600.6
4520642578,1,17,6,1,2,1,1,1,0,1,0,14702,6.6,16741,244,43,649,69,24.4,1470.2,22,3,0,1,2,1,1,1,0,0,14053,6.8,16672,214,42,-649,-69,21.4,1405.3
4482157138,1,15,1,1,4,4,8,0,0,0,0,15572,6.8,17404,221,48,-1216,-1810,22.1,1557.2,15,3,0,4,4,3,0,0,0,0,16788,7.4,19214,256,57,1216,1810,25.6,1678.8
4500854346,0,33,2,0,1,4,0,0,0,0,0,15652,7.0,18830,258,64,11,-139,25.8,1565.2,14,13,1,4,1,4,2,1,1,0,15641,7.0,18969,227,52,-11,139,22.7,1564.1
4523311875,1,15,2,1,9,6,7,1,1,0,0,18017,7.2,19071,210,80,1937,766,21.0,1801.7,14,0,0,6,9,6,0,0,0,0,16080,7.2,18305,209,68,-1937,-766,20.9,1608.0
4517823800,0,19,5,1,6,7,7,0,0,0,0,16072,6.6,17054,225,46,-420,-1185,22.5,1607.2,15,3,0,7,6,10,1,1,0,0,16492,7.2,18239,212,50,420,1185,21.2,1649.2
4506087855,0,20,4,0,6,8,5,1,0,1,0,16022,6.8,17899,206,44,-3063,-1676,20.6,1602.2,18,4,1,8,6,12,1,1,0,0,19085,7.2,19575,240,55,3063,1676,24.0,1908.5
4501029186,0,18,3,0,6,10,10,0,0,0,0,16876,6.6,16812,238,40,-1015,-1031,23.8,1687.6,15,6,1,10,6,9,0,0,0,0,17891,6.8,17843,212,48,1015,1031,21.2,1789.1
4502871772,1,14,0,1,3,7,1,0,0,0,0,14735,7.0,18050,213,64,-2483,-1356,21.3,1473.5,15,1,0,7,3,10,1,1,0,0,17218,7.4,19406,228,62,2483,1356,22.8,1721.8
4424123529,1,17,1,1,8,3,5,0,0,0,0,16739,7.4,19178,218,54,1630,1005,21.8,1673.9,32,2,0,3,8,3,0,0,0,0,15109,7.0,18173,196,64,-1630,-1005,19.6,1510.9
4515307437,0,15,1,0,3,14,1,1,1,0,0,14143,6.2,15352,205,46,-6445,-4329,20.5,1414.3,14,3,1,14,3,14,1,0,1,0,20588,7.4,19681,209,66,6445,4329,20.9,2058.8
4497502064,1,14,2,1,7,8,6,1,0,1,0,16940,6.8,17305,234,42,400,-213,23.4,1694.0,14,3,0,8,7,10,1,1,0,0,16540,6.8,17518,222,52,-400,213,22.2,1654.0
4445820546,0,12,2,0,5,22,4,0,0,0,0,15077,6.4,15707,138,52,-7278,-6021,13.8,1507.7,14,1,1,22,5,12,0,0,0,0,22355,8.0,21728,229,36,7278,6021,22.9,2235.5
4513611157,1,18,4,0,11,6,13,0,0,0,0,18748,7.0,19116,243,40,2520,2092,24.3,1874.8,53,4,1,6,11,5,0,0,0,0,16228,6.8,17024,224,40,-2520,-2092,22.4,1622.8
4511363738,1,17,0,1,10,4,14,1,0,1,0,19271,7.2,18923,245,44,4290,1900,24.5,1927.1,12,2,0,4,10,7,0,0,0,0,14981,6.8,17023,193,53,-4290,-1900,19.3,1498.1
4515582537,1,57,6,1,10,6,9,1,0,1,1,19276,7.2,19395,218,62,3942,2820,21.8,1927.6,19,2,0,6,10,6,0,0,0,0,15334,6.6,16575,189,29,-3942,-2820,18.9,1533.4
4474203677,0,23,5,1,6,6,5,1,1,0,0,16010,7.0,17522,231,50,-210,-589,23.1,1601.0,23,3,0,6,6,7,0,0,0,0,16220,7.0,18111,218,53,210,589,21.8,1622.0
4527127873,0,20,1,0,1,8,1,0,0,0,0,13006,6.0,14750,201,44,-6892,-5371,20.1,1300.6,18,1,1,8,1,12,2,1,1,1,19898,7.2,20121,233,76,6892,5371,23.3,1989.8
4446018252,0,18,5,1,7,7,8,1,1,0,0,16700,7.0,17519,241,40,-418,-1320,24.1,1670.0,16,3,0,7,7,9,0,0,0,0,17118,7.0,18839,224,48,418,1320,22.4,1711.8
4524361217,1,39,4,1,7,6,10,0,0,0,0,16781,7.0,18289,195,55,439,751,19.5,1678.1,13,4,0,6,7,6,2,1,1,0,16342,7.0,17538,203,59,-439,-751,20.3,1634.2
4494865668,0,19,4,1,4,3,1,1,0,1,0,15454,6.6,17213,226,49,957,406,22.6,1545.4,16,3,0,3,4,3,0,0,0,0,14497,6.8,16807,215,50,-957,-406,21.5,1449.7
4520800745,1,16,1,0,6,10,6,1,1,0,0,15936,6.6,17184,233,36,-2542,-1008,23.3,1593.6,17,2,1,10,6,9,0,0,0,0,18478,7.0,18192,233,52,2542,1008,23.3,1847.8
4488308418,1,15,0,1,9,6,8,1,0,1,0,17790,7.0,18908,203,51,1477,691,20.3,1779.0,10,0,0,6,9,4,0,0,0,0,16313,7.0,18217,208,48,-1477,-691,20.8,1631.3
4526978661,1,15,3,1,6,2,4,1,0,1,0,16127,6.8,17096,237,40,2329,1331,23.7,1612.7,17,2,0,2,6,4,1,1,0,0,13798,6.2,15765,186,47,-2329,-1331,18.6,1379.8
4519268347,0,14,0,0,2,3,3,1,0,1,1,16664,6.8,18036,255,55,1047,-143,25.5,1666.4,14,3,1,3,2,4,1,1,0,0,15617,7.0,18179,247,54,-1047,143,24.7,1561.7
4483650027,0,17,3,0,1,6,1,0,0,0,0,14325,6.8,17432,235,57,-1887,-587,23.5,1432.5,17,4,1,6,1,10,1,1,0,0,16212,7.2,18019,228,52,1887,587,22.8,1621.2
4478024561,1,17,3,1,7,8,2,1,1,0,0,16443,6.8,17912,228,48,-1041,-661,22.8,1644.3,13,3,0,8,7,9,0,0,0,0,17484,7.0,18573,216,47,1041,661,21.6,1748.4
4526656386,1,15,1,0,8,6,8,0,0,0,0,16828,6.8,17628,227,42,-47,-888,22.7,1682.8,17,0,1,6,8,10,1,1,0,0,16875,7.0,18516,240,68,47,888,24.0,1687.5
4461165597,1,19,4,0,5,2,5,0,0,0,1,17169,7.0,18362,239,42,1574,1353,23.9,1716.9,18,2,1,2,5,3,2,1,1,0,15595,6.4,17009,252,54,-1574,-1353,25.2,1559.5
4448381986,0,18,3,0,7,7,10,0,0,0,0,16531,6.6,16364,202,44,-869,327,20.2,1653.1,29,2,1,7,7,9,1,1,0,1,17400,6.6,16037,219,48,869,-327,21.9,1740.0
4521693462,0,13,0,0,1,8,1,0,0,0,0,13141,6.6,16162,202,39,-4046,-2777,20.2,1314.1,13,0,1,8,1,5,1,0,1,0,17187,7.2,18939,214,52,4046,2777,21.4,1718.7
4524248852,0,39,1,1,9,8,5,0,0,0,0,16307,7.0,17660,194,32,-796,-217,19.4,1630.7,18,6,0,8,9,10,0,0,0,0,17103,6.8,17877,215,44,796,217,21.5,1710.3
4437258310,1,17,5,1,5,3,8,0,0,0,0,15154,6.4,15685,206,28,1087,-1278,20.6,1515.4,21,5,0,3,5,1,0,0,0,0,14067,6.8,16963,192,43,-1087,1278,19.2,1406.7
4526044508,1,19,3,0,6,6,7,0,0,0,0,16302,7.0,18040,212,45,95,772,21.2,1630.2,15,6,1,6,6,7,1,1,0,0,16207,6.8,17268,205,46,-95,-772,20.5,1620.7
4524282736,1,14,3,1,6,5,5,1,0,1,0,16594,7.0,18973,224,50,466,933,22.4,1659.4,40,4,0,5,6,8,1,1,0,0,16128,7.0,18040,233,52,-466,-933,23.3,1612.8
4525546902,1,12,4,1,6,4,3,1,1,0,0,16081,7.0,18269,232,36,656,553,23.2,1608.1,37,2,0,4,6,5,0,0,0,0,15425,7.0,17716,205,52,-656,-553,20.5,1542.5
4468533756,1,17,3,1,17,5,16,1,1,0,0,20218,7.2,18620,199,40,4899,2415,19.9,2021.8,16,2,0,5,17,5,0,0,0,0,15319,6.4,16205,165,61,-4899,-2415,16.5,1531.9
4511502390,1,18,4,1,5,5,3,2,1,1,0,16399,7.0,17698,236,57,330,-475,23.6,1639.9,20,3,0,5,5,6,0,0,0,0,16069,6.8,18173,235,46,-330,475,23.5,1606.9
4499246696,1,10,2,1,8,5,8,0,0,0,0,17615,7.0,18307,206,46,3686,1471,20.6,1761.5,17,0,0,5,8,4,0,0,0,0,13929,6.6,16836,153,46,-3686,-1471,15.3,1392.9
4516319678,0,15,1,1,6,2,7,1,0,1,0,16583,7.0,18071,244,52,2191,1140,24.4,1658.3,16,4,0,2,6,1,1,1,0,0,14392,6.8,16931,218,52,-2191,-1140,21.8,1439.2
4516268505,1,42,2,1,8,3,6,0,0,0,0,16532,7.2,18420,229,40,1558,785,22.9,1653.2,34,2,0,3,8,2,1,0,1,0,14974,7.0,17635,206,56,-1558,-785,20.6,1497.4
4479921636,1,15,3,1,8,2,11,2,1,1,0,17903,7.4,19614,216,55,3249,1410,21.6,1790.3,12,0,0,2,8,1,0,0,0,0,14654,7.0,18204,231,60,-3249,-1410,23.1,1465.4
4510706463,1,18,1,1,4,1,2,1,1,0,0,17378,7.2,18286,262,60,3046,442,26.2,1737.8,13,2,0,1,4,2,0,0,0,0,14332,6.8,17844,211,64,-3046,-442,21.1,1433.2
4508289353,1,16,2,0,8,2,15,0,0,0,0,17083,7.0,18346,229,24,2877,1714,22.9,1708.3,13,3,1,2,8,1,1,1,0,0,14206,6.6,16632,212,45,-2877,-1714,21.2,1420.6
4500096958,1,14,4,0,4,9,7,1,0,1,0,14641,6.6,16376,171,60,-3174,-1926,17.1,1464.1,22,1,1,9,4,14,1,1,0,0,17815,7.0,18302,194,56,3174,1926,19.4,1781.5
4510890954,0,40,3,1,8,8,6,1,1,0,0,16707,6.6,17154,217,44,-164,343,21.7,1670.7,13,13,0,8,8,12,0,0,0,0,16871,6.8,16811,174,49,164,-343,17.4,1687.1
4519753140,1,19,4,1,11,8,13,1,1,0,0,18384,7.2,18583,208,46,1263,-392,20.8,1838.4,12,5,0,8,11,7,0,0,0,0,17121,7.0,18975,207,51,-1263,392,20.7,1712.1
4431352109,0,19,1,0,4,13,3,0,0,0,0,15802,6.8,17403,218,58,-3645,-1801,21.8,1580.2,16,3,1,13,4,14,1,1,0,0,19447,7.2,19204,214,41,3645,1801,21.4,1944.7
4522798841,0,17,3,1,12,10,18,1,1,0,0,17974,6.2,15423,182,34,186,-741,18.2,1797.4,14,3,0,10,12,9,1,0,1,0,17788,6.4,16164,188,40,-186,741,18.8,1778.8
4521375608,1,17,2,0,7,5,7,1,1,0,0,16030,6.8,17738,180,66,-114,433,18.0,1603.0,15,1,1,5,7,4,0,0,0,0,16144,6.8,17305,233,40,114,-433,23.3,1614.4
4451402051,0,21,4,0,1,3,1,1,0,1,0,14672,6.8,17598,247,50,-757,569,24.7,1467.2,19,4,1,3,1,3,1,1,0,0,15429,6.6,17029,242,48,757,-569,24.2,1542.9
4503341875,0,22,2,1,9,7,10,0,0,0,0,18400,7.2,18909,221,60,2746,1975,22.1,1840.0,39,1,0,7,9,10,1,1,0,0,15654,6.6,16934,164,52,-2746,-1975,16.4,1565.4
4511306202,1,17,0,1,5,3,4,0,0,0,0,15833,7.0,17979,196,68,1284,25,19.6,1583.3,11,3,0,3,5,0,2,1,1,0,14549,6.8,17954,202,56,-1284,-25,20.2,1454.9
4495903813,1,12,2,0,6,2,9,1,1,0,0,16405,7.2,18231,233,47,1410,1243,23.3,1640.5,12,2,1,2,6,3,0,0,0,0,14995,6.6,16988,235,52,-1410,-1243,23.5,1499.5
4525128614,0,24,2,1,8,8,9,0,0,0,0,17238,6.8,17944,209,44,894,-3,20.9,1723.8,15,2,0,8,8,10,0,0,0,0,16344,7.0,17947,187,44,-894,3,18.7,1634.4
4435875824,0,17,2,0,8,10,9,0,0,0,0,16738,6.8,17657,199,48,-1428,-671,19.9,1673.8,15,5,1,10,8,16,1,1,0,0,18166,7.0,18328,201,52,1428,671,20.1,1816.6
4483754983,1,15,2,1,6,6,8,1,1,0,0,16388,6.8,17884,236,40,-473,-1354,23.6,1638.8,19,2,0,6,6,9,0,0,0,0,16861,7.4,19238,235,69,473,1354,23.5,1686.1
4440251539,1,15,4,1,10,7,6,1,1,0,0,17895,7.0,18393,208,45,2330,1713,20.8,1789.5,13,4,0,7,10,7,0,0,0,0,15565,6.6,16680,204,31,-2330,-1713,20.4,1556.5
4524955367,1,17,3,0,2,6,2,1,1,0,0,14341,6.8,17715,233,52,-1929,-680,23.3,1434.1,15,4,1,6,2,8,0,0,0,0,16270,7.0,18395,233,44,1929,680,23.3,1627.0
4464256009,0,13,2,1,5,6,11,0,0,0,0,16429,6.6,17419,226,51,-448,-1140,22.6,1642.9,14,1,0,6,5,7,1,1,0,0,16877,7.2,18559,233,56,448,1140,23.3,1687.7
4526987414,0,27,2,1,3,6,4,0,0,0,0,15742,7.0,17970,214,64,-750,-276,21.4,1574.2,18,2,0,6,3,6,1,1,0,0,16492,7.2,18246,232,52,750,276,23.2,1649.2
4452674976,1,18,2,0,4,7,6,1,0,1,0,15536,6.6,16788,234,48,-1972,-1064,23.4,1553.6,19,6,1,7,4,14,1,1,0,0,17508,7.0,17852,223,58,1972,1064,22.3,1750.8
4523100745,1,12,0,1,8,9,5,0,0,0,0,17259,7.0,18116,214,46,240,399,21.4,1725.9,17,0,0,9,8,14,1,1,0,0,17019,6.8,17717,223,32,-240,-399,22.3,1701.9
4521010137,0,16,4,1,8,5,7,0,0,0,0,17044,6.8,17686,217,46,845,-234,21.7,1704.4,14,1,0,5,8,5,1,1,0,0,16199,6.8,17920,207,60,-845,234,20.7,1619.9
4505122785,0,13,0,1,5,5,10,1,1,0,0,15600,6.6,16815,207,45,-475,-1451,20.7,1560.0,13,1,0,5,5,4,0,0,0,0,16075,6.8,18266,233,49,475,1451,23.3,1607.5
4499828809,0,15,1,0,1,6,1,0,0,0,0,13679,6.4,16597,209,52,-4365,-2883,20.9,1367.9,20,4,1,6,1,6,1,1,0,0,18044,7.2,19480,243,59,4365,2883,24.3,1804.4
4477630964,0,18,4,1,8,6,9,0,0,0,0,17926,7.2,18959,245,53,2664,2155,24.5,1792.6,43,4,0,6,8,9,1,1,0,0,15262,6.8,16804,158,48,-2664,-2155,15.8,1526.2
4513659077,1,16,3,0,4,4,3,1,1,0,0,15024,7.0,17340,217,49,-1243,-1261,21.7,1502.4,15,3,1,4,4,6,1,0,1,0,16267,7.0,18601,221,62,1243,1261,22.1,1626.7
4516254148,0,16,1,0,7,8,8,1,1,0,0,16586,6.8,17047,226,50,-787,-1921,22.6,1658.6,39,7,1,8,7,7,0,0,0,0,17373,7.2,18968,207,56,787,1921,20.7,1737.3
4523386902,0,20,0,0,6,13,8,0,0,0,0,15304,6.4,15933,175,40,-5191,-3819,17.5,1530.4,13,4,1,13,6,15,0,0,0,0,20495,7.2,19752,229,49,5191,3819,22.9,2049.5
4525005858,0,16,0,0,2,9,4,0,0,0,0,13631,6.6,15864,175,52,-5167,-3200,17.5,1363.1,12,1,1,9,2,7,0,0,0,0,18798,7.4,19064,234,44,5167,3200,23.4,1879.8
4515231916,0,70,6,0,1,7,0,1,1,0,0,13789,6.8,16947,210,63,-4038,-2854,21.0,1378.9,20,7,1,7,1,12,0,0,0,0,17827,7.4,19801,252,52,4038,2854,25.2,1782.7
4526037570,0,16,0,1,7,4,10,1,1,0,0,16339,7.0,17365,224,40,457,-959,22.4,1633.9,10,1,0,4,7,3,1,0,1,0,15882,7.0,18324,254,56,-457,959,25.4,1588.2
4454069388,0,41,4,1,7,8,8,0,0,0,0,16604,6.6,17328,203,47,-416,-907,20.3,1660.4,17,6,0,8,7,11,1,1,0,0,17020,7.0,18235,201,55,416,907,20.1,1702.0
4467752796,1,16,2,1,13,5,10,1,0,1,0,18337,7.2,18978,194,43,3211,3640,19.4,1833.7,16,0,0,5,13,6,0,0,0,0,15126,6.4,15338,182,32,-3211,-3640,18.2,1512.6
4504908173,0,11,1,0,5,14,3,0,0,0,0,15322,6.4,15807,210,56,-4024,-2373,21.0,1532.2,18,2,1,14,5,17,1,1,0,0,19346,6.8,18180,203,47,4024,2373,20.3,1934.6
4527555265,0,15,4,0,5,7,4,0,0,0,0,15637,6.6,16547,205,46,-1960,-709,20.5,1563.7,21,2,1,7,5,8,1,1,0,1,17597,6.8,17256,223,43,1960,709,22.3,1759.7
4467974505,1,15,1,1,11,6,13,0,0,0,0,20245,7.6,21086,240,49,4151,3492,24.0,2024.5,34,1,0,6,11,9,0,0,0,0,16094,7.0,17594,171,55,-4151,-3492,17.1,1609.4
4485497527,1,17,6,0,4,5,4,1,0,1,0,16178,7.6,19249,223,80,297,1259,22.3,1617.8,19,4,1,5,4,5,0,0,0,0,15881,7.0,17990,225,48,-297,-1259,22.5,1588.1
4470854318,0,56,1,0,6,10,8,1,0,1,0,15633,6.8,17605,210,36,-2770,-2347,21.0,1563.3,14,2,1,10,6,13,1,1,0,0,18403,7.2,19952,218,52,2770,2347,21.8,1840.3
4494122162,0,12,1,1,3,6,2,0,0,0,0,14607,6.8,17527,204,56,-2968,-2262,20.4,1460.7,40,2,0,6,3,8,2,1,1,0,17575,7.6,19789,243,56,2968,2262,24.3,1757.5
4439064814,0,18,6,1,4,3,4,1,1,0,0,16114,7.0,17563,235,39,1323,25,23.5,1611.4,21,3,0,3,4,5,0,0,0,0,14791,6.8,17538,203,48,-1323,-25,20.3,1479.1
4522501943,0,17,3,1,7,6,8,0,0,0,0,16533,7.0,17850,198,60,-727,-675,19.8,1653.3,15,1,0,6,7,7,1,1,0,0,17260,7.0,18525,224,60,727,675,22.4,1726.0
4524058240,0,41,3,0,1,6,2,1,1,0,0,14165,6.8,17829,218,59,-1963,-45,21.8,1416.5,19,2,1,6,1,7,0,0,0,0,16128,7.0,17874,205,52,1963,45,20.5,1612.8
4522528585,1,14,3,0,8,8,5,1,1,0,0,17421,7.4,19535,244,49,-108,1254,24.4,1742.1,14,2,1,8,8,9,0,0,0,0,17529,7.0,18281,212,58,108,-1254,21.2,1752.9
4510563287,0,11,1,0,8,10,8,0,0,0,0,16239,7.0,17518,186,48,-1289,-1384,18.6,1623.9,16,2,1,10,8,8,1,1,0,0,17528,7.0,18902,204,53,1289,1384,20.4,1752.8
4497769200,1,15,2,1,4,1,3,1,1,0,0,16417,7.0,18579,248,72,1930,793,24.8,1641.7,14,1,0,1,4,1,0,0,0,0,14487,6.8,17786,257,54,-1930,-793,25.7,1448.7
4421709133,0,16,4,0,3,9,5,1,0,1,0,15492,7.0,17768,245,55,-2139,868,24.5,1549.2,38,2,1,9,3,12,1,1,0,0,17631,6.6,16900,195,48,2139,-868,19.5,1763.1
4467013269,1,38,3,0,6,7,7,2,1,1,0,16079,7.0,19081,203,48,-1289,918,20.3,1607.9,27,5,1,7,6,8,0,0,0,0,17368,6.8,18163,264,42,1289,-918,26.4,1736.8
4508637954,1,15,2,0,9,2,15,0,0,0,0,18485,7.2,18688,232,48,4318,2821,23.2,1848.5,17,1,1,2,9,3,1,0,1,0,14167,6.4,15867,197,44,-4318,-2821,19.7,1416.7
4445477359,0,17,3,0,1,11,1,0,0,0,0,12789,6.4,15191,157,48,-6470,-5355,15.7,1278.9,15,2,1,11,1,13,1,1,0,0,19259,7.4,20546,256,63,6470,5355,25.6,1925.9
4513037012,1,17,5,1,11,7,6,2,1,1,0,18413,7.2,19681,228,60,2377,2335,22.8,1841.3,22,2,0,7,11,7,0,0,0,0,16036,7.0,17346,172,60,-2377,-2335,17.2,1603.6
4512728524,0,16,5,1,5,12,3,0,0,0,0,15776,6.8,16537,209,58,-3587,-2861,20.9,1577.6,16,3,0,12,5,10,2,1,1,1,19363,7.2,19398,197,56,3587,2861,19.7,1936.3
4524260253,1,15,1,0,10,4,8,1,0,1,2,20352,7.4,19537,232,57,5649,3668,23.2,2035.2,14,2,1,4,10,6,1,1,0,0,14703,6.4,15869,200,38,-5649,-3668,20.0,1470.3
4512780010,0,17,3,0,3,10,2,0,0,0,0,15137,6.6,16725,214,56,-2645,-1869,21.4,1513.7,60,1,1,10,3,7,1,1,0,0,17782,7.2,18594,225,48,2645,1869,22.5,1778.2
4522555214,0,14,3,1,4,4,9,1,1,0,0,15823,6.8,17501,230,46,-211,-1817,23.0,1582.3,36,4,0,4,4,4,0,0,0,0,16034,7.2,19318,233,64,211,1817,23.3,1603.4
4498584517,0,16,1,0,2,8,3,1,1,0,0,13803,6.4,15972,181,45,-5226,-3701,18.1,1380.3,15,2,1,8,2,9,1,0,1,0,19029,7.2,19673,259,55,5226,3701,25.9,1902.9
4484094490,0,18,5,0,4,1,5,1,1,0,0,15056,7.0,18484,226,44,777,742,22.6,1505.6,23,5,1,1,4,0,1,0,1,0,14279,7.0,17742,234,51,-777,-742,23.4,1427.9
4439587692,1,19,1,1,8,4,5,1,1,0,1,18355,7.0,18790,218,54,2756,1683,21.8,1835.5,13,5,0,4,8,5,0,0,0,0,15599,6.8,17107,200,57,-2756,-1683,20.0,1559.9
4522475843,1,11,0,1,3,5,3,2,1,1,0,15562,6.8,16991,222,52,-1176,-1838,22.2,1556.2,16,2,0,5,3,9,0,0,0,0,16738,7.0,18829,201,68,1176,1838,20.1,1673.8
4471439169,1,19,2,1,9,4,13,0,0,0,0,18369,7.2,19417,210,56,3269,2404,21.0,1836.9,17,2,0,4,9,1,1,1,0,0,15100,6.8,17013,213,52,-3269,-2404,21.3,1510.0
4527658739,1,16,3,0,5,7,6,1,0,1,2,18075,7.2,19324,233,60,600,289,23.3,1807.5,37,4,1,7,5,6,1,1,0,0,17475,7.0,19035,224,63,-600,-289,22.4,1747.5
4505177490,1,63,2,0,8,4,11,1,1,0,0,16911,7.2,19106,217,53,2265,2392,21.7,1691.1,33,0,1,4,8,4,0,0,0,0,14646,6.8,16714,178,55,-2265,-2392,17.8,1464.6
4489475573,1,13,4,1,11,11,14,0,0,0,0,18795,7.4,19236,231,43,733,675,23.1,1879.5,127,3,0,11,11,11,1,1,0,0,18062,7.0,18561,213,32,-733,-675,21.3,1806.2
4489951140,0,16,0,1,7,8,7,1,1,0,0,16938,7.0,17857,222,49,206,-460,22.2,1693.8,14,1,0,8,7,6,0,0,0,0,16732,7.0,18317,215,43,-206,460,21.5,1673.2
4481739224,1,19,5,0,6,6,9,0,0,0,0,16740,7.0,19237,238,54,218,1085,23.8,1674.0,18,4,1,6,6,8,1,1,0,0,16522,7.0,18152,229,54,-218,-1085,22.9,1652.2
4521454203,0,54,4,0,3,5,5,0,0,0,0,15238,6.8,16831,209,40,-1314,-1498,20.9,1523.8,17,1,1,5,3,6,0,0,0,0,16552,6.8,18329,226,63,1314,1498,22.6,1655.2
4515202068,1,35,2,1,4,4,4,0,0,0,0,15686,7.0,18036,206,52,126,290,20.6,1568.6,14,3,0,4,4,6,0,0,0,0,15560,6.8,17746,224,48,-126,-290,22.4,1556.0
4437780946,0,17,5,0,6,6,2,0,0,0,0,15196,6.8,18612,209,52,-1240,-76,20.9,1519.6,13,2,1,6,6,6,1,1,0,0,16436,7.0,18688,210,68,1240,76,21.0,1643.6
4515376975,1,11,3,0,4,6,5,1,0,1,0,16697,7.0,19148,233,69,601,-303,23.3,1669.7,42,5,1,6,4,9,1,1,0,0,16096,7.2,19451,230,53,-601,303,23.0,1609.6
4517987406,0,122,1,0,3,2,4,1,1,0,0,15033,6.8,18279,211,59,6,205,21.1,1503.3,107,2,1,2,3,2,0,0,0,0,15027,7.2,18074,221,57,-6,-205,22.1,1502.7
4516959176,0,18,1,0,7,8,9,0,0,0,0,15903,6.8,17263,189,40,-1831,-2604,18.9,1590.3,14,2,1,8,7,11,2,1,1,0,17734,7.2,19867,226,72,1831,2604,22.6,1773.4
4481320434,1,22,3,1,9,1,12,0,0,0,0,18681,7.4,20293,249,59,5492,4505,24.9,1868.1,12,0,0,1,9,1,1,0,1,0,13189,6.4,15788,181,48,-5492,-4505,18.1,1318.9
4480515524,0,20,3,1,5,5,8,0,0,0,0,16321,7.4,19044,227,52,120,-497,22.7,1632.1,33,2,0,5,5,4,1,1,0,0,16201,7.4,19541,216,64,-120,497,21.6,1620.1
4519133834,0,16,2,0,6,16,6,1,1,0,0,14999,6.4,15530,192,44,-6027,-3955,19.2,1499.9,18,4,1,16,6,24,0,0,0,0,21026,7.4,19485,228,52,6027,3955,22.8,2102.6
4521437370,0,16,1,1,2,5,1,0,0,0,0,14819,7.0,17986,223,63,-930,-594,22.3,1481.9,18,2,0,5,2,3,2,1,1,0,15749,6.8,18580,210,52,930,594,21.0,1574.9
4522146436,1,28,0,0,12,8,11,0,0,0,0,18444,7.2,19294,196,40,1903,2160,19.6,1844.4,13,4,1,8,12,4,1,1,0,0,16541,6.6,17134,173,32,-1903,-2160,17.3,1654.1
4513528910,0,20,5,0,5,4,4,0,0,0,0,15960,7.2,18478,232,64,782,1903,23.2,1596.0,16,4,1,4,5,5,1,1,0,0,15178,6.4,16575,211,43,-782,-1903,21.1,1517.8
4525777991,0,17,1,1,4,6,4,0,0,0,0,15005,6.8,17143,213,47,-1022,-1253,21.3,1500.5,12,2,0,6,4,7,2,1,1,0,16027,7.0,18396,230,43,1022,1253,23.0,1602.7
4524935844,0,17,4,0,2,10,3,1,0,1,0,14593,6.6,16673,199,53,-4019,-2008,19.9,1459.3,17,3,1,10,2,14,1,1,0,0,18612,7.0,18681,232,43,4019,2008,23.2,1861.2
4521225738,0,48,3,0,2,2,3,1,0,1,0,15714,7.0,19458,243,68,821,2119,24.3,1571.4,53,15,1,2,2,3,1,1,0,0,14893,6.8,17339,226,56,-821,-2119,22.6,1489.3
4512164291,1,24,1,1,12,4,13,1,1,0,0,18552,6.6,17072,207,44,4845,2789,20.7,1855.2,13,3,0,4,12,4,0,0,0,0,13707,6.0,14283,183,30,-4845,-2789,18.3,1370.7
4519300992,1,12,7,1,5,3,5,1,0,1,0,15740,7.0,17908,220,48,1154,971,22.0,1574.0,18,1,0,3,5,3,1,1,0,0,14586,6.8,16937,225,56,-1154,-971,22.5,1458.6
4515453856,1,17,3,0,4,3,3,1,0,1,0,15227,7.0,18442,203,60,-513,992,20.3,1522.7,38,3,1,3,4,4,0,0,0,0,15740,7.0,17450,226,57,513,-992,22.6,1574.0
4524132104,0,20,3,0,6,10,8,0,0,0,0,16544,6.8,16885,223,56,-999,-955,22.3,1654.4,20,4,1,10,6,9,1,1,0,0,17543,6.8,17840,221,52,999,955,22.1,1754.3
4470759747,1,39,3,0,8,8,11,0,0,0,0,17706,6.8,18475,231,35,216,1250,23.1,1770.6,17,4,1,8,8,7,0,0,0,0,17490,6.8,17225,204,53,-216,-1250,20.4,1749.0
4450881054,1,16,4,1,8,3,9,1,1,0,0,17636,7.4,19295,249,51,2578,1160,24.9,1763.6,15,1,0,3,8,1,1,0,1,0,15058,7.0,18135,232,56,-2578,-1160,23.2,1505.8
4498735941,0,14,1,0,7,8,8,1,0,1,0,17127,7.0,17974,243,45,-373,-212,24.3,1712.7,19,2,1,8,7,10,1,1,0,0,17500,7.0,18186,229,47,373,212,22.9,1750.0
4518611921,0,49,3,0,4,10,7,0,0,0,0,14755,6.2,15569,213,39,-4095,-1033,21.3,1475.5,15,0,1,10,4,19,1,1,0,0,18850,6.6,16602,199,56,4095,1033,19.9,1885.0
4522063947,0,15,2,0,3,9,3,1,1,0,0,15877,6.8,17848,234,50,-1232,-659,23.4,1587.7,15,2,1,9,3,7,0,0,0,0,17109,7.0,18507,221,37,1232,659,22.1,1710.9
4458373823,1,17,5,1,3,0,0,1,1,0,0,15578,7.4,19730,249,64,611,1554,24.9,1557.8,14,1,0,0,3,0,0,0,0,0,14967,6.8,18176,245,59,-611,-1554,24.5,1496.7
4467276496,1,36,1,1,5,5,8,0,0,0,0,16192,6.8,18197,209,60,1056,-182,20.9,1619.2,11,1,0,5,5,4,1,1,0,0,15136,7.0,18379,185,46,-1056,182,18.5,1513.6
4503939692,0,13,4,0,5,3,9,1,1,0,0,16555,7.2,19152,252,52,659,405,25.2,1655.5,15,1,1,3,5,3,1,0,1,0,15896,7.0,18747,238,57,-659,-405,23.8,1589.6
4504287610,0,37,1,1,4,8,5,0,0,0,0,15168,6.8,17149,201,48,-2626,-1992,20.1,1516.8,11,1,0,8,4,7,0,0,0,0,17794,7.2,19141,254,52,2626,1992,25.4,1779.4
4516106075,0,14,4,0,3,16,5,1,0,1,0,14511,6.2,14800,158,59,-6887,-5573,15.8,1451.1,38,2,1,16,3,19,1,1,0,0,21398,7.4,20373,248,57,6887,5573,24.8,2139.8
4519701142,0,14,4,0,2,6,3,1,1,0,0,15471,7.2,18538,228,65,-814,1199,22.8,1547.1,19,4,1,6,2,10,0,0,0,0,16285,6.8,17339,225,47,814,-1199,22.5,1628.5
4522672364,0,17,4,1,4,7,4,1,1,0,0,15346,6.6,16812,230,48,-973,-1012,23.0,1534.6,21,3,0,7,4,6,0,0,0,0,16319,6.8,17824,178,64,973,1012,17.8,1631.9
4526265096,1,15,2,1,9,6,5,1,0,1,0,16994,7.6,19700,225,40,446,2153,22.5,1699.4,14,2,0,6,9,5,1,1,0,0,16548,6.8,17547,234,42,-446,-2153,23.4,1654.8
4521925963,0,19,3,0,10,6,16,0,0,0,0,18080,7.0,18120,219,30,1998,572,21.9,1808.0,16,3,1,6,10,8,0,0,0,0,16082,6.6,17548,225,39,-1998,-572,22.5,1608.2
4521401653,0,12,3,0,4,9,4,0,0,0,0,15944,7.0,17805,201,71,-2600,-1587,20.1,1594.4,12,1,1,9,4,13,1,1,0,0,18544,7.2,19392,251,53,2600,1587,25.1,1854.4
4519801984,0,18,1,1,7,7,6,1,1,0,0,15927,6.6,15756,192,44,-2390,-2971,19.2,1592.7,13,2,0,7,7,13,0,0,0,0,18317,7.2,18727,219,70,2390,2971,21.9,1831.7
4522842470,1,16,3,1,5,5,7,0,0,0,0,15273,6.8,16349,189,55,15,-2108,18.9,1527.3,24,3,0,5,5,6,1,1,0,0,15258,7.0,18457,216,54,-15,2108,21.6,1525.8
4520910762,1,14,1,1,3,3,3,1,1,0,0,16769,7.2,19760,257,76,1316,1233,25.7,1676.9,17,2,0,3,3,4,0,0,0,0,15453,7.2,18527,241,53,-1316,-1233,24.1,1545.3
4508876664,1,17,2,1,8,1,5,1,1,0,2,19820,7.2,19369,247,63,6883,5337,24.7,1982.0,13,1,0,1,8,1,1,0,1,0,12937,6.0,14032,179,37,-6883,-5337,17.9,1293.7
4486943775,1,13,2,1,16,5,16,1,0,1,0,20380,7.2,20228,230,36,5330,4040,23.0,2038.0,18,2,0,5,16,3,1,1,0,0,15050,6.6,16188,173,44,-5330,-4040,17.3,1505.0
4492730038,0,19,4,1,3,5,6,0,0,0,0,15834,6.8,18088,228,56,-191,-182,22.8,1583.4,145,5,0,5,3,6,1,1,0,0,16025,7.2,18270,208,52,191,182,20.8,1602.5
4499534463,1,82,2,1,10,5,9,2,1,1,0,18408,7.4,19955,208,73,1917,1186,20.8,1840.8,16,3,0,5,10,4,0,0,0,0,16491,7.0,18769,211,41,-1917,-1186,21.1,1649.1
4526405689,1,12,2,1,7,2,8,0,0,0,0,17479,7.0,18923,246,41,2305,482,24.6,1747.9,16,1,0,2,7,0,2,1,1,0,15174,7.2,18441,226,72,-2305,-482,22.6,1517.4
4524941722,0,14,1,0,4,14,2,1,0,1,0,14476,6.4,15711,180,28,-3638,-1582,18.0,1447.6,61,0,1,14,4,13,0,0,0,0,18114,7.0,17293,189,40,3638,1582,18.9,1811.4
4522528063,1,17,2,0,4,1,4,0,0,0,0,16654,7.2,19392,255,59,1856,1530,25.5,1665.4,16,1,1,1,4,1,2,1,1,0,14798,6.8,17862,244,48,-1856,-1530,24.4,1479.8
4469886384,0,40,1,0,1,7,2,0,0,0,0,13998,6.6,17086,207,55,-5086,-3284,20.7,1399.8,11,5,1,7,1,8,1,1,0,0,19084,7.6,20370,258,66,5086,3284,25.8,1908.4
4441849412,0,17,1,0,4,5,4,0,0,0,0,15218,7.0,19074,203,52,-1911,-1211,20.3,1521.8,15,1,1,5,4,7,2,1,1,0,17129,7.4,20285,250,68,1911,1211,25.0,1712.9
4522607227,0,17,7,0,4,7,4,0,0,0,0,16387,7.2,18488,235,56,149,210,23.5,1638.7,44,4,1,7,4,9,1,1,0,0,16238,6.8,18278,202,44,-149,-210,20.2,1623.8
4513848861,0,15,4,0,10,8,16,0,0,0,0,18917,7.2,18476,210,49,773,1125,21.0,1891.7,15,2,1,8,10,11,1,1,0,0,18144,6.6,17351,207,65,-773,-1125,20.7,1814.4
4520618648,0,18,3,1,2,9,0,1,0,1,0,14712,6.6,17001,230,63,-3226,-2335,23.0,1471.2,13,3,0,9,2,9,1,1,0,0,17938,7.2,19336,237,52,3226,2335,23.7,1793.8
4513950311,1,15,0,0,6,5,6,1,0,1,0,16107,7.0,17538,213,56,-456,-1135,21.3,1610.7,14,1,1,5,6,5,1,1,0,0,16563,7.0,18673,203,56,456,1135,20.3,1656.3
4515480447,1,15,0,0,6,6,5,0,0,0,0,16507,7.0,18941,216,65,479,350,21.6,1650.7,39,1,1,6,6,6,0,0,0,0,16028,7.2,18591,212,52,-479,-350,21.2,1602.8
4449209158,0,17,5,1,10,5,9,0,0,0,0,17327,7.2,18807,220,30,1291,20,22.0,1732.7,82,2,0,5,10,6,1,1,0,0,16036,7.2,18787,210,63,-1291,-20,21.0,1603.6
4524116491,1,12,2,0,5,9,8,0,0,0,0,16095,6.8,17192,222,50,-1905,-2185,22.2,1609.5,13,0,1,9,5,12,0,0,0,0,18000,7.2,19377,217,64,1905,2185,21.7,1800.0
4518707192,1,36,5,1,8,3,10,1,1,0,0,17756,7.2,18394,231,43,2510,758,23.1,1775.6,13,2,0,3,8,3,0,0,0,0,15246,6.8,17636,218,68,-2510,-758,21.8,1524.6
4484040931,1,74,0,0,7,7,5,2,1,1,0,18333,6.8,18853,229,64,1665,1578,22.9,1833.3,13,1,1,7,7,15,0,0,0,0,16668,6.8,17275,181,56,-1665,-1578,18.1,1666.8
4517481803,1,15,3,1,7,5,8,0,0,0,0,17134,7.0,19465,207,60,408,742,20.7,1713.4,16,2,0,5,7,4,1,1,0,0,16726,7.2,18723,236,56,-408,-742,23.6,1672.6
4511678140,1,16,2,1,7,9,10,1,0,1,1,19036,7.2,19444,248,60,2346,751,24.8,1903.6,37,1,0,9,7,14,1,1,0,0,16690,7.4,18693,197,53,-2346,-751,19.7,1669.0
4512991895,1,20,2,1,4,4,2,0,0,0,0,15856,7.0,19023,248,66,-82,745,24.8,1585.6,17,4,0,4,4,4,1,1,0,0,15938,7.0,18278,254,51,82,-745,25.4,1593.8
4465402060,0,14,1,0,7,5,10,0,0,0,0,16509,7.0,18241,202,52,373,-1568,20.2,1650.9,14,2,1,5,7,2,1,1,0,0,16136,7.2,19809,224,76,-373,1568,22.4,1613.6
4507906243,1,17,3,1,6,5,6,0,0,0,0,16793,7.0,19426,233,62,463,275,23.3,1679.3,16,4,0,5,6,7,1,1,0,0,16330,7.4,19151,224,62,-463,-275,22.4,1633.0
4460835266,1,16,2,0,9,7,15,1,1,0,0,17088,7.0,17650,179,40,262,-229,17.9,1708.8,16,3,1,7,9,9,0,0,0,0,16826,7.0,17879,222,56,-262,229,22.2,1682.6
4452269008,0,11,0,1,7,12,12,0,0,0,0,16880,7.0,17307,216,43,-2125,-3115,21.6,1688.0,14,1,0,12,7,12,1,0,1,0,19005,7.4,20422,221,33,2125,3115,22.1,1900.5
4476935585,1,18,2,1,5,8,5,0,0,0,0,16616,6.6,17294,218,40,-827,-981,21.8,1661.6,16,2,0,8,5,11,0,0,0,0,17443,6.8,18275,243,40,827,981,24.3,1744.3
4514548275,1,20,4,1,7,3,8,2,1,1,0,17507,7.2,19641,250,64,2790,3073,25.0,1750.7,169,2,0,3,7,3,0,0,0,0,14717,6.6,16568,209,47,-2790,-3073,20.9,1471.7
4424690853,1,14,0,1,7,8,6,0,0,0,0,17088,7.2,18459,219,40,-788,151,21.9,1708.8,13,2,0,8,7,5,2,1,1,0,17876,7.2,18308,226,64,788,-151,22.6,1787.6
4477684980,1,18,5,1,6,8,6,0,0,0,0,17210,7.0,18131,220,72,1091,605,22.0,1721.0,51,3,0,8,6,10,0,0,0,0,16119,7.0,17526,178,32,-1091,-605,17.8,1611.9
4521425528,0,15,3,1,7,11,9,1,1,0,0,15363,6.2,15411,171,52,-2151,-852,17.1,1536.3,16,1,0,11,7,9,0,0,0,0,17514,6.4,16263,199,43,2151,852,19.9,1751.4
4523093553,1,17,3,1,9,4,8,1,1,0,0,18646,7.6,19823,253,43,3767,3277,25.3,1864.6,11,2,0,4,9,6,0,0,0,0,14879,6.6,16546,195,36,-3767,-3277,19.5,1487.9
4490906138,0,148,3,0,8,4,10,0,0,0,0,16600,7.2,18932,192,52,1627,1723,19.2,1660.0,16,2,1,4,8,2,1,1,0,0,14973,6.6,17209,194,64,-1627,-1723,19.4,1497.3
4518094361,0,15,1,0,6,10,7,0,0,0,0,14978,6.6,16243,147,40,-4413,-1993,14.7,1497.8,20,4,1,10,6,16,2,1,1,1,19391,7.0,18236,237,55,4413,1993,23.7,1939.1
4515468378,1,15,1,0,2,10,1,0,0,0,0,13711,6.2,15114,180,48,-4331,-3757,18.0,1371.1,23,0,1,10,2,12,2,1,1,0,18042,7.2,18871,216,71,4331,3757,21.6,1804.2
4516052882,0,12,4,1,7,11,7,0,0,0,0,15418,6.4,15315,203,31,-3531,-3889,20.3,1541.8,18,4,0,11,7,15,2,1,1,0,18949,7.4,19204,215,48,3531,3889,21.5,1894.9
4510527608,1,37,5,1,11,6,13,1,1,0,0,18520,7.2,18859,204,48,2413,2181,20.4,1852.0,18,0,0,6,11,8,0,0,0,0,16107,6.6,16678,206,48,-2413,-2181,20.6,1610.7
4522035012,1,16,4,1,6,5,2,1,0,1,0,16565,7.0,17877,214,51,824,521,21.4,1656.5,15,4,0,5,6,2,1,1,0,0,15741,6.8,17356,212,45,-824,-521,21.2,1574.1
4491680252,1,16,4,0,11,13,6,0,0,0,0,17984,7.0,18165,178,50,-1348,105,17.8,1798.4,19,2,1,13,11,10,1,1,0,0,19332,6.8,18060,210,50,1348,-105,21.0,1933.2
4436824730,1,14,2,0,2,6,2,0,0,0,0,14720,7.2,18456,246,46,-2381,-1122,24.6,1472.0,13,1,1,6,2,3,1,0,1,0,17101,7.0,19578,237,54,2381,1122,23.7,1710.1
4513373886,1,17,1,1,4,5,2,0,0,0,0,15226,6.8,17774,168,67,-1667,-654,16.8,1522.6,16,0,0,5,4,6,0,0,0,0,16893,6.8,18428,227,55,1667,654,22.7,1689.3
4527067159,1,24,3,1,5,1,5,1,0,1,0,17170,7.2,19662,258,48,2695,1696,25.8,1717.0,12,2,0,1,5,2,1,1,0,0,14475,6.8,17966,233,69,-2695,-1696,23.3,1447.5
4457462757,0,17,3,1,8,4,15,1,1,0,1,18357,7.2,18461,228,40,2757,970,22.8,1835.7,14,3,0,4,8,3,1,0,1,0,15600,6.8,17491,209,60,-2757,-970,20.9,1560.0
4518050280,1,15,6,0,4,4,4,0,0,0,0,15506,6.6,17801,229,50,-154,663,22.9,1550.6,19,2,1,4,4,7,1,1,0,0,15660,6.6,17138,222,44,154,-663,22.2,1566.0
4513103663,0,14,2,0,4,9,4,0,0,0,0,14743,6.4,15965,197,50,-3465,-3351,19.7,1474.3,20,3,1,9,4,10,1,1,0,0,18208,7.4,19316,224,74,3465,3351,22.4,1820.8
4523920430,0,14,2,1,2,6,0,0,0,0,0,14333,6.8,16812,223,56,-1636,-1396,22.3,1433.3,16,4,0,6,2,5,1,1,0,0,15969,6.8,18208,223,52,1636,1396,22.3,1596.9
4458702644,0,14,1,1,4,5,3,0,0,0,0,14682,6.6,17105,199,50,-1827,-2059,19.9,1468.2,17,1,0,5,4,5,0,0,0,0,16509,7.4,19164,235,48,1827,2059,23.5,1650.9
4497782675,0,13,2,0,2,3,2,0,0,0,0,14211,6.8,17253,215,41,-1807,-2118,21.5,1421.1,62,2,1,3,2,1,1,1,0,0,16018,7.2,19371,252,75,1807,2118,25.2,1601.8
4465328511,1,18,4,0,4,3,4,1,1,0,0,15181,7.0,17084,216,49,911,449,21.6,1518.1,17,2,1,3,4,4,0,0,0,0,14270,6.8,16635,223,42,-911,-449,22.3,1427.0
4500690189,0,17,2,1,4,6,2,0,0,0,0,15293,6.8,17871,204,56,-1306,-998,20.4,1529.3,18,3,0,6,4,9,2,1,1,0,16599,7.0,18869,221,52,1306,998,22.1,1659.9
4525145035,0,12,1,1,6,8,9,0,0,0,0,16480,6.6,17339,226,48,-1726,63,22.6,1648.0,18,2,0,8,6,9,1,0,1,1,18206,6.8,17276,229,26,1726,-63,22.9,1820.6
4519057052,0,51,2,1,4,4,5,1,1,0,0,15059,6.8,17260,196,60,-345,-715,19.6,1505.9,36,11,0,4,4,2,0,0,0,0,15404,6.6,17975,237,52,345,715,23.7,1540.4
4479811257,1,26,4,0,5,10,8,0,0,0,0,15710,6.6,16731,205,46,-3731,-1458,20.5,1571.0,16,3,1,10,5,11,1,1,0,0,19441,7.2,18189,230,51,3731,1458,23.0,1944.1
4445105963,1,13,2,1,10,3,12,2,1,1,0,18851,7.4,19537,230,52,4064,2564,23.0,1885.1,11,3,0,3,10,5,0,0,0,0,14787,6.8,16973,195,40,-4064,-2564,19.5,1478.7
4522561277,0,16,1,1,3,2,1,0,0,0,0,15360,7.0,18355,220,55,960,39,22.0,1536.0,16,3,0,2,3,2,0,0,0,0,14400,6.8,18316,206,52,-960,-39,20.6,1440.0
4502754942,0,58,3,0,4,7,2,0,0,0,0,15042,7.0,17849,207,55,-2075,-738,20.7,1504.2,20,12,1,7,4,5,2,1,1,0,17117,7.0,18587,236,40,2075,738,23.6,1711.7
4472468889,0,17,3,1,8,4,10,1,1,0,0,17836,7.4,19239,235,67,840,145,23.5,1783.6,16,2,0,4,8,3,0,0,0,0,16996,7.0,19094,263,68,-840,-145,26.3,1699.6
4452899588,1,13,3,1,9,2,8,1,1,0,0,17580,7.2,19527,210,46,3391,2897,21.0,1758.0,14,2,0,2,9,1,0,0,0,0,14189,6.6,16630,195,64,-3391,-2897,19.5,1418.9
4521530707,1,8,1,1,9,8,11,1,1,0,0,17049,6.8,17343,180,49,147,-1425,18.0,1704.9,13,1,0,8,9,8,0,0,0,0,16902,7.2,18768,193,63,-147,1425,19.3,1690.2
4463081486,0,12,3,1,7,4,8,0,0,0,0,17653,7.0,18461,231,59,2962,2430,23.1,1765.3,18,1,0,4,7,5,0,0,0,0,14691,6.4,16031,210,31,-2962,-2430,21.0,1469.1
4526039823,0,14,4,1,5,6,5,1,1,0,0,15414,6.8,17454,208,48,-599,-288,20.8,1541.4,16,1,0,6,5,5,0,0,0,0,16013,6.8,17742,218,50,599,288,21.8,1601.3
4475629470,0,14,3,0,4,7,4,0,0,0,0,14956,6.6,16196,198,41,-2020,-2716,19.8,1495.6,18,2,1,7,4,2,0,0,0,0,16976,7.2,18912,246,55,2020,2716,24.6,1697.6
4517186404,1,16,2,1,10,9,9,1,1,0,0,19219,7.0,18673,229,50,2346,1776,22.9,1921.9,9,0,0,9,10,10,0,0,0,0,16873,6.8,16897,177,35,-2346,-1776,17.7,1687.3
4453137700,1,15,2,0,8,17,7,0,0,0,0,17556,6.6,17097,192,44,-2089,-835,19.2,1755.6,16,3,1,17,8,16,0,0,0,0,19645,6.8,17932,186,36,2089,835,18.6,1964.5
4497518760,0,16,2,1,6,4,2,1,1,0,0,16803,7.0,18812,255,61,1189,1151,25.5,1680.3,19,2,0,4,6,5,0,0,0,0,15614,7.2,17661,206,59,-1189,-1151,20.6,1561.4
4476242451,1,13,1,0,4,4,1,0,0,0,0,15169,6.8,18276,208,70,585,2037,20.8,1516.9,57,4,1,4,4,5,0,0,0,0,14584,6.4,16239,196,43,-585,-2037,19.6,1458.4
4500073526,1,14,2,0,7,5,5,0,0,0,0,17303,7.0,18048,216,43,3111,1587,21.6,1730.3,13,4,1,5,7,2,1,1,0,0,14192,6.6,16461,165,48,-3111,-1587,16.5,1419.2
4508869130,0,15,1,0,8,8,5,0,0,0,0,17188,6.6,17474,229,35,809,645,22.9,1718.8,11,1,1,8,8,10,1,0,1,0,16379,6.6,16829,191,47,-809,-645,19.1,1637.9
4517512393,1,14,4,1,9,8,5,1,1,0,0,15852,6.8,17330,194,35,-1918,-1739,19.4,1585.2,16,3,0,8,9,10,1,0,1,0,17770,7.2,19069,213,66,1918,1739,21.3,1777.0
4469208357,1,72,1,0,9,9,5,0,0,0,0,17999,7.2,19369,227,43,1128,1720,22.7,1799.9,14,3,1,9,9,12,1,1,0,0,16871,7.0,17649,212,40,-1128,-1720,21.2,1687.1
4514842699,1,16,2,1,6,0,6,1,1,0,0,15318,7.0,17999,191,58,1125,299,19.1,1531.8,17,1,0,0,6,0,0,0,0,0,14193,7.0,17700,251,40,-1125,-299,25.1,1419.3
4487193298,0,15,7,1,7,8,8,0,0,0,0,16302,6.2,15434,183,37,-592,-2438,18.3,1630.2,18,4,0,8,7,10,0,0,0,0,16894,6.8,17872,216,50,592,2438,21.6,1689.4
4486259038,0,30,5,1,7,9,12,0,0,0,0,16242,6.4,16365,209,40,-2055,-2649,20.9,1624.2,21,6,0,9,7,12,0,0,0,0,18297,7.2,19014,202,56,2055,2649,20.2,1829.7
4524440792,0,15,4,0,3,6,4,0,0,0,0,14879,6.6,16931,217,35,-1775,-722,21.7,1487.9,35,3,1,6,3,4,0,0,0,0,16654,6.8,17653,215,56,1775,722,21.5,1665.4
4518366913,1,18,2,1,8,3,6,1,1,0,0,17243,6.8,18171,231,52,2803,1638,23.1,1724.3,15,6,0,3,8,5,0,0,0,0,14440,6.6,16533,186,57,-2803,-1638,18.6,1444.0
4508799837,1,16,1,0,6,4,6,1,0,1,1,18625,7.4,19348,240,50,3163,1231,24.0,1862.5,16,2,1,4,6,6,1,1,0,0,15462,7.0,18117,230,46,-3163,-1231,23.0,1546.2
4489154940,1,18,8,0,9,7,12,1,1,0,0,17896,6.8,18474,215,58,1076,1288,21.5,1789.6,84,6,1,7,9,10,0,0,0,0,16820,6.8,17186,222,40,-1076,-1288,22.2,1682.0
4520617966,0,18,0,0,1,6,0,0,0,0,0,13517,6.2,16278,222,44,-3700,-2130,22.2,1351.7,18,2,1,6,1,10,1,1,0,0,17217,7.2,18408,247,60,3700,2130,24.7,1721.7
4450008187,0,20,2,1,6,8,3,0,0,0,0,16386,7.0,18401,207,62,-610,514,20.7,1638.6,14,4,0,8,6,11,1,1,0,0,16996,7.0,17887,211,36,610,-514,21.1,1699.6
4459775765,0,15,2,0,3,4,3,0,0,0,0,14642,6.6,16219,229,36,-744,-1255,22.9,1464.2,17,1,1,4,3,4,2,1,1,0,15386,6.8,17474,212,52,744,1255,21.2,1538.6
4527477768,1,12,2,0,11,8,13,0,0,0,0,18420,7.0,19041,218,42,1472,1838,21.8,1842.0,18,2,1,8,11,9,0,0,0,0,16948,6.8,17203,209,41,-1472,-1838,20.9,1694.8
4524501044,1,138,2,1,3,3,4,1,1,0,0,15048,6.8,17795,223,52,-394,-1174,22.3,1504.8,15,2,0,3,3,3,0,0,0,0,15442,7.2,18969,253,47,394,1174,25.3,1544.2
4518959670,0,15,0,0,9,5,15,1,1,0,0,16888,6.8,17236,200,48,993,783,20.0,1688.8,13,1,1,5,9,7,0,0,0,0,15895,6.4,16453,206,48,-993,-783,20.6,1589.5
4526763714,0,16,2,1,5,9,3,1,1,0,0,15129,6.6,16869,204,44,-1417,860,20.4,1512.9,15,1,0,9,5,14,0,0,0,0,16546,6.6,16009,182,36,1417,-860,18.2,1654.6
4462131057,1,17,5,1,16,5,25,1,1,0,0,20996,7.2,19123,218,47,6476,4261,21.8,2099.6,13,3,0,5,16,8,0,0,0,0,14520,6.2,14862,147,41,-6476,-4261,14.7,1452.0
4519000412,0,40,2,0,1,7,0,0,0,0,0,12300,6.0,14201,171,30,-5394,-5037,17.1,1230.0,18,16,1,7,1,8,2,1,1,0,17694,7.2,19238,246,54,5394,5037,24.6,1769.4
4470317561,1,16,5,1,6,1,4,0,0,0,0,16656,7.4,18706,230,56,2082,1304,23.0,1665.6,32,3,0,1,6,3,1,1,0,0,14574,6.8,17402,213,68,-2082,-1304,21.3,1457.4
4523054451,1,12,1,1,5,4,3,1,1,0,0,15015,6.4,16819,184,47,-585,-809,18.4,1501.5,17,2,0,4,5,2,1,0,1,0,15600,6.8,17628,248,52,585,809,24.8,1560.0
4522574543,0,19,4,0,11,7,15,1,1,0,0,20007,7.0,19097,241,60,3774,4377,24.1,2000.7,13,4,1,7,11,9,0,0,0,0,16233,6.0,14720,184,28,-3774,-4377,18.4,1623.3
4508944628,0,14,3,1,2,5,3,1,1,0,0,15462,7.0,17729,249,66,-1176,-1499,24.9,1546.2,15,1,0,5,2,7,0,0,0,0,16638,7.2,19228,248,58,1176,1499,24.8,1663.8
4525196496,1,16,1,0,9,8,13,0,0,0,0,18562,7.0,18633,203,66,1911,1969,20.3,1856.2,13,4,1,8,9,12,1,1,0,0,16651,6.6,16664,206,48,-1911,-1969,20.6,1665.1
4511755420,1,15,2,0,3,4,4,0,0,0,0,14205,6.6,16546,203,40,-1115,178,20.3,1420.5,18,2,1,4,3,4,1,1,0,0,15320,6.6,16368,192,52,1115,-178,19.2,1532.0
4494539160,0,16,3,0,8,11,6,1,0,1,0,17693,7.2,19111,202,52,-384,-345,20.2,1769.3,16,6,1,11,8,10,1,1,0,0,18077,7.2,19456,199,37,384,345,19.9,1807.7
4526755207,1,19,2,1,5,4,8,1,1,0,0,15983,6.8,17134,219,50,544,-289,21.9,1598.3,13,5,0,4,5,6,0,0,0,0,15439,6.8,17423,218,49,-544,289,21.8,1543.9
4472632367,1,17,3,0,7,6,8,1,0,1,0,17882,7.2,19474,233,55,2689,1875,23.3,1788.2,13,2,1,6,7,5,0,0,0,0,15193,6.8,17599,218,32,-2689,-1875,21.8,1519.3
4514280719,1,11,3,0,10,6,8,1,0,1,0,18555,7.4,20361,246,52,2488,2722,24.6,1855.5,14,3,1,6,10,6,1,1,0,0,16067,6.8,17639,185,67,-2488,-2722,18.5,1606.7
4489796229,1,20,3,1,6,5,4,1,1,0,0,16130,6.8,17004,235,36,149,447,23.5,1613.0,15,7,0,5,6,3,0,0,0,0,15981,6.6,16557,241,40,-149,-447,24.1,1598.1
4495418857,1,17,2,0,6,7,7,0,0,0,0,17075,7.0,18491,234,44,1224,625,23.4,1707.5,18,2,1,7,6,4,2,1,1,0,15851,6.8,17866,221,48,-1224,-625,22.1,1585.1
4524558517,0,29,0,0,5,6,6,0,0,0,0,15693,6.8,17777,210,51,-486,-137,21.0,1569.3,35,1,1,6,5,5,1,1,0,0,16179,7.0,17914,216,52,486,137,21.6,1617.9
4463368363,1,18,1,1,8,5,7,2,1,1,0,18357,7.0,19718,269,56,3346,3707,26.9,1835.7,81,1,0,5,8,4,0,0,0,0,15011,6.6,16011,176,45,-3346,-3707,17.6,1501.1
4522317510,1,19,4,0,6,4,9,0,0,0,0,16317,6.8,16936,210,39,1163,-539,21.0,1631.7,19,4,1,4,6,1,1,1,0,0,15154,6.8,17475,241,32,-1163,539,24.1,1515.4
4495666281,1,16,2,1,6,9,5,1,1,0,0,17451,7.0,18484,249,59,-224,-1881,24.9,1745.1,16,2,0,9,6,10,0,0,0,0,17675,7.4,20365,205,38,224,1881,20.5,1767.5
4464319633,1,13,2,1,10,8,14,2,1,1,0,17893,7.0,17157,206,56,1181,-934,20.6,1789.3,13,2,0,8,10,6,0,0,0,0,16712,7.0,18091,182,47,-1181,934,18.2,1671.2
4489127821,0,15,0,0,4,7,3,1,0,1,0,15798,6.8,17608,225,52,-2289,-2259,22.5,1579.8,16,2,1,7,4,10,1,1,0,0,18087,7.4,19867,239,60,2289,2259,23.9,1808.7
4520606838,0,57,1,1,4,3,7,0,0,0,0,14565,6.4,16719,192,42,179,-417,19.2,1456.5,14,2,0,3,4,2,1,1,0,0,14386,6.6,17136,199,58,-179,417,19.9,1438.6
4478553958,1,19,3,1,5,5,10,1,0,1,0,15447,6.2,15691,194,44,-406,-1748,19.4,1544.7,16,1,0,5,5,6,0,0,0,0,15853,7.0,17439,219,50,406,1748,21.9,1585.3
4518711982,1,15,2,1,9,3,9,0,0,0,0,17438,7.0,18257,186,48,3018,1995,18.6,1743.8,19,1,0,3,9,3,0,0,0,0,14420,6.6,16262,222,39,-3018,-1995,22.2,1442.0
4496792553,1,16,3,0,8,7,13,0,0,0,0,16366,6.8,17010,196,34,-963,-457,19.6,1636.6,16,2,1,7,8,8,0,0,0,0,17329,7.0,17467,220,52,963,457,22.0,1732.9
4494973929,1,87,3,0,8,8,9,2,1,1,0,17940,7.4,19545,216,68,1340,1826,21.6,1794.0,16,3,1,8,8,4,0,0,0,0,16600,6.8,17719,219,48,-1340,-1826,21.9,1660.0
4501009376,0,17,3,0,3,7,1,0,0,0,0,14780,6.8,16972,215,61,-2568,-2314,21.5,1478.0,40,4,1,7,3,10,1,1,0,0,17348,7.2,19286,215,54,2568,2314,21.5,1734.8
4524940006,0,20,3,1,5,6,6,0,0,0,0,15768,6.8,17401,200,55,-450,-1721,20.0,1576.8,20,3,0,6,5,5,1,1,0,0,16218,7.4,19122,225,58,450,1721,22.5,1621.8
4515194519,0,16,2,1,3,2,5,1,1,0,0,14911,6.8,16715,228,44,-224,-1942,22.8,1491.1,16,3,0,2,3,2,0,0,0,0,15135,7.2,18657,248,64,224,1942,24.8,1513.5
4522545696,1,16,2,1,12,4,15,1,0,1,0,19000,7.0,18072,210,48,4181,1584,21.0,1900.0,15,2,0,4,12,4,0,0,0,0,14819,6.4,16488,193,45,-4181,-1584,19.3,1481.9
4494516149,0,37,3,0,4,7,4,1,0,1,0,16388,7.0,17168,220,50,-420,-1518,22.0,1638.8,14,4,1,7,4,10,0,0,0,0,16808,7.2,18686,239,37,420,1518,23.9,1680.8
4487456685,1,16,3,0,8,5,10,0,0,0,0,17536,7.2,19665,247,47,910,1269,24.7,1753.6,16,5,1,5,8,6,1,1,0,0,16626,7.0,18396,226,68,-910,-1269,22.6,1662.6
4522483901,1,16,5,1,7,2,11,1,1,0,0,16685,7.0,18048,216,40,2306,1659,21.6,1668.5,19,3,0,2,7,2,0,0,0,0,14379,6.6,16389,208,44,-2306,-1659,20.8,1437.9
4519169222,0,50,5,1,5,7,9,0,0,0,0,16190,7.0,17505,222,53,-1566,-1852,22.2,1619.0,18,2,0,7,5,6,1,1,0,0,17756,7.2,19357,258,62,1566,1852,25.8,1775.6
4423795870,1,17,4,0,5,7,6,0,0,0,0,15778,6.8,17304,235,40,-1829,-1429,23.5,1577.8,23,3,1,7,5,3,1,1,0,1,17607,6.8,18733,244,51,1829,1429,24.4,1760.7
4520736346,1,13,2,1,11,9,9,0,0,0,0,17795,7.4,18920,164,63,-274,304,16.4,1779.5,14,1,0,9,11,9,0,0,0,0,18069,7.0,18616,237,46,274,-304,23.7,1806.9
4517748263,1,13,5,1,6,5,3,0,0,0,0,16590,7.0,19180,228,43,1209,1099,22.8,1659.0,13,1,0,5,6,10,1,1,0,0,15381,7.0,18081,202,52,-1209,-1099,20.2,1538.1
4506971085,1,17,0,1,8,9,9,2,1,1,0,17030,6.8,17359,206,43,-493,-986,20.6,1703.0,15,4,0,9,8,13,0,0,0,0,17523,7.2,18345,186,44,493,986,18.6,1752.3
4514791683,0,14,14,0,3,7,4,1,0,1,0,15797,6.8,18289,226,64,-1234,26,22.6,1579.7,37,2,1,7,3,8,1,1,0,0,17031,7.0,18263,222,55,1234,-26,22.2,1703.1
4522798631,1,14,3,1,5,4,3,1,1,0,0,15943,7.4,19262,238,64,63,648,23.8,1594.3,16,1,0,4,5,5,0,0,0,0,15880,7.0,18614,210,64,-63,-648,21.0,1588.0
4526833069,1,17,2,0,3,7,3,0,0,0,0,14546,6.6,16662,200,32,-2560,-1275,20.0,1454.6,43,3,1,7,3,6,1,1,0,0,17106,7.0,17937,203,67,2560,1275,20.3,1710.6
4527648336,0,38,6,1,9,5,7,0,0,0,0,16940,7.2,18098,203,36,893,256,20.3,1694.0,19,16,0,5,9,5,1,1,0,0,16047,7.0,17842,228,48,-893,-256,22.8,1604.7
4441973762,1,15,3,1,13,9,13,1,1,0,1,21908,7.4,20909,227,84,4612,2877,22.7,2190.8,15,1,0,9,13,12,0,0,0,0,17296,7.0,18032,195,44,-4612,-2877,19.5,1729.6
4470773670,1,15,0,1,9,4,12,2,1,1,0,18048,7.0,19194,227,61,3414,1608,22.7,1804.8,51,2,0,4,9,1,0,0,0,0,14634,6.8,17586,237,28,-3414,-1608,23.7,1463.4
4519840104,1,18,4,1,7,3,6,0,0,0,1,18100,7.0,18030,197,48,2690,236,19.7,1810.0,15,3,0,3,7,3,1,0,1,0,15410,6.8,17794,211,60,-2690,-236,21.1,1541.0
4492581602,0,14,1,1,9,8,11,2,1,1,0,16839,7.0,17851,192,51,-125,-962,19.2,1683.9,16,3,0,8,9,5,0,0,0,0,16964,7.0,18813,211,58,125,962,21.1,1696.4
4498918077,1,14,2,1,3,7,2,0,0,0,0,14935,7.0,18365,198,59,-3469,-1687,19.8,1493.5,13,3,0,7,3,9,2,1,1,0,18404,7.2,20052,263,72,3469,1687,26.3,1840.4
4494270392,1,15,1,0,6,3,6,0,0,0,0,16746,7.0,17690,204,55,1860,1798,20.4,1674.6,15,1,1,3,6,5,0,0,0,0,14886,6.4,15892,225,38,-1860,-1798,22.5,1488.6
4474919614,0,13,1,1,3,3,4,0,0,0,0,15716,7.0,17405,241,56,-411,-2213,24.1,1571.6,14,3,0,3,3,1,1,1,0,0,16127,7.2,19618,246,72,411,2213,24.6,1612.7
4447981243,0,18,3,1,2,13,2,1,1,0,0,14368,6.8,16711,201,52,-5683,-5256,20.1,1436.8,19,5,0,13,2,13,0,0,0,0,20051,8.0,21967,270,49,5683,5256,27.0,2005.1
4513135937,1,16,2,1,9,3,10,1,1,0,0,18266,7.2,19178,254,54,3360,1693,25.4,1826.6,16,2,0,3,9,2,0,0,0,0,14906,6.8,17485,235,48,-3360,-1693,23.5,1490.6
4524702479,1,15,3,1,5,2,6,1,1,0,0,16225,6.8,17742,231,56,2430,2023,23.1,1622.5,16,1,0,2,5,2,0,0,0,0,13795,6.6,15719,179,52,-2430,-2023,17.9,1379.5
4526183369,1,22,4,1,10,8,17,1,1,0,0,18828,7.2,18186,197,53,2117,180,19.7,1882.8,16,4,0,8,10,8,1,0,1,0,16711,6.8,18006,209,47,-2117,-180,20.9,1671.1
4515904262,1,17,1,0,8,7,7,0,0,0,0,17908,7.2,19202,229,54,653,430,22.9,1790.8,12,2,1,7,8,9,1,1,0,0,17255,7.2,18772,247,46,-653,-430,24.7,1725.5
4522154425,0,37,6,1,2,7,4,0,0,0,0,15262,6.6,17524,232,50,-1033,-104,23.2,1526.2,55,7,0,7,2,10,1,1,0,0,16295,7.0,17628,211,59,1033,104,21.1,1629.5
4494408624,1,42,5,0,13,13,14,0,0,0,0,19580,7.0,18977,201,45,935,2197,20.1,1958.0,13,3,1,13,13,14,0,0,0,0,18645,6.6,16780,179,32,-935,-2197,17.9,1864.5
4506115923,1,15,2,1,5,6,4,1,1,0,0,16803,7.0,18053,251,57,1349,924,25.1,1680.3,15,3,0,6,5,6,0,0,0,0,15454,6.8,17129,182,33,-1349,-924,18.2,1545.4
4509495092,0,17,1,0,1,5,0,1,1,0,0,14004,6.4,16302,217,39,-1113,-1381,21.7,1400.4,10,2,1,5,1,5,0,0,0,0,15117,7.0,17683,212,32,1113,1381,21.2,1511.7
4516825345,0,13,0,1,7,8,7,0,0,0,0,16561,7.0,17480,201,60,-519,-643,20.1,1656.1,14,2,0,8,7,9,2,1,1,0,17080,7.0,18123,228,52,519,643,22.8,1708.0
4524963082,1,13,3,0,2,7,2,0,0,0,0,13825,6.6,15977,185,51,-2891,-3196,18.5,1382.5,16,0,1,7,2,7,0,0,0,0,16716,7.4,19173,229,53,2891,3196,22.9,1671.6
4446535819,1,21,2,1,6,3,10,0,0,0,0,16907,6.8,18072,165,56,1697,125,16.5,1690.7,14,5,0,3,6,1,1,1,0,0,15210,6.8,17947,242,50,-1697,-125,24.2,1521.0
4488986123,0,15,4,0,7,5,8,1,1,0,0,16787,6.8,17483,208,40,800,-237,20.8,1678.7,14,2,1,5,7,7,0,0,0,0,15987,6.8,17720,236,44,-800,237,23.6,1598.7
4506324067,1,19,5,0,4,3,8,1,1,0,0,15650,7.0,17837,224,51,-249,-1163,22.4,1565.0,15,2,1,3,4,3,1,0,1,0,15899,7.2,19000,254,58,249,1163,25.4,1589.9
4527457700,1,12,5,1,8,4,11,1,1,0,0,18320,7.0,18926,244,56,3461,1985,24.4,1832.0,20,3,0,4,8,2,0,0,0,0,14859,6.6,16941,217,36,-3461,-1985,21.7,1485.9
4507333323,1,22,2,0,8,5,12,1,1,0,0,17991,7.4,19538,219,60,2664,3273,21.9,1799.1,16,5,1,5,8,7,0,0,0,0,15327,6.6,16265,187,40,-2664,-3273,18.7,1532.7
4459614716,1,53,6,1,4,3,5,0,0,0,0,16441,7.0,18447,244,52,1254,400,24.4,1644.1,18,3,0,3,4,4,0,0,0,0,15187,6.8,18047,218,60,-1254,-400,21.8,1518.7
4469875556,0,18,2,0,3,4,1,0,0,0,0,14352,6.8,17455,222,44,-1241,-1045,22.2,1435.2,15,3,1,4,3,2,1,0,1,0,15593,6.8,18500,232,55,1241,1045,23.2,1559.3
4526492403,0,16,4,1,4,4,5,1,1,0,0,15596,6.8,18105,223,47,370,-66,22.3,1559.6,49,1,0,4,4,4,0,0,0,0,15226,7.0,18171,200,51,-370,66,20.0,1522.6
4526153369,1,26,3,1,10,2,10,1,0,1,0,17430,6.8,18040,210,42,3140,1824,21.0,1743.0,18,6,0,2,10,2,0,0,0,0,14290,6.8,16216,228,48,-3140,-1824,22.8,1429.0
4525851788,1,12,2,1,6,5,9,1,0,1,0,17025,6.8,17699,207,56,1128,-45,20.7,1702.5,17,1,0,5,6,4,1,1,0,0,15897,7.0,17744,226,52,-1128,45,22.6,1589.7
4526735110,0,16,1,0,5,6,3,2,1,1,0,16089,7.0,18217,227,63,-704,-1227,22.7,1608.9,39,4,1,6,5,4,0,0,0,0,16793,7.2,19444,237,56,704,1227,23.7,1679.3
4481698613,0,17,1,1,5,5,1,0,0,0,0,16109,7.2,19122,237,64,-1599,332,23.7,1610.9,13,2,0,5,5,3,2,1,1,1,17708,7.2,18790,248,60,1599,-332,24.8,1770.8
4494580681,1,24,2,1,12,2,13,1,1,0,0,19306,7.4,19450,206,72,5831,4588,20.6,1930.6,19,4,0,2,12,0,0,0,0,0,13475,6.4,14862,197,48,-5831,-4588,19.7,1347.5
4522384678,0,14,0,1,8,12,3,0,0,0,0,16729,6.4,16290,198,44,-1829,-1132,19.8,1672.9,14,2,0,12,8,16,1,1,0,0,18558,7.0,17422,202,40,1829,1132,20.2,1855.8
4512892156,0,18,4,1,6,5,7,0,0,0,0,16517,6.4,17161,219,49,1402,-566,21.9,1651.7,15,3,0,5,6,3,1,1,0,0,15115,7.0,17727,206,56,-1402,566,20.6,1511.5
4484773926,1,35,2,1,5,2,5,1,1,0,0,16214,7.2,18849,225,52,136,365,22.5,1621.4,13,2,0,2,5,2,1,0,1,1,16078,7.0,18484,236,56,-136,-365,23.6,1607.8
4522377959,0,15,0,0,10,5,14,0,0,0,0,17993,6.6,16834,222,36,2876,2805,22.2,1799.3,14,3,1,5,10,8,0,0,0,0,15117,6.0,14029,180,36,-2876,-2805,18.0,1511.7
4452155671,1,15,4,1,7,6,10,1,0,1,0,17363,7.0,18387,233,39,1449,521,23.3,1736.3,51,1,0,6,7,6,1,1,0,0,15914,7.0,17866,206,42,-1449,-521,20.6,1591.4
4520016243,1,14,3,0,12,2,18,1,1,0,0,19273,7.2,18465,226,60,5784,4755,22.6,1927.3,11,1,1,2,12,2,0,0,0,0,13489,6.0,13710,168,52,-5784,-4755,16.8,1348.9
4462678795,0,37,4,0,3,9,2,0,0,0,0,14272,6.0,15106,194,55,-3608,-4288,19.4,1427.2,15,4,1,9,3,4,0,0,0,0,17880,7.2,19394,259,47,3608,4288,25.9,1788.0
4472594509,0,14,4,0,3,8,1,0,0,0,0,15241,7.0,18179,252,44,-1514,-1033,25.2,1524.1,18,1,1,8,3,8,2,1,1,0,16755,7.4,19212,224,40,1514,1033,22.4,1675.5
4481763565,0,16,3,1,10,9,9,1,1,0,0,17098,6.8,17045,201,35,-635,-1011,20.1,1709.8,18,6,0,9,10,9,0,0,0,0,17733,7.2,18056,208,54,635,1011,20.8,1773.3
4521769978,0,17,2,0,4,6,2,0,0,0,0,15498,6.8,17805,228,32,-1953,-1854,22.8,1549.8,13,4,1,6,4,5,2,1,1,0,17451,7.4,19659,259,58,1953,1854,25.9,1745.1
4508455682,1,16,2,1,7,8,8,0,0,0,0,16712,6.8,16923,221,21,-609,-1114,22.1,1671.2,24,3,0,8,7,11,1,1,0,0,17321,6.8,18037,229,43,609,1114,22.9,1732.1
4523306081,0,15,3,0,8,12,11,0,0,0,0,17201,7.2,18755,207,30,-1817,-354,20.7,1720.1,55,3,1,12,8,13,1,1,0,0,19018,7.4,19109,201,46,1817,354,20.1,1901.8
4512800832,0,14,2,0,3,6,3,0,0,0,0,14901,6.8,16728,201,48,-1123,-976,20.1,1490.1,18,1,1,6,3,6,1,1,0,0,16024,6.8,17704,232,36,1123,976,23.2,1602.4
4491235821,1,17,3,1,13,3,14,1,1,0,1,20961,7.6,19939,225,74,6387,3453,22.5,2096.1,12,5,0,3,13,2,1,0,1,0,14574,6.6,16486,182,57,-6387,-3453,18.2,1457.4
4494693050,0,78,2,1,7,5,11,1,1,0,0,16844,6.8,18255,217,51,749,570,21.7,1684.4,15,2,0,5,7,8,0,0,0,0,16095,7.0,17685,233,44,-749,-570,23.3,1609.5
4493693106,0,16,2,0,4,11,3,0,0,0,0,14504,6.8,16897,191,40,-3926,-1387,19.1,1450.4,15,3,1,11,4,11,0,0,0,0,18430,6.8,18284,211,40,3926,1387,21.1,1843.0
4472245505,0,13,1,0,6,7,12,1,1,0,0,16942,7.2,17991,247,43,330,-308,24.7,1694.2,19,4,1,7,6,6,1,0,1,0,16612,7.0,18299,192,59,-330,308,19.2,1661.2
4524567025,0,15,2,1,10,3,17,1,1,0,0,18110,6.8,18193,193,60,2607,657,19.3,1811.0,15,1,0,3,10,5,0,0,0,0,15503,6.6,17536,236,56,-2607,-657,23.6,1550.3
4522447607,0,9,3,1,5,11,5,0,0,0,0,15946,6.8,16743,208,36,-2267,-2010,20.8,1594.6,18,3,0,11,5,14,1,1,0,0,18213,7.0,18753,227,48,2267,2010,22.7,1821.3
4521559243,1,13,1,1,7,0,8,0,0,0,0,17269,7.2,19988,244,52,3425,3823,24.4,1726.9,15,2,0,0,7,0,1,1,0,0,13844,6.6,16165,228,52,-3425,-3823,22.8,1384.4
4482189285,1,15,1,1,7,0,6,1,1,0,0,18039,7.2,18984,236,64,4991,3364,23.6,1803.9,13,0,0,0,7,0,0,0,0,0,13048,6.2,15620,193,44,-4991,-3364,19.3,1304.8
4509184155,1,17,0,0,2,5,3,0,0,0,0,15282,6.8,17428,243,52,-1665,-1607,24.3,1528.2,16,2,1,5,2,7,2,1,1,0,16947,7.2,19035,248,72,1665,1607,24.8,1694.7
4518710301,1,35,4,0,4,9,1,0,0,0,0,14621,7.0,17862,179,62,-3644,-1277,17.9,1462.1,15,0,1,9,4,12,1,1,0,0,18265,7.0,19139,243,44,3644,1277,24.3,1826.5
4518444031,0,16,5,1,10,8,12,1,1,0,0,17357,7.0,18388,191,59,-310,570,19.1,1735.7,27,2,0,8,10,9,1,0,1,0,17667,7.2,17818,194,56,310,-570,19.4,1766.7
4519070159,1,16,2,0,14,17,18,1,0,1,0,19025,6.8,16965,150,47,-524,-904,15.0,1902.5,13,4,1,17,14,9,1,1,0,0,19549,7.0,17869,185,60,524,904,18.5,1954.9
4514071420,1,13,3,1,12,8,18,1,1,0,0,18047,7.0,18071,202,44,679,-305,20.2,1804.7,12,4,0,8,12,7,1,0,1,0,17368,7.0,18376,206,44,-679,305,20.6,1736.8
4517559119,0,17,2,0,5,5,4,0,0,0,0,15750,6.8,16898,216,49,259,473,21.6,1575.0,38,4,1,5,5,6,0,0,0,0,15491,6.6,16425,200,43,-259,-473,20.0,1549.1
4475735084,1,21,6,0,7,4,11,0,0,0,0,17012,7.0,17924,226,35,1595,-63,22.6,1701.2,48,7,1,4,7,3,1,1,0,0,15417,6.8,17987,230,56,-1595,63,23.0,1541.7
4484715251,0,19,3,0,7,11,6,0,0,0,0,16509,6.8,17298,210,53,-1997,-2590,21.0,1650.9,35,4,1,11,7,10,0,0,0,0,18506,7.4,19888,228,67,1997,2590,22.8,1850.6
4508718134,1,14,2,1,6,3,10,1,1,0,0,16745,6.6,17908,215,48,2287,-268,21.5,1674.5,14,1,0,3,6,3,1,0,1,0,14458,7.0,18176,180,68,-2287,268,18.0,1445.8
4487130661,1,13,1,1,7,7,6,0,0,0,0,17023,6.8,17502,198,37,1202,-535,19.8,1702.3,13,4,0,7,7,5,1,0,1,0,15821,7.0,18037,180,46,-1202,535,18.0,1582.1
4524672129,1,14,1,1,11,9,15,1,1,0,0,19421,7.4,19063,215,62,2548,1873,21.5,1942.1,10,2,0,9,11,5,0,0,0,0,16873,7.0,17190,165,56,-2548,-1873,16.5,1687.3
4506599710,0,13,1,0,5,16,4,0,0,0,0,15723,6.4,15978,196,64,-5601,-4942,19.6,1572.3,15,1,1,16,5,22,1,1,0,0,21324,7.6,20920,210,47,5601,4942,21.0,2132.4
4522058891,1,11,1,0,5,6,7,0,0,0,0,15334,6.8,17065,193,45,-2412,-2055,19.3,1533.4,16,2,1,6,5,5,0,0,0,0,17746,7.2,19120,243,54,2412,2055,24.3,1774.6
4518888602,1,15,2,1,2,5,2,0,0,0,0,15318,7.0,17867,219,50,-1145,-2100,21.9,1531.8,16,1,0,5,2,1,1,0,1,0,16463,7.4,19967,261,56,1145,2100,26.1,1646.3
4522504753,0,43,1,0,3,5,2,1,1,0,0,15175,7.0,18100,232,62,-1243,-425,23.2,1517.5,15,17,1,5,3,6,0,0,0,0,16418,7.2,18525,219,49,1243,425,21.9,1641.8
4479366531,1,36,0,1,3,2,4,0,0,0,0,15751,7.0,18853,252,56,991,1570,25.2,1575.1,18,3,0,2,3,2,0,0,0,0,14760,6.8,17283,222,56,-991,-1570,22.2,1476.0
4513354940,1,23,4,1,7,5,6,1,1,0,0,16946,6.8,17723,247,40,2276,1630,24.7,1694.6,15,6,0,5,7,7,0,0,0,0,14670,6.4,16093,194,29,-2276,-1630,19.4,1467.0
4477403514,0,16,2,0,5,9,3,1,1,0,0,15803,7.0,18061,217,73,-2994,-1007,21.7,1580.3,13,1,1,9,5,12,1,0,1,0,18797,7.2,19068,248,67,2994,1007,24.8,1879.7
4523502630,1,18,4,1,11,7,7,2,1,1,0,18303,7.0,18032,202,54,2667,1951,20.2,1830.3,18,5,0,7,11,5,0,0,0,0,15636,6.4,16081,174,49,-2667,-1951,17.4,1563.6
4410120147,0,144,4,1,4,7,6,1,1,0,0,15787,7.2,18200,230,42,-1856,-1804,23.0,1578.7,14,3,0,7,4,11,0,0,0,0,17643,7.4,20004,225,66,1856,1804,22.5,1764.3
4527363053,1,37,2,1,7,4,6,2,1,1,0,17162,7.6,20178,249,44,3035,3792,24.9,1716.2,19,2,0,4,7,3,0,0,0,0,14127,6.6,16386,170,47,-3035,-3792,17.0,1412.7
4491873583,0,18,1,0,7,8,5,0,0,0,0,16456,6.8,16502,209,55,-706,-1460,20.9,1645.6,18,4,1,8,7,8,1,1,0,0,17162,6.8,17962,200,55,706,1460,20.0,1716.2
4508246222,0,18,2,1,4,4,3,0,0,0,0,15601,6.8,17171,232,48,415,14,23.2,1560.1,14,4,0,4,4,5,1,1,0,0,15186,6.8,17157,202,70,-415,-14,20.2,1518.6
4522421841,1,20,2,1,8,7,11,1,1,0,1,18744,6.8,18677,210,55,2858,1988,21.0,1874.4,14,2,0,7,8,7,0,0,0,0,15886,6.8,16689,174,56,-2858,-1988,17.4,1588.6
4521695253,1,21,2,1,10,5,7,1,1,0,0,17671,7.0,18386,231,44,1726,1158,23.1,1767.1,14,1,0,5,10,3,0,0,0,0,15945,6.6,17228,199,56,-1726,-1158,19.9,1594.5
4523588445,0,15,5,1,4,3,5,1,1,0,0,16116,7.0,17653,244,47,2092,1763,24.4,1611.6,13,2,0,3,4,2,0,0,0,0,14024,6.4,15890,191,48,-2092,-1763,19.1,1402.4
4522604950,0,14,3,1,9,14,11,0,0,0,0,17496,6.8,17522,185,51,-2574,-2554,18.5,1749.6,15,2,0,14,9,13,1,1,0,0,20070,7.4,20076,198,56,2574,2554,19.8,2007.0
4466011800,0,15,6,1,8,4,7,0,0,0,0,17239,6.8,18339,210,52,1201,-46,21.0,1723.9,17,4,0,4,8,4,1,1,0,0,16038,7.0,18385,225,80,-1201,46,22.5,1603.8
4520625365,1,39,1,0,7,5,9,1,1,0,0,16460,7.0,17849,220,48,23,-338,22.0,1646.0,16,1,1,5,7,8,0,0,0,0,16437,7.0,18187,222,48,-23,338,22.2,1643.7
4499933829,1,19,4,0,10,9,11,1,1,0,0,18413,7.2,18554,219,60,194,661,21.9,1841.3,13,2,1,9,10,12,0,0,0,0,18219,6.8,17893,230,36,-194,-661,23.0,1821.9
4526558273,0,14,1,1,8,9,6,1,1,0,0,16889,6.6,16862,198,52,-696,-1472,19.8,1688.9,15,1,0,9,8,6,0,0,0,0,17585,7.0,18334,201,54,696,1472,20.1,1758.5
4511223295,0,13,0,0,4,13,3,0,0,0,0,15161,6.6,16945,196,60,-7089,-2815,19.6,1516.1,16,0,1,13,4,13,0,0,0,1,22250,7.2,19760,237,55,7089,2815,23.7,2225.0
4499960219,1,17,3,1,10,6,13,2,1,1,1,19263,7.4,19347,197,50,3840,3165,19.7,1926.3,21,3,0,6,10,8,0,0,0,0,15423,6.4,16182,204,38,-3840,-3165,20.4,1542.3
4516722910,0,15,1,0,7,10,11,0,0,0,0,15723,6.4,15809,159,44,-4307,-2260,15.9,1572.3,17,0,1,10,7,13,1,0,1,1,20030,7.0,18069,253,40,4307,2260,25.3,2003.0
4497727067,0,17,3,0,3,5,2,0,0,0,0,15195,7.0,17434,226,61,-713,-653,22.6,1519.5,17,3,1,5,3,6,1,1,0,0,15908,7.0,18087,232,54,713,653,23.2,1590.8
4524811313,1,20,2,1,11,9,13,1,0,1,0,19096,7.2,19250,206,55,895,910,20.6,1909.6,18,2,0,9,11,9,0,0,0,0,18201,7.0,18340,235,49,-895,-910,23.5,1820.1
4499647535,0,33,3,0,5,5,10,1,1,0,0,17208,7.2,19055,260,60,549,429,26.0,1720.8,17,4,1,5,5,6,0,0,0,0,16659,6.8,18626,258,60,-549,-429,25.8,1665.9
4505943275,0,18,4,0,9,6,14,0,0,0,0,17517,7.2,18612,228,44,124,-1526,22.8,1751.7,39,4,1,6,9,7,2,1,1,0,17393,7.4,20138,235,60,-124,1526,23.5,1739.3
4510971608,0,14,4,0,3,11,4,1,1,0,0,14017,6.6,16410,182,56,-4941,-2777,18.2,1401.7,16,4,1,11,3,8,0,0,0,0,18958,7.4,19187,227,44,4941,2777,22.7,1895.8
4525167083,0,16,0,1,9,5,6,1,1,0,0,17366,6.8,17609,213,51,629,-887,21.3,1736.6,33,3,0,5,9,4,0,0,0,0,16737,7.0,18496,223,60,-629,887,22.3,1673.7
4474915935,1,26,8,1,9,10,7,1,1,0,0,18410,7.2,18561,253,51,714,-176,25.3,1841.0,13,7,0,10,9,10,0,0,0,0,17696,7.0,18737,232,40,-714,176,23.2,1769.6
4515935955,1,19,4,0,7,4,3,2,1,1,0,16700,7.0,19019,218,72,1039,1629,21.8,1670.0,14,3,1,4,7,3,0,0,0,0,15661,7.0,17390,248,48,-1039,-1629,24.8,1566.1
4442091575,1,20,3,1,11,1,13,1,1,0,1,18789,7.4,20433,231,38,4250,3916,23.1,1878.9,17,0,0,1,11,1,0,0,0,0,14539,6.4,16517,223,57,-4250,-3916,22.3,1453.9
4513512773,1,15,2,0,5,5,4,0,0,0,0,16450,7.2,18742,222,72,296,1046,22.2,1645.0,12,4,1,5,5,8,2,1,1,0,16154,7.0,17696,220,60,-296,-1046,22.0,1615.4
4515656149,1,15,2,1,13,6,18,1,1,0,0,20666,7.2,19611,220,60,5525,3383,22.0,2066.6,13,1,0,6,13,7,0,0,0,0,15141,6.6,16228,185,48,-5525,-3383,18.5,1514.1
4511396736,0,19,1,0,4,6,5,1,0,1,0,14939,6.6,15632,189,51,-798,-1418,18.9,1493.9,11,3,1,6,4,13,1,1,0,0,15737,6.8,17050,210,50,798,1418,21.0,1573.7
4516759278,1,21,5,1,8,4,7,1,1,0,1,17790,6.8,17688,190,56,1837,458,19.0,1779.0,86,2,0,4,8,4,1,0,1,0,15953,6.8,17230,176,68,-1837,-458,17.6,1595.3
4523422751,1,15,2,1,8,0,8,2,1,1,0,18519,7.2,20004,235,52,5222,3469,23.5,1851.9,10,0,0,0,8,0,0,0,0,0,13297,6.6,16535,187,68,-5222,-3469,18.7,1329.7
4493892937,1,45,4,0,2,8,1,2,1,1,0,14194,6.8,17765,192,62,-1949,-18,19.2,1419.4,19,3,1,8,2,9,0,0,0,0,16143,7.0,17783,190,53,1949,18,19.0,1614.3
4459496289,0,18,0,0,11,8,7,0,0,0,0,18303,7.2,19278,220,52,1142,841,22.0,1830.3,13,5,1,8,11,7,0,0,0,0,17161,7.0,18437,201,56,-1142,-841,20.1,1716.1
4525065975,1,17,2,0,3,4,3,1,1,0,0,15279,7.0,18515,240,44,-1023,92,24.0,1527.9,16,2,1,4,3,4,1,0,1,0,16302,7.0,18423,243,48,1023,-92,24.3,1630.2
4508204342,1,14,2,1,4,4,4,2,1,1,0,15802,7.0,17365,237,48,306,-936,23.7,1580.2,17,2,0,4,4,5,0,0,0,0,15496,7.0,18301,209,69,-306,936,20.9,1549.6
4521916214,1,16,8,0,6,11,7,1,1,0,0,15246,6.6,16135,174,43,-2974,-2746,17.4,1524.6,26,3,1,11,6,9,1,0,1,0,18220,7.2,18881,198,59,2974,2746,19.8,1822.0
4527500964,1,35,5,0,8,5,13,1,1,0,0,17737,7.2,18648,224,60,2413,2163,22.4,1773.7,16,4,1,5,8,7,0,0,0,0,15324,6.6,16485,179,34,-2413,-2163,17.9,1532.4
4492447049,0,13,2,1,1,4,1,0,0,0,0,14017,6.4,15893,229,32,-2638,-2478,22.9,1401.7,39,3,0,4,1,5,2,1,1,0,16655,6.8,18371,231,56,2638,2478,23.1,1665.5
4525110974,1,13,3,1,8,3,10,2,1,1,0,16903,7.4,19854,207,63,2524,2733,20.7,1690.3,39,2,0,3,8,1,0,0,0,0,14379,6.8,17121,199,40,-2524,-2733,19.9,1437.9
4526414474,0,32,2,0,10,8,8,0,0,0,0,17945,7.4,19818,206,56,209,1647,20.6,1794.5,80,3,1,8,10,3,1,1,0,1,17736,6.8,18171,196,56,-209,-1647,19.6,1773.6
4450778903,1,16,3,1,7,5,7,1,1,0,0,16470,7.0,17655,216,49,632,-1247,21.6,1647.0,14,4,0,5,7,2,0,0,0,0,15838,7.0,18902,230,60,-632,1247,23.0,1583.8
4512960247,0,14,2,0,8,7,3,0,0,0,0,17113,7.2,19396,234,49,815,1397,23.4,1711.3,15,2,1,7,8,4,0,0,0,0,16298,6.8,17999,182,52,-815,-1397,18.2,1629.8
4515748681,1,16,2,1,12,7,12,0,0,0,0,19055,7.0,18944,225,51,982,1653,22.5,1905.5,37,3,0,7,12,8,2,1,1,1,18073,6.6,17291,188,53,-982,-1653,18.8,1807.3
4526731999,1,22,9,0,12,7,14,1,1,0,0,17785,7.0,17490,183,28,376,-470,18.3,1778.5,139,1,1,7,12,7,0,0,0,0,17409,6.8,17960,207,48,-376,470,20.7,1740.9
4524799428,1,40,1,1,9,3,7,0,0,0,0,18322,7.4,20963,258,68,4100,4903,25.8,1832.2,38,11,0,3,9,1,0,0,0,0,14222,6.4,16060,204,41,-4100,-4903,20.4,1422.2
4450495621,1,16,1,1,9,5,12,0,0,0,0,16759,7.0,17756,183,48,988,581,18.3,1675.9,13,5,0,5,9,9,2,1,1,0,15771,6.6,17175,198,59,-988,-581,19.8,1577.1
4511239909,1,39,3,1,6,7,5,1,1,0,0,16688,6.8,17678,223,44,-405,437,22.3,1668.8,17,4,0,7,6,11,0,0,0,0,17093,6.6,17241,205,55,405,-437,20.5,1709.3
4494953056,1,17,4,1,6,2,5,2,1,1,1,17945,7.0,18758,268,44,2404,1129,26.8,1794.5,94,5,0,2,6,1,0,0,0,0,15541,6.8,17629,260,49,-2404,-1129,26.0,1554.1
4513221186,0,11,3,1,8,6,9,1,1,0,0,16707,6.8,17380,193,44,-724,1250,19.3,1670.7,17,4,0,6,8,7,0,0,0,1,17431,6.4,16130,216,36,724,-1250,21.6,1743.1
4447477693,0,17,3,0,8,8,11,0,0,0,0,16634,7.0,17892,198,40,-355,279,19.8,1663.4,38,3,1,8,8,7,0,0,0,0,16989,6.8,17613,195,44,355,-279,19.5,1698.9
4456030501,1,15,1,1,9,4,11,1,0,1,0,17495,7.0,19239,235,44,1858,1429,23.5,1749.5,38,1,0,4,9,3,1,1,0,0,15637,6.8,17810,215,52,-1858,-1429,21.5,1563.7
4420829528,1,20,7,0,11,4,12,0,0,0,0,19392,7.2,18570,239,48,4872,3076,23.9,1939.2,20,3,1,4,11,6,0,0,0,0,14520,6.2,15494,203,34,-4872,-3076,20.3,1452.0
4477719459,0,19,2,1,5,6,7,1,0,1,1,18324,7.2,18932,227,68,2215,2315,22.7,1832.4,16,4,0,6,5,13,0,0,0,0,16109,6.6,16617,203,36,-2215,-2315,20.3,1610.9
4458628043,1,16,2,1,6,3,6,1,1,0,0,16847,7.4,19065,220,67,2341,2303,22.0,1684.7,14,4,0,3,6,3,0,0,0,0,14506,6.6,16762,214,38,-2341,-2303,21.4,1450.6
4520588877,0,15,2,0,2,10,2,0,0,0,0,14044,6.6,16501,191,56,-6604,-2014,19.1,1404.4,18,3,1,10,2,6,2,1,1,2,20648,7.2,18515,236,48,6604,2014,23.6,2064.8
4458532783,1,20,5,1,9,2,14,0,0,0,0,18202,7.0,18332,232,58,3424,1624,23.2,1820.2,20,3,0,2,9,2,1,1,0,0,14778,6.4,16708,228,50,-3424,-1624,22.8,1477.8
4489690611,1,15,6,1,10,5,14,1,0,1,0,17857,6.8,17155,211,38,1879,-344,21.1,1785.7,16,4,0,5,10,5,0,0,0,0,15978,6.8,17499,227,34,-1879,344,22.7,1597.8
4473484316,0,15,1,0,6,10,4,0,0,0,0,15679,6.4,16997,188,53,-3209,-2726,18.8,1567.9,16,2,1,10,6,8,0,0,0,0,18888,7.2,19723,233,48,3209,2726,23.3,1888.8
4484417350,0,15,1,0,2,8,3,0,0,0,0,14433,6.6,16813,202,64,-3215,-1656,20.2,1443.3,21,3,1,8,2,7,1,0,1,0,17648,7.2,18469,243,43,3215,1656,24.3,1764.8
4484833636,1,17,8,1,7,4,11,1,0,1,2,19915,7.2,18674,246,53,5286,3583,24.6,1991.5,17,1,0,4,7,8,1,1,0,0,14629,6.2,15091,154,45,-5286,-3583,15.4,1462.9
4442192126,1,15,3,1,4,5,3,0,0,0,0,15884,6.8,17698,251,42,739,1639,25.1,1588.4,16,2,0,5,4,6,1,1,0,0,15145,6.4,16059,175,54,-739,-1639,17.5,1514.5
4495535828,1,21,3,1,6,3,5,2,1,1,0,16646,7.2,18549,242,49,919,94,24.2,1664.6,14,10,0,3,6,6,0,0,0,0,15727,7.2,18455,258,56,-919,-94,25.8,1572.7
4492394631,1,12,1,1,8,5,9,1,1,0,0,18014,7.2,19778,238,68,1388,973,23.8,1801.4,37,0,0,5,8,5,0,0,0,0,16626,7.2,18805,225,60,-1388,-973,22.5,1662.6
4516505202,1,15,3,1,4,4,4,0,0,0,0,15722,6.8,17896,224,51,-470,-187,22.4,1572.2,102,1,0,4,4,3,0,0,0,0,16192,7.0,18083,242,48,470,187,24.2,1619.2
4466252369,0,12,2,1,5,6,4,1,0,1,0,16103,7.2,18747,208,55,-2659,88,20.8,1610.3,16,1,0,6,5,11,0,0,0,1,18762,7.4,18659,245,52,2659,-88,24.5,1876.2
4526239268,0,9,0,0,2,11,4,1,1,0,0,14079,6.6,16131,215,51,-4780,-3425,21.5,1407.9,15,3,1,11,2,13,0,0,0,0,18859,7.4,19556,214,52,4780,3425,21.4,1885.9
4494040158,1,16,1,1,6,8,10,1,1,0,0,15388,6.4,15544,153,60,-3077,-3160,15.3,1538.8,14,1,0,8,6,5,1,0,1,1,18465,7.0,18704,214,59,3077,3160,21.4,1846.5
4518590112,0,18,0,0,5,7,6,0,0,0,0,15470,6.8,17038,217,40,-1708,-677,21.7,1547.0,51,2,1,7,5,12,0,0,0,0,17178,7.2,17715,207,44,1708,677,20.7,1717.8
4496308488,1,15,4,1,15,4,16,0,0,0,1,21462,6.8,18193,208,27,7579,4666,20.8,2146.2,15,1,0,4,15,7,0,0,0,0,13883,5.8,13527,139,41,-7579,-4666,13.9,1388.3
4526612665,0,21,3,1,1,1,3,0,0,0,0,15301,7.0,18098,249,72,166,-436,24.9,1530.1,17,4,0,1,1,0,1,1,0,0,15135,6.8,18534,230,60,-166,436,23.0,1513.5
4499907399,1,20,5,0,5,2,6,0,0,0,0,16029,6.8,17493,234,47,1756,1920,23.4,1602.9,16,2,1,2,5,3,0,0,0,0,14273,6.2,15573,199,49,-1756,-1920,19.9,1427.3
4519028145,0,15,4,1,9,5,7,0,0,0,0,17651,7.0,18199,222,51,2348,1133,22.2,1765.1,12,5,0,5,9,4,1,1,0,0,15303,6.8,17066,195,43,-2348,-1133,19.5,1530.3
4525010379,1,27,5,0,4,6,4,0,0,0,0,14944,6.8,16969,200,40,-916,-659,20.0,1494.4,48,2,1,6,4,8,1,1,0,0,15860,7.0,17628,193,63,916,659,19.3,1586.0
4472293510,0,14,1,0,1,4,1,0,0,0,0,14588,6.8,17460,241,45,-2574,-404,24.1,1458.8,11,3,1,4,1,6,0,0,0,1,17162,6.8,17864,222,47,2574,404,22.2,1716.2
4524761713,1,22,0,0,6,4,5,1,1,0,0,16538,7.0,18735,227,44,1126,878,22.7,1653.8,12,1,1,4,6,2,1,0,1,0,15412,6.8,17857,225,45,-1126,-878,22.5,1541.2
4486764809,0,16,4,0,1,3,1,1,0,1,0,14605,7.0,17830,244,48,-280,903,24.4,1460.5,14,3,1,3,1,3,1,1,0,0,14885,6.6,16927,217,60,280,-903,21.7,1488.5
4527195678,0,11,1,0,4,8,2,0,0,0,0,15442,6.8,17142,204,52,-3924,-3699,20.4,1544.2,15,1,1,8,4,6,2,1,1,1,19366,7.6,20841,254,76,3924,3699,25.4,1936.6
4497782255,0,17,4,0,2,5,2,0,0,0,0,15190,7.0,18432,241,60,-1782,-754,24.1,1519.0,17,4,1,5,2,3,1,1,0,0,16972,7.2,19186,251,72,1782,754,25.1,1697.2
4516154193,0,16,2,1,3,5,7,0,0,0,0,14994,6.6,16731,199,41,-1080,-1664,19.9,1499.4,20,3,0,5,3,3,1,0,1,0,16074,7.0,18395,235,64,1080,1664,23.5,1607.4
4499816860,0,26,3,1,4,5,4,1,1,0,0,15273,6.8,17539,211,60,-808,-311,21.1,1527.3,20,1,0,5,4,6,0,0,0,0,16081,7.2,17850,238,45,808,311,23.8,1608.1
4516515397,0,13,1,0,6,12,3,0,0,0,0,15485,6.6,16784,213,28,-3683,-3420,21.3,1548.5,34,3,1,12,6,13,2,1,1,0,19168,7.4,20204,209,63,3683,3420,20.9,1916.8
4522484818,0,16,2,1,8,8,8,0,0,0,0,17698,7.2,18605,218,56,-373,-1526,21.8,1769.8,14,2,0,8,8,5,1,1,0,0,18071,7.4,20131,233,76,373,1526,23.3,1807.1
4498466711,0,14,1,0,6,5,8,1,1,0,1,17471,6.8,17895,217,56,1019,37,21.7,1747.1,16,2,1,5,6,4,0,0,0,0,16452,6.8,17858,206,55,-1019,-37,20.6,1645.2
4415547977,0,16,6,0,6,8,4,0,0,0,0,15342,6.6,15988,221,39,-1758,-2010,22.1,1534.2,20,3,1,8,6,10,1,1,0,0,17100,7.0,17998,226,48,1758,2010,22.6,1710.0
4521738379,0,16,6,1,6,9,12,0,0,0,0,16492,6.8,17944,220,47,-2847,-1355,22.0,1649.2,51,4,0,9,6,19,2,1,1,1,19339,7.4,19299,237,56,2847,1355,23.7,1933.9
4524056834,0,17,2,0,8,3,10,1,1,0,0,17084,7.2,18781,219,52,2148,1700,21.9,1708.4,15,4,1,3,8,2,0,0,0,0,14936,6.4,17081,217,52,-2148,-1700,21.7,1493.6
4469524745,1,86,6,1,9,6,8,1,0,1,1,19257,7.0,18701,224,68,3766,3001,22.4,1925.7,45,6,0,6,9,9,0,0,0,0,15491,6.4,15700,186,44,-3766,-3001,18.6,1549.1
4485910798,1,20,6,1,6,2,6,1,1,0,0,16825,7.0,18820,247,49,2492,1176,24.7,1682.5,42,4,0,2,6,2,0,0,0,0,14333,7.0,17644,205,56,-2492,-1176,20.5,1433.3
4526945027,0,15,3,0,1,6,1,0,0,0,0,14971,6.6,17477,255,55,-1390,-446,25.5,1497.1,16,2,1,6,1,4,2,1,1,0,16361,6.8,17923,226,52,1390,446,22.6,1636.1
4489559952,1,17,6,0,9,9,9,0,0,0,0,17898,7.0,18398,231,52,-113,-116,23.1,1789.8,39,5,1,9,9,11,1,1,0,0,18011,7.2,18514,218,52,113,116,21.8,1801.1
4514660539,1,20,2,1,9,9,7,0,0,0,0,17174,7.0,18159,189,49,-1342,-1278,18.9,1717.4,173,3,0,9,9,10,1,1,0,0,18516,7.2,19437,238,50,1342,1278,23.8,1851.6
4478911331,1,14,4,0,12,5,23,1,1,0,0,18494,6.8,17736,212,43,3098,2685,21.2,1849.4,25,1,1,5,12,9,0,0,0,0,15396,6.2,15051,188,34,-3098,-2685,18.8,1539.6
4488885595,0,15,4,0,2,5,1,1,1,0,0,14128,6.6,16843,214,45,-2425,-1778,21.4,1412.8,19,3,1,5,2,4,0,0,0,0,16553,7.2,18621,233,55,2425,1778,23.3,1655.3
4523657645,1,16,5,0,5,4,5,1,0,1,0,15436,7.0,18911,220,48,-684,-742,22.0,1543.6,39,5,1,4,5,6,1,1,0,0,16120,7.2,19653,267,53,684,742,26.7,1612.0
4510706024,0,15,11,0,5,4,7,2,1,1,0,16222,7.0,18814,243,56,459,1309,24.3,1622.2,42,1,1,4,5,1,0,0,0,0,15763,7.0,17505,234,51,-459,-1309,23.4,1576.3
4467981904,1,17,2,1,10,11,8,1,0,1,0,18237,6.6,17871,235,44,206,257,23.5,1823.7,14,5,0,11,10,14,0,0,0,0,18031,6.8,17614,175,36,-206,-257,17.5,1803.1
4524439900,0,22,3,0,6,9,6,0,0,0,0,15196,6.6,16925,188,34,-2560,-826,18.8,1519.6,41,3,1,9,6,18,1,1,0,0,17756,7.0,17751,211,44,2560,826,21.1,1775.6
4469567856,0,16,2,1,6,7,3,2,1,1,0,16308,7.0,18718,227,65,-52,430,22.7,1630.8,14,2,0,7,6,5,0,0,0,0,16360,7.2,18288,208,52,52,-430,20.8,1636.0
4524565861,1,16,0,1,7,0,7,0,0,0,0,18406,7.4,19320,247,56,4990,2055,24.7,1840.6,79,1,0,0,7,0,1,1,0,0,13416,6.8,17265,196,70,-4990,-2055,19.6,1341.6
4522462611,0,16,2,1,7,7,13,1,1,0,0,16034,6.6,16642,199,40,-754,-729,19.9,1603.4,14,1,0,7,7,12,0,0,0,0,16788,6.8,17371,224,50,754,729,22.4,1678.8
4501037269,0,18,5,1,7,7,11,2,1,1,0,16484,7.0,17470,202,62,-375,-752,20.2,1648.4,80,6,0,7,7,5,0,0,0,0,16859,7.2,18222,219,41,375,752,21.9,1685.9
4523619832,0,15,2,0,7,6,4,1,1,0,0,16519,7.0,18850,203,64,-1464,331,20.3,1651.9,21,2,1,6,7,4,0,0,0,0,17983,7.0,18519,240,60,1464,-331,24.0,1798.3
4522459951,1,15,5,1,9,4,12,1,1,0,0,17190,6.6,17783,210,41,1847,1084,21.0,1719.0,14,2,0,4,9,5,1,0,1,0,15343,6.8,16699,200,40,-1847,-1084,20.0,1534.3
4463059486,0,16,3,0,4,12,5,1,1,0,0,15380,6.6,15984,226,43,-4864,-2818,22.6,1538.0,17,2,1,12,4,17,1,0,1,2,20244,7.2,18802,231,36,4864,2818,23.1,2024.4
4465317385,0,16,3,1,7,13,7,0,0,0,0,15061,6.2,15124,183,31,-4179,-4531,18.3,1506.1,15,3,0,13,7,8,1,0,1,0,19240,7.2,19655,236,52,4179,4531,23.6,1924.0
4522864178,1,37,0,0,8,7,8,0,0,0,0,17197,6.8,16987,185,48,733,-1480,18.5,1719.7,12,4,1,7,8,4,1,0,1,0,16464,7.0,18467,245,40,-733,1480,24.5,1646.4
4524640273,1,16,1,1,7,5,7,0,0,0,0,16602,7.0,17918,211,59,888,1005,21.1,1660.2,22,1,0,5,7,4,0,0,0,0,15714,7.0,16913,227,33,-888,-1005,22.7,1571.4
4525240848,0,18,5,1,7,7,11,0,0,0,0,17201,7.0,18871,230,49,-211,-626,23.0,1720.1,16,2,0,7,7,10,1,1,0,0,17412,7.2,19497,222,68,211,626,22.2,1741.2
4510751913,0,16,3,0,5,13,5,0,0,0,0,15069,6.2,14655,172,36,-4160,-6073,17.2,1506.9,48,4,1,13,5,10,1,1,0,0,19229,7.4,20728,231,69,4160,6073,23.1,1922.9
4515829402,0,105,1,1,6,7,3,0,0,0,0,15720,6.8,17660,187,43,-1862,-1326,18.7,1572.0,13,3,0,7,6,6,1,0,1,0,17582,7.2,18986,240,52,1862,1326,24.0,1758.2
4512472589,1,15,2,1,3,7,3,1,1,0,0,15199,6.8,17382,235,45,-1631,-1338,23.5,1519.9,14,2,0,7,3,7,1,0,1,0,16830,7.0,18720,206,49,1631,1338,20.6,1683.0
4523421831,0,11,4,1,4,4,7,1,1,0,0,15788,6.8,18264,243,50,671,881,24.3,1578.8,17,0,0,4,4,5,0,0,0,0,15117,7.0,17383,228,48,-671,-881,22.8,1511.7
4520650769,1,18,2,0,4,3,3,0,0,0,0,15220,6.8,18562,234,44,-1297,-129,23.4,1522.0,34,1,1,3,4,4,0,0,0,0,16517,7.0,18691,241,56,1297,129,24.1,1651.7
4484087846,0,15,2,0,7,5,10,1,1,0,0,16938,7.2,19399,231,48,600,824,23.1,1693.8,15,1,1,5,7,8,1,0,1,0,16338,7.0,18575,229,60,-600,-824,22.9,1633.8
4526683512,1,16,5,0,8,7,9,1,0,1,0,17075,7.0,17360,198,49,399,-182,19.8,1707.5,15,2,1,7,8,6,1,1,0,0,16676,7.0,17542,219,65,-399,182,21.9,1667.6
4465443052,1,13,3,1,12,13,12,0,0,0,0,19201,7.0,19303,215,56,-1398,-26,21.5,1920.1,17,3,0,13,12,13,1,1,0,1,20599,7.2,19329,215,40,1398,26,21.5,2059.9
4477491383,0,16,3,1,8,7,9,0,0,0,0,16059,7.0,17499,190,36,-1073,-657,19.0,1605.9,18,4,0,7,8,7,1,0,1,0,17132,6.8,18156,232,43,1073,657,23.2,1713.2
4486380071,0,11,5,1,7,16,7,0,0,0,0,16711,6.4,15855,201,51,-3289,-4291,20.1,1671.1,15,1,0,16,7,17,1,0,1,0,20000,7.4,20146,201,49,3289,4291,20.1,2000.0
4455484504,0,40,2,0,3,4,4,0,0,0,0,15120,6.8,17606,230,48,-1338,-779,23.0,1512.0,19,17,1,4,3,8,1,1,0,0,16458,7.0,18385,234,55,1338,779,23.4,1645.8
4463289443,1,17,5,1,8,4,10,0,0,0,0,18326,7.2,19015,239,51,3517,2356,23.9,1832.6,19,6,0,4,8,4,1,0,1,0,14809,6.6,16659,203,24,-3517,-2356,20.3,1480.9
4509016746,0,16,4,0,9,12,9,0,0,0,0,17554,7.4,19237,243,46,-315,-293,24.3,1755.4,14,2,1,12,9,7,0,0,0,0,17869,7.4,19530,179,50,315,293,17.9,1786.9
4508992127,0,16,5,1,4,10,4,0,0,0,0,15302,6.8,16647,210,55,-3051,-2123,21.0,1530.2,24,4,0,10,4,12,1,1,0,0,18353,7.0,18770,215,50,3051,2123,21.5,1835.3
4522593287,0,17,2,1,3,8,4,0,0,0,0,14037,6.2,15309,167,54,-2491,-2521,16.7,1403.7,35,3,0,8,3,6,2,1,1,0,16528,7.0,17830,202,36,2491,2521,20.2,1652.8
4464836293,0,16,5,0,4,5,7,0,0,0,0,15858,6.8,17491,246,44,-512,-844,24.6,1585.8,20,3,1,5,4,6,2,1,1,0,16370,7.0,18335,241,52,512,844,24.1,1637.0
4524343815,1,16,3,0,2,7,4,1,0,1,0,14010,6.4,16322,187,38,-3047,-612,18.7,1401.0,13,3,1,7,2,9,1,1,0,0,17057,6.6,16934,215,38,3047,612,21.5,1705.7
4494350446,1,16,1,1,8,4,7,2,1,1,0,17634,7.0,19000,242,46,2018,2261,24.2,1763.4,31,1,0,4,8,2,0,0,0,0,15616,6.6,16739,233,50,-2018,-2261,23.3,1561.6
4500244269,0,38,2,1,5,5,4,1,0,1,0,15509,6.8,17265,220,40,-1335,-1142,22.0,1550.9,14,2,0,5,5,10,1,1,0,0,16844,7.0,18407,230,69,1335,1142,23.0,1684.4
4527591942,0,39,3,1,7,5,8,0,0,0,0,16481,7.0,18136,190,46,572,-233,19.0,1648.1,18,2,0,5,7,7,1,1,0,0,15909,7.0,18369,224,48,-572,233,22.4,1590.9
4469852956,1,17,3,0,5,5,4,0,0,0,0,16545,7.2,19148,235,67,-207,-251,23.5,1654.5,15,4,1,5,5,6,1,1,0,0,16752,7.2,19399,235,72,207,251,23.5,1675.2
4490133266,1,16,1,0,8,5,8,1,1,0,0,17405,7.2,19297,229,46,1198,197,22.9,1740.5,36,3,1,5,8,1,0,0,0,0,16207,7.2,19100,237,64,-1198,-197,23.7,1620.7
4484301956,0,13,2,1,10,4,10,0,0,0,0,18224,7.4,19875,225,43,2978,3229,22.5,1822.4,17,1,0,4,10,5,0,0,0,0,15246,6.8,16646,224,42,-2978,-3229,22.4,1524.6
4458860802,0,15,7,0,11,7,7,0,0,0,0,18860,8.0,22224,233,60,1651,3902,23.3,1886.0,18,3,1,7,11,6,1,1,0,0,17209,7.0,18322,215,47,-1651,-3902,21.5,1720.9
4515415640,0,20,1,1,9,14,10,0,0,0,0,17155,6.6,16245,183,32,-4473,-2976,18.3,1715.5,15,4,0,14,9,16,2,1,1,1,21628,7.0,19221,214,51,4473,2976,21.4,2162.8
4527075241,1,14,3,1,6,6,7,1,1,0,0,16620,6.8,16713,212,52,1156,168,21.2,1662.0,18,3,0,6,6,6,1,0,1,0,15464,6.6,16545,200,39,-1156,-168,20.0,1546.4
4511949314,1,5,1,0,4,8,5,0,0,0,0,14834,6.6,16539,191,52,-2714,-427,19.1,1483.4,18,0,1,8,4,11,1,0,1,0,17548,6.8,16966,198,51,2714,427,19.8,1754.8
4496759358,0,16,2,0,5,13,3,0,0,0,0,15305,6.4,16138,209,48,-2615,-800,20.9,1530.5,15,0,1,13,5,11,1,1,0,0,17920,6.6,16938,157,54,2615,800,15.7,1792.0
4466458124,0,14,2,0,2,6,2,1,1,0,0,13590,6.6,15723,170,56,-3089,-1857,17.0,1359.0,18,1,1,6,2,6,0,0,0,0,16679,6.8,17580,215,47,3089,1857,21.5,1667.9
4495136621,0,16,2,1,7,5,15,0,0,0,0,18038,7.0,17959,241,43,3107,2223,24.1,1803.8,13,4,0,5,7,6,1,1,0,0,14931,6.4,15736,154,60,-3107,-2223,15.4,1493.1
4507594036,1,14,1,0,6,8,7,0,0,0,0,15818,6.6,16894,162,53,-1492,-1925,16.2,1581.8,13,2,1,8,6,5,1,1,0,0,17310,7.2,18819,214,56,1492,1925,21.4,1731.0
4522654087,0,12,0,0,3,8,3,0,0,0,0,15149,6.8,17143,205,51,-1876,-2659,20.5,1514.9,13,2,1,8,3,4,1,1,0,0,17025,7.4,19802,211,76,1876,2659,21.1,1702.5
4477014254,0,17,2,1,11,6,10,1,1,0,0,18203,7.0,18175,199,56,1393,441,19.9,1820.3,29,4,0,6,11,2,0,0,0,0,16810,6.8,17734,224,52,-1393,-441,22.4,1681.0
4452777029,0,16,3,0,4,3,8,1,1,0,0,15714,7.0,17817,230,49,589,675,23.0,1571.4,17,1,1,3,4,6,1,0,1,0,15125,6.8,17142,199,67,-589,-675,19.9,1512.5
4525175959,0,17,3,1,8,4,10,1,1,0,0,17161,7.2,18145,206,48,1577,-50,20.6,1716.1,17,3,0,4,8,2,0,0,0,0,15584,7.0,18195,214,48,-1577,50,21.4,1558.4
4487077116,1,13,4,0,4,3,5,0,0,0,0,16079,7.0,18772,221,54,752,1388,22.1,1607.9,23,2,1,3,4,5,1,1,0,0,15327,6.6,17384,223,52,-752,-1388,22.3,1532.7
4480194384,0,15,2,1,5,7,4,0,0,0,0,15977,6.8,18136,206,71,-1130,-347,20.6,1597.7,15,2,0,7,5,8,1,1,0,0,17107,7.2,18483,230,56,1130,347,23.0,1710.7
4526731314,1,18,3,1,5,6,6,1,0,1,0,15743,6.6,16662,212,48,-720,-1533,21.2,1574.3,21,5,0,6,5,11,1,1,0,0,16463,7.0,18195,229,48,720,1533,22.9,1646.3
4481913524,1,13,2,1,7,3,9,2,1,1,0,16518,7.2,19145,208,48,1630,2330,20.8,1651.8,18,2,0,3,7,2,0,0,0,0,14888,6.8,16815,218,48,-1630,-2330,21.8,1488.8
4448127170,0,34,7,1,2,3,3,1,0,1,0,15345,7.2,18848,230,64,-164,1358,23.0,1534.5,19,3,0,3,2,7,1,1,0,0,15509,6.6,17490,236,55,164,-1358,23.6,1550.9
4492374255,1,18,2,1,5,3,5,1,1,0,0,16583,6.8,17825,219,60,961,-900,21.9,1658.3,13,1,0,3,5,2,1,0,1,0,15622,7.0,18725,234,64,-961,900,23.4,1562.2
4523278950,1,17,1,0,3,5,5,0,0,0,0,14313,6.2,15407,194,52,-2089,-2275,19.4,1431.3,18,6,1,5,3,7,1,1,0,0,16402,6.8,17682,243,48,2089,2275,24.3,1640.2
4516998276,0,14,4,0,3,4,2,0,0,0,0,15519,7.0,18382,256,58,-546,1078,25.6,1551.9,21,3,1,4,3,6,1,1,0,0,16065,6.8,17304,227,48,546,-1078,22.7,1606.5
4476686875,0,34,1,1,7,5,8,1,0,1,0,17364,7.0,18990,215,68,1206,1055,21.5,1736.4,15,1,0,5,7,4,1,1,0,0,16158,7.0,17935,248,49,-1206,-1055,24.8,1615.8
4472428830,0,52,19,0,3,8,4,0,0,0,0,13636,6.2,14432,177,35,-4529,-4665,17.7,1363.6,37,2,1,8,3,7,2,1,1,0,18165,7.4,19097,249,60,4529,4665,24.9,1816.5
4506646295,1,19,3,1,13,7,16,2,1,1,1,20611,7.0,19378,210,51,4096,3516,21.0,2061.1,16,3,0,7,13,8,0,0,0,0,16515,6.4,15862,166,44,-4096,-3516,16.6,1651.5
4460625430,1,16,3,0,11,7,16,1,1,0,0,18421,7.2,18519,232,44,2256,725,23.2,1842.1,16,3,1,7,11,7,0,0,0,0,16165,6.8,17794,222,35,-2256,-725,22.2,1616.5
4519145907,1,13,3,0,4,6,3,2,1,1,0,15695,7.2,18493,238,44,-300,451,23.8,1569.5,11,2,1,6,4,5,0,0,0,0,15995,7.2,18042,203,51,300,-451,20.3,1599.5
4522867011,0,15,1,0,3,6,0,1,0,1,0,15189,6.6,17014,225,56,-1720,-2056,22.5,1518.9,12,4,1,6,3,3,1,1,0,0,16909,7.2,19070,248,61,1720,2056,24.8,1690.9
4489399864,1,15,1,1,7,7,6,0,0,0,0,17627,7.0,18282,244,51,428,35,24.4,1762.7,12,2,0,7,7,11,1,1,0,0,17199,7.0,18247,247,51,-428,-35,24.7,1719.9
4513844046,1,133,5,0,4,5,2,0,0,0,0,15039,6.8,17278,221,52,-960,-1743,22.1,1503.9,15,3,1,5,4,2,1,1,0,0,15999,7.0,19021,232,60,960,1743,23.2,1599.9
4503355940,1,15,1,0,2,4,2,1,1,0,0,14905,6.8,18468,244,56,-1090,522,24.4,1490.5,15,5,1,4,2,4,0,0,0,0,15995,6.8,17946,243,51,1090,-522,24.3,1599.5
4492589905,1,48,2,0,1,3,1,1,1,0,0,15119,6.8,18281,249,64,-326,-294,24.9,1511.9,13,0,1,3,1,3,1,0,1,0,15445,7.4,18575,228,53,326,294,22.8,1544.5
4520508656,1,16,3,0,1,6,0,0,0,0,0,13775,7.0,17208,206,61,-2217,-715,20.6,1377.5,18,4,1,6,1,6,1,1,0,0,15992,6.8,17923,242,40,2217,715,24.2,1599.2
4481845799,0,14,2,0,5,9,5,0,0,0,0,15611,7.0,17672,222,44,-2415,-2092,22.2,1561.1,12,1,1,9,5,10,1,1,0,0,18026,7.2,19764,231,56,2415,2092,23.1,1802.6
4499919097,1,17,3,0,7,2,9,0,0,0,0,16454,7.0,18576,207,45,2042,1127,20.7,1645.4,15,2,1,2,7,1,0,0,0,0,14412,6.8,17449,195,72,-2042,-1127,19.5,1441.2
4494726186,1,11,4,0,4,6,3,0,0,0,0,15727,7.2,18903,247,44,-84,221,24.7,1572.7,14,1,1,6,4,4,0,0,0,0,15811,7.2,18682,216,52,84,-221,21.6,1581.1
4500216445,1,18,2,1,8,7,10,0,0,0,0,17450,7.2,18989,236,52,270,638,23.6,1745.0,17,4,0,7,8,5,1,0,1,0,17180,6.8,18351,220,48,-270,-638,22.0,1718.0
4495526731,0,12,2,1,8,5,7,1,0,1,0,17697,7.2,18512,203,59,2682,2118,20.3,1769.7,15,0,0,5,8,5,1,1,0,0,15015,6.6,16394,165,50,-2682,-2118,16.5,1501.5
4296004784,1,19,5,1,6,2,6,1,1,0,0,17354,7.4,19609,263,64,2944,3092,26.3,1735.4,21,6,0,2,6,2,0,0,0,0,14410,6.4,16517,232,44,-2944,-3092,23.2,1441.0
4516721414,0,18,4,1,8,8,8,1,1,0,0,16453,6.8,17231,206,40,-569,-213,20.6,1645.3,21,2,0,8,8,10,1,0,1,0,17022,7.0,17444,199,43,569,213,19.9,1702.2
4508349018,1,15,1,0,8,10,10,1,0,1,0,16688,6.8,17007,201,51,-1198,-768,20.1,1668.8,18,4,1,10,8,14,1,1,0,0,17886,7.2,17775,209,49,1198,768,20.9,1788.6
4515867016,1,13,2,0,4,3,6,1,1,0,0,14972,6.8,17357,201,49,-266,-613,20.1,1497.2,37,1,1,3,4,4,1,0,1,0,15238,7.0,17970,233,46,266,613,23.3,1523.8
4496431819,1,13,3,1,4,8,6,1,1,0,0,15077,7.0,17523,208,42,-2035,-1237,20.8,1507.7,15,2,0,8,4,7,0,0,0,0,17112,7.0,18760,231,54,2035,1237,23.1,1711.2
4477019326,1,10,3,0,5,5,7,0,0,0,0,16038,7.2,19227,228,54,-844,139,22.8,1603.8,14,3,1,5,5,5,1,1,0,0,16882,7.2,19088,226,68,844,-139,22.6,1688.2
4524934660,1,17,3,1,5,1,4,1,1,0,0,15823,7.0,17964,197,48,2028,1165,19.7,1582.3,13,3,0,1,5,1,0,0,0,0,13795,6.8,16799,205,46,-2028,-1165,20.5,1379.5
4497276216,1,14,7,0,10,10,7,0,0,0,0,18022,7.4,19347,202,50,1382,2107,20.2,1802.2,20,3,1,10,10,11,1,0,1,0,16640,6.6,17240,186,29,-1382,-2107,18.6,1664.0
4505590856,0,74,4,1,3,2,7,0,0,0,0,14452,6.8,16280,202,40,47,-264,20.2,1445.2,16,0,0,2,3,2,1,1,0,0,14405,6.6,16544,226,48,-47,264,22.6,1440.5
4523793959,1,20,1,1,8,2,16,1,1,0,0,18186,7.4,19555,232,67,3131,2377,23.2,1818.6,14,2,0,2,8,5,0,0,0,0,15055,6.6,17178,231,50,-3131,-2377,23.1,1505.5
4477629107,0,17,1,0,11,10,14,1,1,0,0,17892,6.8,16641,157,41,-1361,-1031,15.7,1789.2,26,1,1,10,11,10,1,0,1,0,19253,6.8,17672,239,52,1361,1031,23.9,1925.3
4458389228,1,20,5,1,11,8,9,0,0,0,0,18746,7.2,19066,225,44,2198,1355,22.5,1874.6,18,1,0,8,11,4,1,1,0,0,16548,6.8,17711,204,64,-2198,-1355,20.4,1654.8
4498286628,0,11,1,0,0,10,0,0,0,0,0,12863,6.6,16182,177,56,-5961,-4133,17.7,1286.3,36,2,1,10,0,9,1,1,0,0,18824,7.6,20315,244,48,5961,4133,24.4,1882.4
4470228230,0,13,0,0,3,5,3,0,0,0,0,15136,6.8,17202,216,52,-401,-995,21.6,1513.6,11,2,1,5,3,2,0,0,0,0,15537,7.0,18197,240,40,401,995,24.0,1553.7
4513054107,1,17,1,0,5,5,6,0,0,0,0,16873,7.2,19105,223,64,1389,1418,22.3,1687.3,38,2,1,5,5,7,1,1,0,0,15484,6.8,17687,226,49,-1389,-1418,22.6,1548.4
4509657547,1,17,6,1,12,11,12,0,0,0,0,19237,7.2,18874,209,72,981,369,20.9,1923.7,14,3,0,11,12,11,0,0,0,0,18256,7.0,18505,233,32,-981,-369,23.3,1825.6
4524615195,1,12,2,0,10,8,9,2,1,1,0,19862,7.8,20693,252,64,2228,1524,25.2,1986.2,15,0,1,8,10,8,0,0,0,0,17634,7.2,19169,228,57,-2228,-1524,22.8,1763.4
4525582904,0,18,2,0,5,7,5,0,0,0,0,15195,6.6,16429,187,59,-2539,-1637,18.7,1519.5,33,0,1,7,5,5,0,0,0,1,17734,6.6,18066,223,40,2539,1637,22.3,1773.4
4518413320,1,37,6,0,5,1,6,1,0,1,0,16144,7.0,17907,226,65,2237,1009,22.6,1614.4,33,2,1,1,5,1,0,0,0,0,13907,6.8,16898,226,53,-2237,-1009,22.6,1390.7
4523945577,1,15,4,1,7,5,10,0,0,0,0,16987,6.8,18078,235,40,2407,543,23.5,1698.7,13,2,0,5,7,2,2,1,1,0,14580,6.8,17535,168,60,-2407,-543,16.8,1458.0
4525540282,0,17,4,1,14,5,26,1,1,0,0,19452,7.0,18579,209,45,3682,1284,20.9,1945.2,16,2,0,5,14,6,0,0,0,0,15770,6.6,17295,207,56,-3682,-1284,20.7,1577.0
4499812377,0,21,4,1,5,5,5,1,1,0,0,15371,6.8,16868,224,43,-612,-1300,22.4,1537.1,16,4,0,5,5,7,0,0,0,0,15983,7.2,18168,194,56,612,1300,19.4,1598.3
4523021460,1,15,3,1,3,1,3,0,0,0,0,16956,7.0,18863,270,55,3560,2311,27.0,1695.6,45,2,0,1,3,0,0,0,0,0,13396,6.6,16552,198,51,-3560,-2311,19.8,1339.6
4509007045,1,23,4,1,8,9,9,1,0,1,0,17610,6.8,17779,212,52,-1168,-674,21.2,1761.0,55,2,0,9,8,17,1,1,0,0,18778,7.2,18453,229,54,1168,674,22.9,1877.8
4519833399,0,17,1,0,6,6,4,1,0,1,0,16533,7.0,18187,217,61,85,765,21.7,1653.3,14,2,1,6,6,9,0,0,0,0,16448,6.8,17422,214,46,-85,-765,21.4,1644.8
4522402068,1,14,5,1,10,8,9,1,1,0,0,18265,7.2,19323,204,53,2520,3200,20.4,1826.5,17,1,0,8,10,7,1,0,1,0,15745,6.4,16123,163,32,-2520,-3200,16.3,1574.5
4448491393,0,19,3,0,0,6,0,0,0,0,0,13395,6.8,16282,207,47,-3275,-3254,20.7,1339.5,20,3,1,6,0,5,0,0,0,0,16670,7.2,19536,257,40,3275,3254,25.7,1667.0
4509036476,0,10,3,0,0,5,0,0,0,0,0,12905,6.2,15457,195,44,-3927,-3257,19.5,1290.5,17,3,1,5,0,5,0,0,0,0,16832,7.0,18714,211,78,3927,3257,21.1,1683.2
4517776059,1,17,3,1,10,1,8,1,1,0,0,18646,7.0,19491,237,49,5148,2922,23.7,1864.6,12,2,0,1,10,0,0,0,0,0,13498,6.4,16569,210,43,-5148,-2922,21.0,1349.8
4438638752,1,22,6,1,7,4,5,1,1,0,0,17382,7.4,19669,218,75,2164,3151,21.8,1738.2,30,7,0,4,7,7,0,0,0,0,15218,6.6,16518,205,48,-2164,-3151,20.5,1521.8
4525980245,0,17,1,1,3,6,6,0,0,0,0,14630,6.6,16137,181,71,-1309,-1408,18.1,1463.0,14,1,0,6,3,6,1,1,0,0,15939,6.6,17545,212,45,1309,1408,21.2,1593.9
4519483858,0,18,4,1,5,12,1,0,0,0,0,15217,6.4,16160,193,39,-4199,-3576,19.3,1521.7,26,5,0,12,5,10,1,1,0,0,19416,7.2,19736,270,48,4199,3576,27.0,1941.6
4475253617,0,37,3,1,2,4,1,0,0,0,0,15101,7.0,18673,241,64,-1443,-269,24.1,1510.1,44,1,0,4,2,5,1,1,0,0,16544,7.0,18942,217,68,1443,269,21.7,1654.4
4439747783,0,23,2,0,3,8,6,0,0,0,0,14517,6.4,15493,169,46,-3525,-3278,16.9,1451.7,13,0,1,8,3,15,2,1,1,0,18042,7.0,18771,202,79,3525,3278,20.2,1804.2
4483701739,0,20,2,0,3,10,3,1,1,0,0,14367,6.4,15957,192,53,-5085,-3236,19.2,1436.7,17,5,1,10,3,13,0,0,0,0,19452,7.4,19193,249,48,5085,3236,24.9,1945.2
4525234644,1,15,2,0,7,3,8,1,1,0,0,16389,7.0,18131,225,48,566,-528,22.5,1638.9,16,3,1,3,7,5,1,0,1,0,15823,7.2,18659,261,48,-566,528,26.1,1582.3
4517001678,0,13,3,0,6,12,5,1,1,0,0,15716,6.8,17135,189,46,-3393,-1177,18.9,1571.6,14,3,1,12,6,19,0,0,0,0,19109,6.8,18312,206,44,3393,1177,20.6,1910.9
4526234788,1,45,2,0,5,8,5,1,0,1,0,15420,6.8,16996,176,50,-2178,-1407,17.6,1542.0,14,2,1,8,5,7,1,1,0,0,17598,7.0,18403,219,34,2178,1407,21.9,1759.8
4514530540,1,16,2,1,7,2,8,0,0,0,0,17633,6.6,17885,226,47,3373,2234,22.6,1763.3,13,0,0,2,7,2,0,0,0,0,14260,6.6,15651,205,36,-3373,-2234,20.5,1426.0
4523843821,0,18,4,0,10,8,10,2,1,1,0,17272,7.0,18189,210,41,-88,555,21.0,1727.2,17,5,1,8,10,13,0,0,0,0,17360,7.0,17634,223,45,88,-555,22.3,1736.0
4462117148,0,38,5,1,3,6,5,2,1,1,0,15427,6.8,16873,209,48,-1186,-1760,20.9,1542.7,21,3,0,6,3,2,0,0,0,0,16613,7.2,18633,230,54,1186,1760,23.0,1661.3
4527204318,0,19,2,0,0,9,0,0,0,0,0,15090,7.0,18031,238,65,-1931,-299,23.8,1509.0,47,5,1,9,0,13,1,1,0,0,17021,7.2,18330,220,44,1931,299,22.0,1702.1
4521593829,1,37,1,0,8,7,14,1,1,0,0,16749,7.0,17759,174,56,243,-276,17.4,1674.9,20,2,1,7,8,1,0,0,0,0,16506,6.8,18035,227,51,-243,276,22.7,1650.6
4447488924,1,16,3,1,12,6,17,1,1,0,0,20010,7.2,20053,208,56,4311,2572,20.8,2001.0,17,4,0,6,12,5,0,0,0,0,15699,6.8,17481,214,33,-4311,-2572,21.4,1569.9
4458733619,0,34,4,0,7,7,6,0,0,0,0,17315,7.0,18632,218,48,297,518,21.8,1731.5,17,6,1,7,7,11,0,0,0,0,17018,7.0,18114,221,46,-297,-518,22.1,1701.8
4513194329,0,15,5,0,5,8,6,0,0,0,0,16230,6.8,18114,230,57,-1222,-125,23.0,1623.0,20,2,1,8,5,9,1,0,1,0,17452,6.8,18239,221,36,1222,125,22.1,1745.2
4506388090,0,12,5,0,3,12,2,1,0,1,0,15111,6.8,17710,210,68,-3620,-2690,21.0,1511.1,17,4,1,12,3,9,1,1,0,0,18731,7.2,20400,236,45,3620,2690,23.6,1873.1
4501055152,0,48,4,1,2,3,2,1,1,0,0,14607,6.6,16424,222,45,-1183,-2491,22.2,1460.7,12,5,0,3,2,1,0,0,0,0,15790,7.0,18915,228,58,1183,2491,22.8,1579.0
4486155288,1,83,6,0,6,4,7,2,1,1,0,16699,7.0,18503,242,55,1109,718,24.2,1669.9,19,5,1,4,6,6,0,0,0,0,15590,6.8,17785,237,41,-1109,-718,23.7,1559.0
4518881307,0,17,2,0,3,7,5,0,0,0,0,14676,6.6,16668,170,59,-1563,-1232,17.0,1467.6,18,1,1,7,3,3,1,1,0,0,16239,6.8,17900,201,52,1563,1232,20.1,1623.9
4465542010,1,18,1,1,5,5,4,1,0,1,0,16278,7.0,18389,244,56,269,480,24.4,1627.8,13,2,0,5,5,5,0,0,0,0,16009,7.0,17909,219,60,-269,-480,21.9,1600.9
4446116098,1,17,1,1,7,5,5,2,1,1,0,17227,7.6,20568,218,56,1329,1625,21.8,1722.7,13,4,0,5,7,3,0,0,0,0,15898,7.0,18943,207,73,-1329,-1625,20.7,1589.8
4525061543,0,45,18,1,8,9,11,0,0,0,0,17951,6.8,17922,226,39,-194,431,22.6,1795.1,47,4,0,9,8,12,0,0,0,0,18145,6.8,17491,227,48,194,-431,22.7,1814.5
4520768462,0,17,7,0,11,8,15,0,0,0,0,17069,6.6,16703,174,38,229,-45,17.4,1706.9,17,5,1,8,11,9,2,1,1,0,16840,6.8,16748,212,44,-229,45,21.2,1684.0
4520853310,1,16,21,0,4,4,7,0,0,0,0,15536,6.6,17282,190,43,-680,410,19.0,1553.6,62,0,1,4,4,8,1,1,0,0,16216,6.6,16872,215,53,680,-410,21.5,1621.6
4484558599,0,12,0,0,1,9,1,1,1,0,0,13727,6.6,16509,207,62,-5000,-4822,20.7,1372.7,27,2,1,9,1,6,0,0,0,0,18727,7.6,21331,254,77,5000,4822,25.4,1872.7
4452404347,1,17,1,0,12,7,7,0,0,0,0,17539,7.6,20178,189,46,686,765,18.9,1753.9,27,2,1,7,12,7,0,0,0,0,16853,7.0,19413,208,63,-686,-765,20.8,1685.3
4468356736,0,14,2,1,10,10,17,1,1,0,0,18847,7.2,19480,213,76,987,642,21.3,1884.7,14,1,0,10,10,8,0,0,0,0,17860,7.2,18838,206,56,-987,-642,20.6,1786.0
4518359137,0,12,1,1,8,8,6,0,0,0,0,16983,7.2,18675,198,52,-125,-479,19.8,1698.3,15,4,0,8,8,7,1,1,0,0,17108,7.4,19154,208,51,125,479,20.8,1710.8
4481630032,0,18,1,1,5,1,6,1,1,0,0,15381,7.0,17703,211,51,759,657,21.1,1538.1,15,6,0,1,5,0,0,0,0,0,14622,6.8,17046,245,50,-759,-657,24.5,1462.2
4448082269,1,15,7,1,8,4,7,1,0,1,0,17328,7.0,18867,234,56,2156,3157,23.4,1732.8,22,1,0,4,8,8,0,0,0,0,15172,6.2,15710,225,35,-2156,-3157,22.5,1517.2
4500726742,0,14,6,0,2,8,1,1,0,1,0,13895,6.6,16914,210,44,-2894,-1742,21.0,1389.5,17,2,1,8,2,9,1,1,0,0,16789,7.0,18656,208,55,2894,1742,20.8,1678.9
4518835789,1,22,6,1,7,3,6,1,1,0,0,19140,7.4,19579,253,64,5008,2355,25.3,1914.0,60,6,0,3,7,3,1,0,1,0,14132,6.8,17224,179,45,-5008,-2355,17.9,1413.2
4506682192,0,11,2,0,3,6,1,0,0,0,0,13899,6.4,16444,202,36,-3238,-2465,20.2,1389.9,14,4,1,6,3,7,1,1,0,0,17137,7.2,18909,261,45,3238,2465,26.1,1713.7
4424206558,1,17,1,1,7,8,10,1,1,0,0,16863,6.6,17727,216,48,106,-462,21.6,1686.3,14,0,0,8,7,9,0,0,0,0,16757,7.2,18189,184,52,-106,462,18.4,1675.7
4526662466,0,12,3,1,7,5,8,1,0,1,0,17315,6.8,18122,229,50,1792,217,22.9,1731.5,40,2,0,5,7,8,1,1,0,0,15523,6.8,17905,226,47,-1792,-217,22.6,1552.3
4514180847,1,17,3,1,10,5,12,2,1,1,0,18625,7.2,18897,223,63,3149,2125,22.3,1862.5,17,1,0,5,10,4,0,0,0,0,15476,6.8,16772,227,40,-3149,-2125,22.7,1547.6
4524444788,1,14,1,1,5,6,4,0,0,0,0,16481,7.2,18268,221,53,563,-1127,22.1,1648.1,14,2,0,6,5,4,1,1,0,0,15918,7.2,19395,217,52,-563,1127,21.7,1591.8
4497094157,0,45,6,0,7,4,6,0,0,0,0,16258,7.0,18355,207,43,-487,764,20.7,1625.8,17,3,1,4,7,4,1,0,1,1,16745,6.6,17591,207,61,487,-764,20.7,1674.5
4506595531,1,15,2,1,5,4,5,0,0,0,0,14797,6.6,16703,195,40,-1576,-1720,19.5,1479.7,15,2,0,4,5,2,1,1,0,0,16373,6.8,18423,259,48,1576,1720,25.9,1637.3
4525315485,0,15,0,0,6,8,6,0,0,0,0,16132,6.8,18331,199,57,-1850,-1016,19.9,1613.2,16,2,1,8,6,9,1,1,0,0,17982,7.4,19347,243,54,1850,1016,24.3,1798.2
4495660541,0,15,0,1,6,7,13,1,0,1,0,16587,6.6,16824,199,47,457,-383,19.9,1658.7,15,2,0,7,6,13,1,1,0,0,16130,6.8,17207,194,40,-457,383,19.4,1613.0
4453712057,0,16,4,1,6,6,5,1,0,1,0,17783,7.6,19374,236,72,1498,149,23.6,1778.3,13,3,0,6,6,7,1,1,0,0,16285,7.4,19225,213,61,-1498,-149,21.3,1628.5
4526222193,1,21,6,1,6,1,7,1,1,0,0,17231,7.2,19272,237,80,3142,2037,23.7,1723.1,18,0,0,1,6,1,0,0,0,0,14089,6.8,17235,245,44,-3142,-2037,24.5,1408.9
4520611653,0,17,3,0,6,11,5,0,0,0,0,16864,7.0,18758,219,49,-1406,-1006,21.9,1686.4,15,1,1,11,6,12,0,0,0,0,18270,7.2,19764,195,67,1406,1006,19.5,1827.0
4453522690,0,19,7,1,5,3,6,1,1,0,0,16116,6.8,18086,249,60,493,-699,24.9,1611.6,43,5,0,3,5,3,0,0,0,0,15623,7.2,18785,250,48,-493,699,25.0,1562.3
4526645317,1,12,2,0,3,7,5,0,0,0,0,15521,7.0,17703,210,63,-1079,233,21.0,1552.1,48,1,1,7,3,14,1,1,0,0,16600,7.0,17470,215,44,1079,-233,21.5,1660.0
4525092845,0,16,1,1,5,10,3,1,0,1,0,16141,7.0,17238,229,52,-1634,-2844,22.9,1614.1,14,3,0,10,5,10,0,0,0,0,17775,7.6,20082,240,40,1634,2844,24.0,1777.5
4486426740,1,14,0,0,3,4,4,1,1,0,0,15178,7.0,18172,209,64,-767,-606,20.9,1517.8,14,2,1,4,3,4,1,0,1,0,15945,7.0,18778,229,64,767,606,22.9,1594.5
4492269154,1,15,3,0,7,7,12,0,0,0,0,17329,6.8,17342,212,60,216,259,21.2,1732.9,49,2,1,7,7,12,0,0,0,0,17113,6.8,17083,181,52,-216,-259,18.1,1711.3
4523110443,1,23,1,0,7,4,8,1,0,1,1,17617,6.6,17519,199,47,241,307,19.9,1761.7,25,3,1,4,7,7,1,1,0,1,17376,6.6,17212,214,58,-241,-307,21.4,1737.6
4502375792,0,13,1,0,6,14,5,1,0,1,1,16749,6.2,15390,203,23,-3586,-2840,20.3,1674.9,67,2,1,14,6,25,1,1,0,1,20335,7.2,18230,194,39,3586,2840,19.4,2033.5
4426518452,1,27,7,0,5,4,4,1,1,0,0,15712,6.8,17969,221,46,-169,282,22.1,1571.2,23,4,1,4,5,4,0,0,0,0,15881,6.8,17687,235,50,169,-282,23.5,1588.1
4468712896,1,23,5,1,7,6,6,1,1,0,0,17743,7.4,19173,255,52,1572,829,25.5,1774.3,16,3,0,6,7,4,0,0,0,0,16171,7.0,18344,218,47,-1572,-829,21.8,1617.1
4519757776,1,14,2,0,4,3,3,1,1,0,0,15988,7.0,18515,251,52,623,640,25.1,1598.8,14,2,1,3,4,2,1,0,1,0,15365,7.0,17875,234,56,-623,-640,23.4,1536.5
4475316564,1,13,4,1,7,2,2,1,1,0,0,16116,7.2,19219,246,49,1409,2205,24.6,1611.6,19,0,0,2,7,2,0,0,0,0,14707,6.8,17014,203,51,-1409,-2205,20.3,1470.7
4522487692,1,14,3,0,3,6,4,0,0,0,0,15930,7.0,19263,241,71,-1240,-793,24.1,1593.0,14,4,1,6,3,6,1,1,0,0,17170,7.2,20056,252,64,1240,793,25.2,1717.0
4524109040,1,15,2,1,4,1,4,2,1,1,0,16305,7.2,19758,253,64,1793,929,25.3,1630.5,15,2,0,1,4,1,0,0,0,0,14512,7.2,18829,204,76,-1793,-929,20.4,1451.2
4525946644,0,18,1,0,4,8,5,1,1,0,0,15901,7.0,18666,245,60,-2522,-1763,24.5,1590.1,12,2,1,8,4,7,0,0,0,0,18423,7.6,20429,250,68,2522,1763,25.0,1842.3
4522266851,0,14,1,0,1,3,2,0,0,0,0,14054,6.6,17175,205,64,-1744,-1555,20.5,1405.4,14,5,1,3,1,3,1,1,0,0,15798,7.0,18730,232,48,1744,1555,23.2,1579.8
4474379367,1,12,3,1,7,10,7,1,1,0,0,17062,7.2,18221,220,50,-1246,150,22.0,1706.2,17,2,0,10,7,12,0,0,0,0,18308,6.8,18071,203,58,1246,-150,20.3,1830.8
4527413531,0,16,3,0,7,13,9,0,0,0,0,16090,6.6,16407,182,44,-4191,-2861,18.2,1609.0,18,5,1,13,7,26,1,1,0,0,20281,7.4,19268,219,46,4191,2861,21.9,2028.1
4492000436,0,53,4,0,2,11,2,1,0,1,0,14164,6.8,16392,202,44,-5120,-2590,20.2,1416.4,43,6,1,11,2,18,0,0,0,0,19284,7.2,18982,232,52,5120,2590,23.2,1928.4
4484423915,0,16,3,1,3,4,4,1,1,0,0,15929,7.0,17996,236,62,-688,-1113,23.6,1592.9,16,7,0,4,3,4,0,0,0,0,16617,7.2,19109,269,57,688,1113,26.9,1661.7
4465134989,1,22,7,1,6,3,5,1,1,0,0,16942,7.0,18645,216,71,2032,2196,21.6,1694.2,85,4,0,3,6,3,0,0,0,0,14910,6.4,16449,210,48,-2032,-2196,21.0,1491.0
4499786377,0,35,0,0,5,4,3,1,1,0,0,16123,7.0,18987,235,52,857,961,23.5,1612.3,13,2,1,4,5,5,0,0,0,0,15266,7.0,18026,202,55,-857,-961,20.2,1526.6
4500522425,1,18,4,0,7,2,7,1,1,0,0,17103,7.0,19263,221,56,2481,2112,22.1,1710.3,18,4,1,2,7,2,0,0,0,0,14622,7.0,17151,210,52,-2481,-2112,21.0,1462.2
4479510893,0,49,2,1,8,8,14,0,0,0,0,17346,6.8,16570,191,41,1399,1293,19.1,1734.6,21,5,0,8,8,14,0,0,0,0,15947,6.2,15277,193,34,-1399,-1293,19.3,1594.7
4523651939,0,17,3,0,2,4,4,0,0,0,0,13298,6.6,16659,192,37,-3826,-2595,19.2,1329.8,14,3,1,4,2,5,1,1,0,0,17124,7.2,19254,250,74,3826,2595,25.0,1712.4
4484592452,1,18,4,1,12,9,20,0,0,0,0,20188,7.2,18981,226,47,2735,1076,22.6,2018.8,15,2,0,9,12,19,0,0,0,0,17453,6.8,17905,198,42,-2735,-1076,19.8,1745.3
4525110748,0,15,3,0,8,5,6,2,1,1,0,17744,7.2,19502,237,59,1109,735,23.7,1774.4,14,1,1,5,8,3,0,0,0,0,16635,7.2,18767,231,60,-1109,-735,23.1,1663.5
4492236236,0,13,0,0,2,10,1,0,0,0,0,13872,6.4,17095,197,43,-6115,-3209,19.7,1387.2,15,4,1,10,2,9,0,0,0,0,19987,7.4,20304,264,47,6115,3209,26.4,1998.7
4493059433,1,14,0,1,10,4,10,1,0,1,1,19107,7.4,20103,230,56,3799,2856,23.0,1910.7,11,2,0,4,10,3,0,0,0,0,15308,6.8,17247,210,56,-3799,-2856,21.0,1530.8
4517498934,1,18,2,1,1,1,2,1,1,0,0,14426,6.8,17085,219,52,-323,-615,21.9,1442.6,18,0,0,1,1,2,0,0,0,0,14749,6.6,17700,243,44,323,615,24.3,1474.9
4464488268,1,18,3,1,2,2,2,1,0,1,0,15260,7.0,18522,220,71,-505,-602,22.0,1526.0,17,2,0,2,2,1,1,1,0,0,15765,7.2,19124,249,71,505,602,24.9,1576.5
4515832303,0,49,4,0,3,5,4,0,0,0,0,14586,6.6,16499,194,49,-1494,-700,19.4,1458.6,15,2,1,5,3,5,0,0,0,0,16080,6.6,17199,231,45,1494,700,23.1,1608.0
4501447640,1,17,1,0,1,2,2,0,0,0,0,14402,6.6,17052,233,52,-688,-577,23.3,1440.2,14,2,1,2,1,3,1,1,0,0,15090,6.8,17629,258,54,688,577,25.8,1509.0
4509068036,0,15,3,1,4,0,2,0,0,0,0,16024,6.8,19005,220,62,3133,2377,22.0,1602.4,14,2,0,0,4,0,0,0,0,0,12891,6.6,16628,206,44,-3133,-2377,20.6,1289.1
4514399530,0,12,0,0,6,10,9,0,0,0,0,16291,6.8,17343,188,52,-2893,-2027,18.8,1629.1,14,2,1,10,6,15,2,1,1,0,19184,7.2,19370,236,60,2893,2027,23.6,1918.4
4462579984,0,21,3,1,10,8,7,0,0,0,0,17823,6.6,17275,237,36,828,-79,23.7,1782.3,17,1,0,8,10,5,1,1,0,0,16995,6.8,17354,200,47,-828,79,20.0,1699.5
4488956857,0,14,2,1,5,8,5,1,1,0,0,15786,6.6,16737,219,44,-1860,-2194,21.9,1578.6,12,2,0,8,5,11,1,0,1,0,17646,7.2,18931,231,44,1860,2194,23.1,1764.6
4516604848,0,15,1,1,6,6,5,0,0,0,0,15868,6.6,16452,201,38,-585,-795,20.1,1586.8,17,3,0,6,6,7,0,0,0,0,16453,6.8,17247,242,41,585,795,24.2,1645.3
4513070256,0,84,3,0,5,12,4,0,0,0,0,15819,7.0,18015,199,54,-3176,-2235,19.9,1581.9,14,2,1,12,5,17,1,1,0,0,18995,7.6,20250,222,50,3176,2235,22.2,1899.5
4517767326,0,10,2,0,1,8,2,0,0,0,0,14012,6.4,15628,211,44,-2447,-1476,21.1,1401.2,16,1,1,8,1,10,0,0,0,0,16459,6.6,17104,198,39,2447,1476,19.8,1645.9
4526636452,0,30,4,1,9,7,13,0,0,0,0,16374,6.6,15811,152,65,1057,-143,15.2,1637.4,16,3,0,7,9,6,1,1,0,0,15317,6.6,15954,196,44,-1057,143,19.6,1531.7
4475259574,1,15,3,1,2,3,2,1,1,0,0,14535,6.4,16699,234,35,-988,-1427,23.4,1453.5,16,1,0,3,2,4,1,0,1,0,15523,7.0,18126,241,48,988,1427,24.1,1552.3
4502743834,0,25,4,1,4,8,8,1,0,1,0,15167,6.4,15683,220,37,-1645,-1268,22.0,1516.7,16,6,0,8,4,17,0,0,0,0,16812,6.4,16951,198,44,1645,1268,19.8,1681.2
4523749489,1,13,8,1,6,7,9,0,0,0,0,15815,6.6,16506,206,40,-1053,-2759,20.6,1581.5,37,3,0,7,6,7,1,1,0,0,16868,7.4,19265,247,43,1053,2759,24.7,1686.8
4467793261,1,14,2,1,3,2,3,0,0,0,0,15422,6.8,16988,215,63,1391,214,21.5,1542.2,16,2,0,2,3,3,1,1,0,0,14031,6.8,16774,232,36,-1391,-214,23.2,1403.1
4505375338,1,21,3,0,5,5,8,2,1,1,0,16709,7.0,18855,222,68,728,2095,22.2,1670.9,15,7,1,5,5,8,0,0,0,0,15981,6.8,16760,224,44,-728,-2095,22.4,1598.1
4470191400,1,14,3,0,7,4,10,1,1,0,0,17978,7.4,18771,216,66,2604,432,21.6,1797.8,14,5,1,4,7,0,0,0,0,0,15374,7.0,18339,220,51,-2604,-432,22.0,1537.4
4455506797,0,10,4,0,8,8,13,1,0,1,0,18236,7.0,18690,221,48,1112,203,22.1,1823.6,43,0,1,8,8,12,0,0,0,0,17124,7.0,18487,198,44,-1112,-203,19.8,1712.4
4525586479,1,56,6,1,7,6,9,1,0,1,0,16647,6.6,17867,214,60,-206,-363,21.4,1664.7,16,5,0,6,7,10,1,1,0,0,16853,7.0,18230,238,39,206,363,23.8,1685.3
4526548398,0,15,3,1,5,4,9,0,0,0,0,15633,6.8,17562,222,44,148,-543,22.2,1563.3,17,3,0,4,5,4,0,0,0,0,15485,7.0,18105,210,56,-148,543,21.0,1548.5
4524848216,0,35,3,0,6,8,4,0,0,0,0,15589,6.6,16619,181,40,-1535,-2054,18.1,1558.9,38,1,1,8,6,10,1,0,1,0,17124,7.0,18673,210,56,1535,2054,21.0,1712.4
4516068485,0,37,4,0,0,10,0,0,0,0,0,12837,6.2,15086,196,36,-5369,-5193,19.6,1283.7,20,3,1,10,0,10,2,1,1,0,18206,7.2,20279,242,47,5369,5193,24.2,1820.6
4512523488,1,17,0,1,7,2,10,1,1,0,0,17336,7.0,18459,231,52,2866,1474,23.1,1733.6,49,2,0,2,7,0,0,0,0,0,14470,6.8,16985,198,54,-2866,-1474,19.8,1447.0
4526272276,0,15,2,0,1,6,1,0,0,0,0,13409,6.6,15601,203,45,-3559,-3320,20.3,1340.9,12,1,1,6,1,4,2,1,1,0,16968,7.0,18921,236,69,3559,3320,23.6,1696.8
4513961751,1,15,3,1,10,9,14,1,1,0,0,18513,7.0,17991,213,60,710,288,21.3,1851.3,17,1,0,9,10,13,0,0,0,0,17803,6.8,17703,191,56,-710,-288,19.1,1780.3
4503121126,0,17,3,1,9,6,11,0,0,0,0,17372,6.8,17545,202,42,1491,1101,20.2,1737.2,17,4,0,6,9,6,2,1,1,0,15881,6.4,16444,206,48,-1491,-1101,20.6,1588.1
4521106254,0,15,0,0,10,6,13,0,0,0,0,17976,7.4,18454,176,52,1642,1965,17.6,1797.6,13,1,1,6,10,5,1,1,0,0,16334,6.4,16489,195,46,-1642,-1965,19.5,1633.4
4527043235,0,15,1,1,6,3,6,0,0,0,0,16986,7.0,18376,226,35,2587,1971,22.6,1698.6,13,2,0,3,6,4,1,1,0,0,14399,6.6,16405,208,40,-2587,-1971,20.8,1439.9
4520518919,0,18,1,0,5,4,5,0,0,0,0,15984,7.2,17527,203,54,193,89,20.3,1598.4,15,3,1,4,5,4,0,0,0,0,15791,6.8,17438,222,50,-193,-89,22.2,1579.1
4523516940,0,16,3,1,5,7,4,0,0,0,0,15866,6.6,16957,222,51,-635,-2299,22.2,1586.6,15,1,0,7,5,5,1,1,0,0,16501,7.2,19256,215,56,635,2299,21.5,1650.1
4527694492,0,15,2,1,10,3,14,1,1,0,1,18911,6.8,18311,205,48,4335,1377,20.5,1891.1,15,1,0,3,10,4,1,0,1,0,14576,6.6,16934,192,50,-4335,-1377,19.2,1457.6
4476639744,0,16,1,0,4,4,4,0,0,0,0,15778,7.2,18381,219,40,36,-325,21.9,1577.8,15,0,1,4,4,1,0,0,0,0,15742,7.2,18706,220,64,-36,325,22.0,1574.2
4438156005,0,13,2,1,5,7,3,2,1,1,0,15592,7.0,18837,205,64,-1711,-303,20.5,1559.2,17,4,0,7,5,8,0,0,0,0,17303,7.2,19140,241,56,1711,303,24.1,1730.3
4512229508,1,20,1,0,7,9,6,0,0,0,0,17214,7.0,18251,231,49,-1806,123,23.1,1721.4,23,6,1,9,7,13,1,1,0,1,19020,7.0,18128,204,54,1806,-123,20.4,1902.0
4524104535,1,13,2,1,7,2,5,1,0,1,0,16242,7.0,17867,218,48,2156,2101,21.8,1624.2,17,0,0,2,7,3,0,0,0,0,14086,6.4,15766,212,38,-2156,-2101,21.2,1408.6
4436942531,0,19,5,1,9,6,10,0,0,0,0,16544,6.6,16417,191,41,1239,568,19.1,1654.4,47,2,0,6,9,8,1,0,1,0,15305,6.4,15849,179,41,-1239,-568,17.9,1530.5
4505017372,1,11,4,1,13,7,10,1,1,0,3,22228,7.2,18219,234,54,8657,7609,23.4,2222.8,11,1,0,7,13,9,0,0,0,0,13571,4.8,10610,107,29,-8657,-7609,10.7,1357.1
4471433408,0,16,4,1,10,6,11,1,1,0,0,18001,7.0,18571,216,50,1510,151,21.6,1800.1,14,2,0,6,10,6,0,0,0,0,16491,6.8,18420,231,45,-1510,-151,23.1,1649.1
4493814352,1,12,3,0,5,3,5,0,0,0,0,16076,7.2,18917,245,48,1067,1824,24.5,1607.6,18,3,1,3,5,2,0,0,0,0,15009,6.8,17093,235,48,-1067,-1824,23.5,1500.9
4457019061,1,17,5,1,7,8,8,0,0,0,0,17363,6.8,17169,188,44,903,1019,18.8,1736.3,25,3,0,8,7,7,1,0,1,0,16460,6.4,16150,205,35,-903,-1019,20.5,1646.0
4526226027,0,55,7,0,3,4,7,1,0,1,0,14996,6.6,16984,221,47,-444,240,22.1,1499.6,20,5,1,4,3,8,1,1,0,0,15440,6.6,16744,197,42,444,-240,19.7,1544.0
4513140089,1,32,1,1,10,6,10,0,0,0,0,18787,7.2,18788,212,46,2048,1050,21.2,1878.7,11,4,0,6,10,7,0,0,0,0,16739,7.0,17738,228,52,-2048,-1050,22.8,1673.9
4472611324,0,25,7,1,6,3,6,0,0,0,0,15048,7.0,17356,183,34,-1138,-867,18.3,1504.8,17,7,0,3,6,3,1,1,0,0,16186,7.0,18223,253,54,1138,867,25.3,1618.6
4519404652,0,22,1,1,7,6,6,0,0,0,0,16420,6.8,17929,209,55,-514,-1465,20.9,1642.0,36,3,0,6,7,9,1,1,0,0,16934,7.2,19394,236,68,514,1465,23.6,1693.4
4525382011,0,10,2,0,5,11,5,0,0,0,0,16375,7.0,18609,231,60,-1189,-1074,23.1,1637.5,17,1,1,11,5,7,1,1,0,0,17564,7.4,19683,217,38,1189,1074,21.7,1756.4
4472130589,1,15,5,0,4,7,2,1,1,0,0,15682,6.8,17438,234,60,-1075,73,23.4,1568.2,19,2,1,7,4,6,0,0,0,0,16757,6.8,17365,213,51,1075,-73,21.3,1675.7
4526245865,1,126,2,1,9,6,10,1,1,0,0,17951,7.2,18755,228,48,1464,179,22.8,1795.1,16,3,0,6,9,7,1,0,1,0,16487,6.8,18576,233,44,-1464,-179,23.3,1648.7
4503402454,0,18,3,1,11,8,15,0,0,0,0,18923,7.0,18843,225,68,1744,454,22.5,1892.3,16,2,0,8,11,7,1,0,1,0,17179,7.0,18389,219,48,-1744,-454,21.9,1717.9
4502735326,1,16,1,1,7,6,7,0,0,0,0,16672,7.0,18698,210,58,-521,860,21.0,1667.2,13,4,0,6,7,11,1,1,0,0,17193,7.0,17838,250,48,521,-860,25.0,1719.3
4510820768,1,11,0,1,7,2,7,1,1,0,0,18117,7.4,19804,236,72,5779,5212,23.6,1811.7,17,0,0,2,7,0,0,0,0,0,12338,5.6,14592,197,8,-5779,-5212,19.7,1233.8
4477133738,0,14,3,0,7,9,5,0,0,0,0,16855,7.2,18568,221,59,-1297,-856,22.1,1685.5,79,1,1,9,7,8,1,1,0,0,18152,7.2,19424,229,51,1297,856,22.9,1815.2
4477499518,1,23,3,1,12,8,10,0,0,0,0,17668,6.8,17036,184,40,-120,-393,18.4,1766.8,15,3,0,8,12,8,0,0,0,0,17788,6.8,17429,194,36,120,393,19.4,1778.8
4458884103,0,16,2,1,11,6,9,1,1,0,0,17537,7.2,19736,196,56,2607,1862,19.6,1753.7,11,2,0,6,11,2,0,0,0,0,14930,7.0,17874,183,44,-2607,-1862,18.3,1493.0
4510678710,0,15,3,0,5,7,5,0,0,0,0,14459,6.4,14990,182,40,-2251,-2427,18.2,1445.9,18,3,1,7,5,10,1,1,0,0,16710,6.8,17417,198,60,2251,2427,19.8,1671.0
4517708245,1,15,2,1,4,12,7,0,0,0,0,15123,6.6,15874,169,48,-4949,-3427,16.9,1512.3,16,4,0,12,4,14,2,1,1,1,20072,7.2,19301,221,56,4949,3427,22.1,2007.2
4452102075,1,59,2,1,5,2,8,1,1,0,0,17010,7.0,18660,250,58,2312,1175,25.0,1701.0,34,3,0,2,5,2,0,0,0,0,14698,6.6,17485,220,54,-2312,-1175,22.0,1469.8
4519628071,0,13,1,0,1,7,1,1,0,1,0,13741,6.4,15605,179,56,-2955,-2776,17.9,1374.1,16,2,1,7,1,7,1,1,0,0,16696,7.0,18381,220,47,2955,2776,22.0,1669.6
4496732986,0,13,5,1,7,5,10,0,0,0,0,16521,7.0,17150,223,35,413,-857,22.3,1652.1,43,1,0,5,7,5,0,0,0,0,16108,7.0,18007,197,56,-413,857,19.7,1610.8
4513005798,0,13,0,0,9,5,7,1,1,0,0,17322,7.0,18525,255,44,1372,2320,25.5,1732.2,13,1,1,5,9,6,0,0,0,0,15950,6.6,16205,213,52,-1372,-2320,21.3,1595.0
4520419730,1,18,2,1,5,6,5,2,1,1,0,16635,7.4,19221,235,76,152,-57,23.5,1663.5,37,3,0,6,5,10,0,0,0,0,16483,7.4,19278,233,40,-152,57,23.3,1648.3
4523806896,0,19,0,0,3,8,4,0,0,0,0,14462,6.4,16255,210,43,-2247,-1501,21.0,1446.2,91,2,1,8,3,7,1,1,0,0,16709,6.8,17756,213,64,2247,1501,21.3,1670.9
4527083339,0,18,3,0,3,10,2,0,0,0,0,15142,6.8,16713,211,52,-3107,-1687,21.1,1514.2,19,5,1,10,3,21,1,1,0,0,18249,6.8,18400,222,53,3107,1687,22.2,1824.9
4503411816,1,17,3,1,5,1,6,0,0,0,0,16733,7.2,19698,231,62,1901,1126,23.1,1673.3,14,4,0,1,5,1,2,1,1,0,14832,7.0,18572,239,68,-1901,-1126,23.9,1483.2
4440050075,1,17,1,1,7,1,5,1,1,0,1,18772,7.2,18771,255,55,5169,2153,25.5,1877.2,10,3,0,1,7,1,0,0,0,0,13603,6.6,16618,200,48,-5169,-2153,20.0,1360.3
4502220585,1,19,4,1,15,4,23,1,1,0,1,22134,7.6,20809,234,59,8151,5114,23.4,2213.4,15,2,0,4,15,6,0,0,0,0,13983,6.2,15695,176,34,-8151,-5114,17.6,1398.3
4507922418,0,40,3,0,11,9,10,1,1,0,0,18342,7.2,19368,190,65,-30,1414,19.0,1834.2,45,11,1,9,11,10,0,0,0,0,18372,7.0,17954,164,48,30,-1414,16.4,1837.2
4477806643,0,16,6,1,4,5,5,0,0,0,0,15717,6.8,17679,224,44,-527,-208,22.4,1571.7,62,4,0,5,4,9,1,1,0,0,16244,6.8,17887,199,75,527,208,19.9,1624.4
4511713193,0,13,4,0,2,6,2,1,1,0,0,14596,6.8,17298,204,81,-1883,-1131,20.4,1459.6,16,2,1,6,2,2,0,0,0,0,16479,6.8,18429,254,43,1883,1131,25.4,1647.9
4513103851,0,17,2,1,7,7,8,1,1,0,0,17191,6.8,17267,206,48,-347,-2753,20.6,1719.1,14,1,0,7,7,11,0,0,0,0,17538,7.6,20020,212,68,347,2753,21.2,1753.8
4515270451,0,36,4,0,5,7,5,0,0,0,0,15708,6.8,17420,220,41,-1127,-2006,22.0,1570.8,13,2,1,7,5,4,0,0,0,0,16835,7.0,19426,226,52,1127,2006,22.6,1683.5
4469375094,1,80,5,0,5,10,3,0,0,0,0,16637,6.8,17846,219,40,-2368,618,21.9,1663.7,56,6,1,10,5,14,1,1,0,1,19005,7.0,17228,224,48,2368,-618,22.4,1900.5
4513598574,1,14,1,1,8,6,7,0,0,0,0,18634,7.0,19500,239,56,2077,1804,23.9,1863.4,17,3,0,6,8,12,1,1,0,0,16557,6.8,17696,196,71,-2077,-1804,19.6,1655.7
4460970980,0,15,0,0,3,8,3,0,0,0,0,15036,7.2,17957,198,60,-2855,-2453,19.8,1503.6,15,2,1,8,3,7,1,1,0,0,17891,7.4,20410,269,52,2855,2453,26.9,1789.1
4527434584,1,15,16,1,10,7,11,1,1,0,0,19052,7.0,18439,242,47,2514,1416,24.2,1905.2,38,2,0,7,10,11,0,0,0,0,16538,6.6,17023,197,48,-2514,-1416,19.7,1653.8
4501204350,1,14,3,1,9,7,12,0,0,0,0,17491,6.6,16826,200,48,233,-1221,20.0,1749.1,74,0,0,7,9,8,0,0,0,0,17258,6.8,18047,216,45,-233,1221,21.6,1725.8
4495179602,0,13,1,0,2,12,4,0,0,0,0,14199,6.4,16214,167,55,-7911,-3435,16.7,1419.9,14,2,1,12,2,17,1,1,0,2,22110,7.2,19649,223,48,7911,3435,22.3,2211.0
4505414237,0,17,3,1,5,5,6,0,0,0,0,16563,6.8,17565,226,53,1149,-530,22.6,1656.3,19,5,0,5,5,6,0,0,0,0,15414,6.8,18095,205,51,-1149,530,20.5,1541.4
4480746827,0,38,1,0,2,7,3,0,0,0,0,13825,6.8,16773,173,48,-3453,-2582,17.3,1382.5,15,0,1,7,2,4,0,0,0,0,17278,7.4,19355,237,48,3453,2582,23.7,1727.8
4503029657,1,18,4,0,10,9,10,0,0,0,0,18209,6.8,16955,200,37,1287,440,20.0,1820.9,11,1,1,9,10,16,0,0,0,0,16922,6.2,16515,198,53,-1287,-440,19.8,1692.2
4450783811,0,15,3,0,5,7,4,0,0,0,0,16078,6.8,18042,217,60,-1408,-1192,21.7,1607.8,12,5,1,7,5,12,1,1,0,0,17486,7.0,19234,245,58,1408,1192,24.5,1748.6
4484976193,0,19,2,0,11,11,10,0,0,0,0,18174,6.8,17137,222,34,-787,-926,22.2,1817.4,17,5,1,11,11,16,1,1,0,0,18961,6.6,18063,225,40,787,926,22.5,1896.1
4527311362,1,15,1,1,6,1,9,0,0,0,0,17226,7.4,19043,269,52,2955,2093,26.9,1722.6,82,1,0,1,6,1,1,0,1,0,14271,6.8,16950,224,56,-2955,-2093,22.4,1427.1
4522255964,1,15,1,0,6,7,5,1,0,1,0,16461,7.0,18295,173,64,-667,1243,17.3,1646.1,17,3,1,7,6,9,0,0,0,0,17128,6.6,17052,224,39,667,-1243,22.4,1712.8
4524371920,0,11,4,1,6,7,3,1,0,1,0,16568,7.0,18066,215,60,-727,322,21.5,1656.8,15,2,0,7,6,10,1,1,0,0,17295,7.0,17744,211,42,727,-322,21.1,1729.5
4502334465,1,18,4,1,11,8,16,1,0,1,1,20639,7.2,18457,207,61,4639,3197,20.7,2063.9,15,3,0,8,11,10,1,1,0,0,16000,6.2,15260,159,55,-4639,-3197,15.9,1600.0
4478447096,0,16,1,1,8,8,9,0,0,0,0,17057,6.6,17009,190,48,240,-903,19.0,1705.7,17,2,0,8,8,9,0,0,0,0,16817,7.0,17912,197,51,-240,903,19.7,1681.7
4521231615,1,14,3,0,5,10,6,0,0,0,0,16373,6.8,16941,237,51,-1343,-1261,23.7,1637.3,16,1,1,10,5,17,1,1,0,0,17716,6.8,18202,195,57,1343,1261,19.5,1771.6
4459925036,0,14,2,0,2,14,3,0,0,0,0,14332,6.4,15949,219,51,-5624,-4155,21.9,1433.2,19,2,1,14,2,19,1,1,0,0,19956,7.4,20104,226,49,5624,4155,22.6,1995.6
4521063765,1,14,4,0,3,3,4,1,1,0,0,15138,7.0,18807,194,66,-105,1086,19.4,1513.8,16,2,1,3,3,3,0,0,0,0,15243,7.0,17721,235,55,105,-1086,23.5,1524.3
4515381064,1,22,5,0,1,2,3,0,0,0,0,14359,6.8,17258,228,55,-334,-73,22.8,1435.9,16,1,1,2,1,1,1,1,0,0,14693,6.6,17331,223,48,334,73,22.3,1469.3
4522523284,0,15,3,0,5,8,3,0,0,0,0,16554,6.8,18076,216,56,-505,-580,21.6,1655.4,36,1,1,8,5,13,1,0,1,0,17059,7.0,18656,193,71,505,580,19.3,1705.9
4524409899,0,13,4,1,5,3,7,0,0,0,0,16660,7.2,18967,257,52,1723,970,25.7,1666.0,38,1,0,3,5,5,2,1,1,0,14937,7.0,17997,227,52,-1723,-970,22.7,1493.7
4520357816,0,16,1,1,7,4,2,0,0,0,0,15911,7.0,17640,219,38,428,1015,21.9,1591.1,13,1,0,4,7,5,1,1,0,0,15483,6.6,16625,234,45,-428,-1015,23.4,1548.3
4501319055,1,21,4,0,6,2,6,1,1,0,0,16844,7.0,18805,243,45,2726,1990,24.3,1684.4,39,4,1,2,6,1,0,0,0,0,14118,6.8,16815,210,50,-2726,-1990,21.0,1411.8
4523041612,0,17,2,0,5,4,4,0,0,0,0,16891,7.4,19197,207,79,1060,1554,20.7,1689.1,69,3,1,4,5,4,1,1,0,0,15831,6.8,17643,211,60,-1060,-1554,21.1,1583.1
4501224571,0,13,1,0,5,8,3,0,0,0,0,15318,7.0,18578,200,48,-1086,646,20.0,1531.8,35,1,1,8,5,8,2,1,1,0,16404,6.8,17932,194,43,1086,-646,19.4,1640.4
4522440155,0,15,3,0,1,2,1,1,1,0,0,15216,7.2,18663,251,56,99,-174,25.1,1521.6,12,2,1,2,1,5,0,0,0,0,15117,7.0,18837,217,60,-99,174,21.7,1511.7
4518352378,1,17,3,1,6,1,6,0,0,0,0,17357,7.2,19151,234,51,4111,2823,23.4,1735.7,22,1,0,1,6,0,1,1,0,0,13246,6.6,16328,208,53,-4111,-2823,20.8,1324.6
4516562563,0,14,1,0,9,6,10,0,0,0,0,16760,6.8,16804,193,42,226,-957,19.3,1676.0,13,2,1,6,9,2,0,0,0,0,16534,6.8,17761,213,55,-226,957,21.3,1653.4
4518019650,0,11,4,1,3,5,3,0,0,0,0,15029,7.0,17571,230,40,-1420,-1415,23.0,1502.9,103,1,0,5,3,5,1,1,0,0,16449,7.0,18986,222,56,1420,1415,22.2,1644.9
4456960285,1,19,5,0,10,8,10,1,1,0,0,17251,6.8,17415,217,46,-733,-541,21.7,1725.1,17,3,1,8,10,13,0,0,0,0,17984,6.8,17956,234,39,733,541,23.4,1798.4
4492021851,1,14,1,0,8,11,9,0,0,0,0,16583,6.4,17229,198,44,-1635,-2200,19.8,1658.3,14,0,1,11,8,7,1,1,0,0,18218,7.2,19429,211,60,1635,2200,21.1,1821.8
4520894733,0,14,2,0,3,3,5,1,1,0,0,15518,6.6,16768,234,52,315,-61,23.4,1551.8,19,1,1,3,3,4,0,0,0,0,15203,6.6,16829,216,51,-315,61,21.6,1520.3
4524193415,0,16,3,1,8,8,9,1,1,0,0,16891,7.0,17845,201,51,-1296,4,20.1,1689.1,15,3,0,8,8,9,0,0,0,0,18187,7.0,17841,217,48,1296,-4,21.7,1818.7
4510867188,0,12,1,1,5,4,5,1,0,1,0,16731,7.4,19377,238,60,1675,2022,23.8,1673.1,16,1,0,4,5,2,1,1,0,0,15056,6.8,17355,218,63,-1675,-2022,21.8,1505.6
4511606609,1,27,6,1,7,7,4,0,0,0,0,17309,7.2,19092,253,48,763,1025,25.3,1730.9,17,1,0,7,7,9,1,1,0,0,16546,7.0,18067,217,48,-763,-1025,21.7,1654.6
4525041896,0,13,3,0,3,10,2,1,1,0,0,14995,6.6,16206,210,53,-3685,-3119,21.0,1499.5,20,3,1,10,3,13,1,0,1,0,18680,7.4,19325,200,67,3685,3119,20.0,1868.0
4492694297,1,15,0,1,11,6,9,1,1,0,0,17229,7.0,18401,191,40,354,736,19.1,1722.9,28,4,0,6,11,6,0,0,0,0,16875,6.8,17665,202,52,-354,-736,20.2,1687.5
4514117878,1,22,8,1,7,2,9,1,1,0,0,18021,7.2,19353,246,50,4957,4440,24.6,1802.1,50,2,0,2,7,2,0,0,0,0,13064,6.4,14913,182,45,-4957,-4440,18.2,1306.4
4500036039,1,18,2,1,6,3,10,0,0,0,0,16299,7.0,17994,234,45,1049,-291,23.4,1629.9,35,3,0,3,6,1,0,0,0,0,15250,7.0,18285,240,51,-1049,291,24.0,1525.0
4499791451,1,23,2,1,13,3,15,0,0,0,0,19484,7.2,19688,235,50,4694,2781,23.5,1948.4,14,1,0,3,13,3,2,1,1,0,14790,6.6,16907,196,59,-4694,-2781,19.6,1479.0
4527990640,1,85,3,0,8,7,11,1,0,1,0,17442,7.2,20005,210,68,-347,966,21.0,1744.2,13,1,1,7,8,10,0,0,0,0,17789,7.2,19039,218,58,347,-966,21.8,1778.9
4517834263,1,14,1,1,8,6,8,0,0,0,0,17915,7.2,19197,215,56,1451,1985,21.5,1791.5,15,1,0,6,8,9,0,0,0,0,16464,7.0,17212,222,47,-1451,-1985,22.2,1646.4
4522356055,1,19,2,0,6,5,5,1,1,0,0,15926,6.8,17186,209,44,905,1369,20.9,1592.6,15,2,1,5,6,10,0,0,0,0,15021,6.4,15817,180,40,-905,-1369,18.0,1502.1
4501235801,0,14,0,0,5,5,6,1,1,0,0,15412,6.6,17055,180,51,-709,-658,18.0,1541.2,23,0,1,5,5,3,1,0,1,0,16121,6.8,17713,231,43,709,658,23.1,1612.1
4517513355,1,17,4,1,9,6,7,0,0,0,0,17147,7.2,19004,197,52,1412,1897,19.7,1714.7,18,2,0,6,9,4,1,1,0,0,15735,6.8,17107,210,43,-1412,-1897,21.0,1573.5
4521025798,1,14,2,0,4,3,3,1,1,0,0,16374,7.0,18573,263,57,825,1066,26.3,1637.4,15,5,1,3,4,6,0,0,0,0,15549,6.6,17507,253,46,-825,-1066,25.3,1554.9
4510805663,0,45,4,0,4,9,3,0,0,0,0,15430,6.8,18275,240,53,-2850,-832,24.0,1543.0,16,7,1,9,4,7,1,1,0,0,18280,7.4,19107,235,48,2850,832,23.5,1828.0
4525132603,1,14,3,0,5,9,6,0,0,0,0,16500,7.0,17896,238,60,-2390,-1796,23.8,1650.0,20,4,1,9,5,11,1,1,0,0,18890,7.2,19692,240,49,2390,1796,24.0,1889.0
4516849769,0,13,2,1,5,12,5,0,0,0,0,15230,6.4,15161,185,44,-3832,-3915,18.5,1523.0,16,0,0,12,5,11,1,1,0,0,19062,7.4,19076,219,58,3832,3915,21.9,1906.2
4501021629,1,13,2,1,9,8,8,0,0,0,0,17208,6.8,17852,194,36,-197,919,19.4,1720.8,11,0,0,8,9,10,0,0,0,0,17405,6.6,16933,218,40,197,-919,21.8,1740.5
4509949605,1,17,3,0,7,7,9,0,0,0,0,16323,7.2,18362,213,44,-451,336,21.3,1632.3,63,5,1,7,7,10,1,1,0,0,16774,6.8,18026,219,44,451,-336,21.9,1677.4
4505637581,1,13,0,1,4,4,4,1,1,0,0,15360,6.8,17742,228,44,97,-1064,22.8,1536.0,14,1,0,4,4,0,0,0,0,0,15263,7.0,18806,220,59,-97,1064,22.0,1526.3
4495332793,0,12,0,0,2,3,2,1,0,1,0,14191,6.8,16725,207,48,-1093,-1572,20.7,1419.1,119,1,1,3,2,3,0,0,0,0,15284,7.2,18297,239,55,1093,1572,23.9,1528.4
4497698751,0,39,4,0,3,8,3,0,0,0,0,14809,6.8,17625,232,44,-2595,-1917,23.2,1480.9,16,5,1,8,3,10,0,0,0,0,17404,7.2,19542,245,56,2595,1917,24.5,1740.4
4412284612,0,14,3,0,11,14,10,0,0,0,0,18420,7.2,19093,225,46,-1004,-515,22.5,1842.0,14,2,1,14,11,14,0,0,0,0,19424,7.2,19608,205,52,1004,515,20.5,1942.4
4513249754,1,16,2,1,13,8,20,1,0,1,2,21728,7.4,20117,242,62,4161,2591,24.2,2172.8,10,2,0,8,13,15,0,0,0,0,17567,6.8,17526,214,58,-4161,-2591,21.4,1756.7
4496547749,1,13,3,1,8,9,8,2,1,1,0,17267,7.0,17580,203,51,-356,-408,20.3,1726.7,48,3,0,9,8,16,0,0,0,0,17623,6.8,17988,180,44,356,408,18.0,1762.3
4483621634,1,19,3,0,6,7,4,0,0,0,0,16039,7.0,17942,195,49,-665,-571,19.5,1603.9,16,3,1,7,6,5,1,1,0,0,16704,7.0,18513,231,52,665,571,23.1,1670.4
4500969202,1,56,4,0,0,6,0,1,1,0,0,14439,6.8,17416,264,45,-2696,-2455,26.4,1443.9,19,22,1,6,0,9,0,0,0,0,17135,7.4,19871,250,48,2696,2455,25.0,1713.5
4510924170,0,11,1,1,9,9,14,0,0,0,0,17058,6.4,16359,174,40,-1004,-2008,17.4,1705.8,17,0,0,9,9,14,0,0,0,0,18062,7.0,18367,213,56,1004,2008,21.3,1806.2
4491389277,1,11,1,0,7,6,5,0,0,0,0,17242,7.2,19085,236,53,403,1790,23.6,1724.2,14,2,1,6,7,9,0,0,0,0,16839,6.8,17295,216,47,-403,-1790,21.6,1683.9
4460730840,1,24,5,1,13,4,16,1,1,0,0,20029,7.4,20123,213,54,6445,4988,21.3,2002.9,17,2,0,4,13,4,0,0,0,0,13584,6.0,15135,176,29,-6445,-4988,17.6,1358.4
4523715686,1,16,3,0,5,3,3,1,1,0,0,16487,6.8,18581,235,42,1780,1010,23.5,1648.7,15,1,1,3,5,1,0,0,0,0,14707,6.8,17571,218,48,-1780,-1010,21.8,1470.7
4505359839,0,17,3,0,1,9,0,0,0,0,0,13458,6.6,16195,221,36,-4232,-2456,22.1,1345.8,26,1,1,9,1,8,0,0,0,0,17690,7.2,18651,225,35,4232,2456,22.5,1769.0
4494937598,0,13,2,0,6,7,8,0,0,0,0,16068,7.2,18240,209,54,-932,-517,20.9,1606.8,15,1,1,7,6,4,2,1,1,0,17000,7.2,18757,240,44,932,517,24.0,1700.0
4511628511,1,15,1,1,7,5,9,1,1,0,0,17791,7.0,19243,244,71,2037,2483,24.4,1779.1,14,4,0,5,7,5,0,0,0,0,15754,6.6,16760,209,36,-2037,-2483,20.9,1575.4
4510123428,0,17,3,1,10,10,14,0,0,0,0,17207,6.8,17379,179,40,519,-748,17.9,1720.7,26,1,0,10,10,5,0,0,0,0,16688,7.2,18127,188,55,-519,748,18.8,1668.8
4487468549,1,15,3,0,12,7,16,0,0,0,0,19246,7.2,19668,231,40,2861,1432,23.1,1924.6,15,2,1,7,12,5,0,0,0,0,16385,6.8,18236,213,55,-2861,-1432,21.3,1638.5
4504764958,1,17,2,1,7,1,9,0,0,0,0,18408,7.4,20063,250,60,4119,2320,25.0,1840.8,15,1,0,1,7,1,2,1,1,0,14289,6.8,17743,234,51,-4119,-2320,23.4,1428.9
4499739655,1,16,5,1,6,4,6,0,0,0,0,18072,7.2,19281,281,46,3018,1320,28.1,1807.2,17,4,0,4,6,2,1,1,0,0,15054,7.0,17961,223,58,-3018,-1320,22.3,1505.4
4502847039,1,15,1,0,2,4,1,1,1,0,0,14431,7.0,17984,194,70,-940,-43,19.4,1443.1,25,2,1,4,2,3,0,0,0,0,15371,6.8,18027,234,42,940,43,23.4,1537.1
4511106120,0,16,2,0,1,8,2,0,0,0,0,14055,6.6,16334,208,55,-4331,-2588,20.8,1405.5,43,4,1,8,1,10,1,1,0,0,18386,7.2,18922,226,56,4331,2588,22.6,1838.6
4518093689,0,14,1,0,2,7,0,0,0,0,0,14074,6.4,16376,203,43,-3510,-3014,20.3,1407.4,14,2,1,7,2,4,1,0,1,0,17584,7.2,19390,266,44,3510,3014,26.6,1758.4
4498040102,1,21,1,1,13,4,14,1,1,0,0,18722,6.8,18343,187,46,3593,727,18.7,1872.2,33,5,0,4,13,6,0,0,0,0,15129,6.8,17616,209,49,-3593,-727,20.9,1512.9
4526285141,1,20,1,0,5,4,3,1,1,0,0,16517,6.8,17812,246,49,819,-48,24.6,1651.7,13,3,1,4,5,4,0,0,0,0,15698,7.2,17860,245,57,-819,48,24.5,1569.8
4525974749,0,26,3,1,6,6,5,0,0,0,0,16367,7.0,17910,218,56,-1761,-226,21.8,1636.7,14,1,0,6,6,4,2,1,1,1,18128,7.0,18136,233,54,1761,226,23.3,1812.8
4525334878,0,26,2,0,8,8,8,1,0,1,0,16145,7.2,19030,192,47,-1580,358,19.2,1614.5,16,4,1,8,8,7,1,1,0,0,17725,7.2,18672,224,62,1580,-358,22.4,1772.5
4515561021,1,46,6,0,4,1,10,1,1,0,0,15966,7.2,18955,229,59,1532,1453,22.9,1596.6,61,7,1,1,4,1,0,0,0,0,14434,7.2,17502,229,60,-1532,-1453,22.9,1443.4
4508612227,1,16,3,1,9,2,8,2,1,1,0,17303,7.0,18705,219,49,2871,2154,21.9,1730.3,16,2,0,2,9,3,0,0,0,0,14432,6.8,16551,217,52,-2871,-2154,21.7,1443.2
4476661914,0,10,0,1,2,11,3,0,0,0,0,14562,6.8,16952,196,68,-4816,-3750,19.6,1456.2,12,1,0,11,2,12,1,1,0,0,19378,7.4,20702,259,48,4816,3750,25.9,1937.8
4469769550,0,17,3,0,6,14,4,0,0,0,0,16150,6.6,16419,194,41,-2243,-2024,19.4,1615.0,15,3,1,14,6,13,0,0,0,0,18393,7.0,18443,186,56,2243,2024,18.6,1839.3
4452471591,0,22,3,1,12,3,11,1,1,0,0,18428,7.0,18214,218,47,3117,1745,21.8,1842.8,39,6,0,3,12,4,0,0,0,0,15311,6.6,16469,254,28,-3117,-1745,25.4,1531.1
4470439990,1,10,3,0,10,6,14,1,1,0,0,17835,7.0,18791,212,42,1568,1001,21.2,1783.5,19,3,1,6,10,7,0,0,0,0,16267,6.8,17790,209,54,-1568,-1001,20.9,1626.7
4495710198,1,16,1,1,8,2,5,1,1,0,0,16909,7.2,18318,229,40,2304,2532,22.9,1690.9,14,3,0,2,8,2,0,0,0,0,14605,6.2,15786,208,44,-2304,-2532,20.8,1460.5
4417369885,0,18,0,0,6,10,6,0,0,0,0,16577,6.6,16338,221,36,-1311,-1472,22.1,1657.7,19,1,1,10,6,12,1,1,0,0,17888,7.0,17810,169,72,1311,1472,16.9,1788.8
4476709038,1,20,2,0,4,4,4,1,0,1,0,15971,6.8,17247,241,53,603,-932,24.1,1597.1,47,5,1,4,4,5,0,0,0,0,15368,6.8,18179,215,50,-603,932,21.5,1536.8
4495208776,1,14,5,1,9,1,17,2,1,1,0,18070,7.2,19270,235,55,3828,2447,23.5,1807.0,16,1,0,1,9,0,0,0,0,0,14242,6.6,16823,214,68,-3828,-2447,21.4,1424.2
4524203497,1,13,2,1,6,3,5,2,1,1,0,17898,7.0,19735,238,67,3477,3386,23.8,1789.8,12,0,0,3,6,3,0,0,0,0,14421,6.6,16349,224,44,-3477,-3386,22.4,1442.1
4519714045,1,12,3,1,7,2,4,0,0,0,0,17389,7.0,18966,237,52,3129,1416,23.7,1738.9,12,2,0,2,7,1,1,1,0,0,14260,6.8,17550,203,60,-3129,-1416,20.3,1426.0
4521965130,0,85,0,1,6,2,6,1,1,0,0,16440,7.0,18417,208,50,2821,2754,20.8,1644.0,12,1,0,2,6,2,0,0,0,0,13619,6.2,15663,203,46,-2821,-2754,20.3,1361.9
4514719397,0,16,0,0,1,5,1,0,0,0,0,14181,6.8,17487,234,49,-2489,-1271,23.4,1418.1,18,1,1,5,1,7,0,0,0,0,16670,7.0,18758,253,49,2489,1271,25.3,1667.0
4527556875,0,18,4,1,4,3,2,1,1,0,0,15282,7.0,17671,232,54,-35,317,23.2,1528.2,27,1,0,3,4,4,0,0,0,0,15317,6.8,17354,206,47,35,-317,20.6,1531.7
4468503240,1,91,3,0,10,5,13,0,0,0,1,19571,7.2,18463,213,50,4006,2081,21.3,1957.1,17,1,1,5,10,6,0,0,0,0,15565,6.6,16382,210,47,-4006,-2081,21.0,1556.5
4525174684,1,16,2,1,5,2,5,1,1,0,0,16594,7.4,20008,227,76,1737,1565,22.7,1659.4,13,0,0,2,5,3,0,0,0,0,14857,7.0,18443,217,72,-1737,-1565,21.7,1485.7
4483147494,0,11,3,1,5,10,4,0,0,0,0,15656,6.6,16714,206,40,-1458,-618,20.6,1565.6,23,2,0,10,5,11,2,1,1,0,17114,6.6,17332,193,45,1458,618,19.3,1711.4
4523536218,1,38,0,1,6,3,7,0,0,0,0,16887,7.4,19954,232,64,846,680,23.2,1688.7,14,21,0,3,6,1,1,1,0,0,16041,7.2,19274,242,64,-846,-680,24.2,1604.1
4477478034,0,17,1,0,5,13,5,0,0,0,0,14642,6.2,15033,171,41,-4958,-2388,17.1,1464.2,29,4,1,13,5,14,1,1,0,0,19600,7.0,17421,231,24,4958,2388,23.1,1960.0
4523588763,0,16,1,1,2,7,2,0,0,0,0,14612,6.6,16340,242,43,-2541,-3552,24.2,1461.2,36,6,0,7,2,8,1,1,0,0,17153,7.4,19892,220,68,2541,3552,22.0,1715.3
4494910651,0,17,2,0,2,5,1,0,0,0,0,14658,6.6,16832,210,47,-1957,422,21.0,1465.8,18,7,1,5,2,7,1,1,0,1,16615,6.6,16410,209,39,1957,-422,20.9,1661.5
4518389976,0,20,0,0,3,8,3,0,0,0,0,14301,6.6,17009,173,52,-2482,-1576,17.3,1430.1,14,3,1,8,3,6,1,1,0,0,16783,7.0,18585,230,52,2482,1576,23.0,1678.3
4521120327,0,41,5,1,6,10,7,1,0,1,0,15075,6.4,16260,179,32,-3996,-3131,17.9,1507.5,23,10,0,10,6,11,1,1,0,0,19071,7.4,19391,210,78,3996,3131,21.0,1907.1
4522209406,0,14,3,0,5,10,6,1,1,0,0,14604,6.2,15280,146,52,-4752,-2451,14.6,1460.4,39,2,1,10,5,11,0,0,0,1,19356,6.8,17731,210,47,4752,2451,21.0,1935.6
4431859691,1,15,6,0,7,3,7,0,0,0,0,16592,7.0,19045,220,40,1709,880,22.0,1659.2,15,2,1,3,7,1,1,1,0,0,14883,7.2,18165,203,60,-1709,-880,20.3,1488.3
4521194149,1,18,3,1,9,6,6,2,1,1,0,17673,7.2,19727,208,68,1369,2756,20.8,1767.3,19,3,0,6,9,7,0,0,0,0,16304,6.6,16971,216,48,-1369,-2756,21.6,1630.4
4519597739,1,13,1,1,13,8,15,1,0,1,0,19399,6.8,17635,226,34,2348,2115,22.6,1939.9,17,2,0,8,13,4,1,1,0,0,17051,6.4,15520,192,45,-2348,-2115,19.2,1705.1
4511728953,1,15,2,0,4,5,3,1,1,0,0,15859,7.2,18390,242,59,-88,-932,24.2,1585.9,41,2,1,5,4,10,0,0,0,0,15947,7.2,19322,222,61,88,932,22.2,1594.7
4519480977,1,42,5,0,6,6,10,0,0,0,0,16206,6.8,17669,221,49,-677,-67,22.1,1620.6,18,8,1,6,6,10,1,1,0,0,16883,6.8,17736,245,45,677,67,24.5,1688.3
4468657792,1,13,4,1,1,1,2,2,1,1,0,14546,7.0,17721,232,60,305,-443,23.2,1454.6,18,2,0,1,1,1,0,0,0,0,14241,7.2,18164,203,68,-305,443,20.3,1424.1
4517686299,0,14,4,0,5,6,6,0,0,0,0,15698,6.6,17663,201,63,-687,-372,20.1,1569.8,23,3,1,6,5,8,1,1,0,0,16385,7.0,18035,230,43,687,372,23.0,1638.5
4503699941,0,18,1,1,8,7,11,1,1,0,0,16465,6.6,17106,215,28,84,-1185,21.5,1646.5,18,3,0,7,8,5,0,0,0,0,16381,7.2,18291,203,51,-84,1185,20.3,1638.1
4491789559,0,17,3,1,5,7,5,0,0,0,0,15723,6.8,17429,203,50,-1522,-1611,20.3,1572.3,19,4,0,7,5,4,1,1,0,0,17245,7.0,19040,241,56,1522,1611,24.1,1724.5
4497491291,0,15,3,0,4,6,6,1,0,1,1,16580,7.0,17438,205,45,-551,-551,20.5,1658.0,54,2,1,6,4,10,1,1,0,0,17131,6.8,17989,218,55,551,551,21.8,1713.1
4483466671,0,22,2,0,7,6,10,0,0,0,1,18376,7.0,17877,225,48,2595,776,22.5,1837.6,33,4,1,6,7,4,2,1,1,0,15781,6.6,17101,201,59,-2595,-776,20.1,1578.1
4510387973,1,19,2,1,7,1,7,2,1,1,0,16537,7.2,19213,232,53,2954,2444,23.2,1653.7,14,3,0,1,7,0,0,0,0,0,13583,6.8,16769,202,52,-2954,-2444,20.2,1358.3
4523854789,1,15,4,0,6,6,5,0,0,0,0,16037,7.2,18383,207,51,59,-107,20.7,1603.7,14,5,1,6,6,7,1,1,0,0,15978,7.0,18490,229,48,-59,107,22.9,1597.8
4520803035,0,11,4,0,2,8,3,0,0,0,0,14376,6.8,17660,208,60,-3122,-1229,20.8,1437.6,38,3,1,8,2,8,0,0,0,0,17498,7.0,18889,231,36,3122,1229,23.1,1749.8
4297209068,1,17,5,1,6,6,6,0,0,0,0,16621,6.6,17333,220,44,282,399,22.0,1662.1,19,2,0,6,6,8,0,0,0,0,16339,6.8,16934,216,53,-282,-399,21.6,1633.9
4501265779,0,12,2,0,8,6,7,0,0,0,0,16793,6.8,17595,210,36,115,-80,21.0,1679.3,14,3,1,6,8,6,1,1,0,0,16678,6.8,17675,238,41,-115,80,23.8,1667.8
4524178462,0,19,5,0,2,6,0,0,0,0,0,15054,7.2,18364,239,60,-962,612,23.9,1505.4,18,7,1,6,2,6,1,1,0,0,16016,6.8,17752,233,44,962,-612,23.3,1601.6
4509989116,0,19,3,1,5,8,6,0,0,0,0,16020,6.8,17044,240,46,-1407,-1305,24.0,1602.0,25,7,0,8,5,12,1,1,0,0,17427,7.2,18349,226,50,1407,1305,22.6,1742.7
4522097852,0,17,3,0,8,5,5,0,0,0,0,16538,7.4,19266,238,36,1664,1691,23.8,1653.8,41,1,1,5,8,1,1,1,0,0,14874,6.8,17575,190,56,-1664,-1691,19.0,1487.4
4504146901,0,14,2,0,2,5,3,0,0,0,0,15128,7.0,17938,251,53,-860,-334,25.1,1512.8,17,2,1,5,2,9,1,1,0,0,15988,7.0,18272,226,52,860,334,22.6,1598.8
4526866372,0,14,3,0,3,10,6,0,0,0,0,14836,6.4,16507,214,45,-3421,-2836,21.4,1483.6,17,1,1,10,3,9,1,1,0,0,18257,7.2,19343,229,44,3421,2836,22.9,1825.7
4526291828,1,17,0,0,5,2,3,2,1,1,0,17956,7.0,18251,271,50,4594,2745,27.1,1795.6,18,3,1,2,5,6,0,0,0,0,13362,6.4,15506,187,33,-4594,-2745,18.7,1336.2
4468611805,0,17,1,0,6,6,8,2,1,1,0,16207,7.0,17381,211,50,-819,-1829,21.1,1620.7,13,2,1,6,6,3,0,0,0,0,17026,7.0,19210,223,56,819,1829,22.3,1702.6
4495913544,0,15,0,1,9,9,4,1,0,1,0,16749,6.4,16518,172,52,-645,-2890,17.2,1674.9,15,4,0,9,9,7,1,1,0,0,17394,7.0,19408,202,48,645,2890,20.2,1739.4
4515490352,0,15,1,0,2,8,2,0,0,0,0,13956,6.6,16492,210,50,-3535,-1720,21.0,1395.6,16,2,1,8,2,12,1,1,0,0,17491,7.0,18212,203,63,3535,1720,20.3,1749.1
4523498928,0,9,0,0,2,9,1,0,0,0,0,13879,6.2,15363,185,48,-4267,-3389,18.5,1387.9,15,2,1,9,2,5,2,1,1,0,18146,7.0,18752,232,56,4267,3389,23.2,1814.6
4503520980,1,18,0,1,7,2,6,1,0,1,0,17365,7.2,19227,245,44,2740,1708,24.5,1736.5,15,2,0,2,7,4,1,1,0,0,14625,7.0,17519,213,66,-2740,-1708,21.3,1462.5
4495074473,0,16,6,1,4,8,2,0,0,0,1,16334,6.4,15901,218,36,-300,-1937,21.8,1633.4,16,3,0,8,4,7,1,1,0,0,16634,7.0,17838,224,52,300,1937,22.4,1663.4
4480206299,1,23,3,1,9,7,12,1,0,1,0,17836,7.2,19027,214,64,969,1554,21.4,1783.6,18,3,0,7,9,7,1,1,0,0,16867,6.8,17473,216,36,-969,-1554,21.6,1686.7
4479823004,1,18,1,0,13,9,18,1,1,0,0,19032,7.4,18951,232,44,527,721,23.2,1903.2,12,4,1,9,13,5,0,0,0,0,18505,7.0,18230,216,63,-527,-721,21.6,1850.5
4482488363,0,16,4,0,3,5,3,0,0,0,0,13988,6.2,15917,174,44,-2761,-2185,17.4,1398.8,22,5,1,5,3,11,1,1,0,0,16749,7.0,18102,242,43,2761,2185,24.2,1674.9
4502366249,1,14,2,1,2,5,2,0,0,0,0,14939,6.4,16939,218,40,-1348,-2082,21.8,1493.9,16,1,0,5,2,4,1,0,1,0,16287,7.4,19021,250,52,1348,2082,25.0,1628.7
4498073592,0,15,3,1,4,7,4,1,1,0,0,15149,6.8,16969,217,51,-1887,-567,21.7,1514.9,17,1,0,7,4,9,0,0,0,0,17036,6.8,17536,241,44,1887,567,24.1,1703.6
4502847673,1,19,4,0,11,5,10,1,1,0,0,18307,7.2,19247,228,54,3223,2804,22.8,1830.7,14,2,1,5,11,3,0,0,0,0,15084,6.6,16443,198,40,-3223,-2804,19.8,1508.4
4495265880,1,15,0,0,6,1,6,1,1,0,0,17402,7.2,19869,262,51,3250,3073,26.2,1740.2,14,2,1,1,6,1,0,0,0,0,14152,6.4,16796,232,52,-3250,-3073,23.2,1415.2
4473800740,1,18,17,1,13,5,11,0,0,0,0,20853,7.6,20248,270,43,5501,3548,27.0,2085.3,43,0,0,5,13,7,0,0,0,0,15352,6.8,16700,188,48,-5501,-3548,18.8,1535.2
4505359485,0,14,2,0,4,3,5,1,1,0,0,15412,7.0,18001,212,56,-287,-1045,21.2,1541.2,13,2,1,3,4,3,0,0,0,0,15699,7.0,19046,243,56,287,1045,24.3,1569.9
4521111365,1,17,2,1,3,7,3,1,1,0,0,14849,6.8,17502,221,53,-3736,-2032,22.1,1484.9,16,2,0,7,3,6,1,0,1,1,18585,7.6,19534,232,60,3736,2032,23.2,1858.5
4507096347,1,20,3,1,6,7,4,1,1,0,0,17261,7.0,18583,206,56,1579,1615,20.6,1726.1,19,3,0,7,6,9,0,0,0,0,15682,6.6,16968,184,36,-1579,-1615,18.4,1568.2
4491194203,1,24,3,0,10,5,15,0,0,0,0,17688,7.2,19492,197,48,1937,2816,19.7,1768.8,49,2,1,5,10,4,0,0,0,0,15751,6.8,16676,192,44,-1937,-2816,19.2,1575.1
4504886310,1,18,4,0,5,3,4,1,1,0,0,15979,7.2,18795,260,53,1027,615,26.0,1597.9,19,3,1,3,5,4,0,0,0,0,14952,7.0,18180,219,60,-1027,-615,21.9,1495.2
4474405300,0,16,2,0,6,6,3,0,0,0,0,15040,6.8,17558,184,37,-2006,-101,18.4,1504.0,16,5,1,6,6,5,0,0,0,0,17046,6.8,17659,236,43,2006,101,23.6,1704.6
4504189660,0,15,3,1,2,4,3,0,0,0,0,14779,6.6,16944,214,64,-1024,-571,21.4,1477.9,16,1,0,4,2,5,1,1,0,0,15803,7.0,17515,227,52,1024,571,22.7,1580.3
4478592146,1,48,4,1,4,2,4,1,1,0,0,15730,6.8,18012,240,55,1383,660,24.0,1573.0,14,2,0,2,4,1,0,0,0,0,14347,6.6,17352,221,56,-1383,-660,22.1,1434.7
4525005115,0,13,3,0,6,6,9,0,0,0,0,17924,7.0,18749,248,46,870,703,24.8,1792.4,17,1,1,6,6,9,0,0,0,0,17054,6.8,18046,241,39,-870,-703,24.1,1705.4
4464331919,0,48,2,1,4,4,3,1,0,1,0,15721,7.2,18756,213,64,-1050,89,21.3,1572.1,18,0,0,4,4,6,1,1,0,0,16771,7.2,18667,238,56,1050,-89,23.8,1677.1
4497572230,0,17,5,0,3,10,3,0,0,0,0,14635,6.6,16718,202,41,-3709,-1017,20.2,1463.5,16,3,1,10,3,10,1,1,0,0,18344,6.8,17735,231,39,3709,1017,23.1,1834.4
4511211862,0,16,5,1,4,6,6,0,0,0,0,15246,6.6,16921,224,51,-1346,-2280,22.4,1524.6,17,2,0,6,4,10,1,1,0,0,16592,7.0,19201,221,56,1346,2280,22.1,1659.2
4524501776,1,19,1,1,11,6,15,1,1,0,0,18230,6.8,17602,195,52,2114,75,19.5,1823.0,14,2,0,6,11,7,0,0,0,0,16116,6.8,17527,198,52,-2114,-75,19.8,1611.6
4517636466,1,30,3,1,4,7,5,1,1,0,0,15860,7.2,18449,228,63,-1160,-12,22.8,1586.0,145,2,0,7,4,9,1,0,1,0,17020,7.0,18461,203,48,1160,12,20.3,1702.0
4524715450,1,15,13,1,6,8,10,1,1,0,0,16359,6.4,15794,182,49,-2414,-3087,18.2,1635.9,41,1,0,8,6,4,0,0,0,1,18773,7.2,18881,225,49,2414,3087,22.5,1877.3
4519707046,0,15,2,0,3,5,0,0,0,0,0,16228,6.8,18476,234,71,352,639,23.4,1622.8,9,2,1,5,3,6,0,0,0,0,15876,7.0,17837,203,44,-352,-639,20.3,1587.6
4518264766,1,16,5,1,12,1,24,1,1,0,0,20289,7.2,20144,245,48,7039,4860,24.5,2028.9,54,1,0,1,12,1,0,0,0,0,13250,6.4,15284,152,60,-7039,-4860,15.2,1325.0
4526094722,0,16,4,0,7,8,6,0,0,0,0,15772,6.8,17144,204,40,-1502,-429,20.4,1577.2,16,3,1,8,7,11,2,1,1,0,17274,6.8,17573,225,44,1502,429,22.5,1727.4
4470286128,0,16,3,0,4,13,5,0,0,0,0,15309,6.6,16938,175,48,-4962,-2312,17.5,1530.9,15,4,1,13,4,14,1,0,1,0,20271,7.2,19250,242,38,4962,2312,24.2,2027.1
4447992971,1,16,2,1,6,4,10,1,1,0,0,16993,7.2,18935,262,57,422,-758,26.2,1699.3,16,3,0,4,6,6,0,0,0,0,16571,7.4,19693,254,60,-422,758,25.4,1657.1
4417938039,0,18,4,0,8,10,8,0,0,0,0,16996,6.8,18052,227,44,-1065,626,22.7,1699.6,19,4,1,10,8,13,0,0,0,0,18061,6.8,17426,216,30,1065,-626,21.6,1806.1
4504894173,0,17,1,1,8,1,9,0,0,0,0,16763,6.6,17181,209,36,3371,1173,20.9,1676.3,18,1,0,1,8,2,0,0,0,0,13392,6.4,16008,195,50,-3371,-1173,19.5,1339.2
4512777907,1,19,2,1,6,4,2,1,1,0,0,16476,7.0,18421,238,64,-323,345,23.8,1647.6,18,5,0,4,6,10,0,0,0,0,16799,7.0,18076,231,60,323,-345,23.1,1679.9
4456782548,0,42,0,0,9,10,14,0,0,0,0,17215,6.8,17349,198,31,-1908,-994,19.8,1721.5,16,2,1,10,9,11,0,0,0,0,19123,7.2,18343,235,55,1908,994,23.5,1912.3
4513447040,1,15,4,0,4,3,3,1,1,0,0,16044,7.0,18612,237,62,1223,2123,23.7,1604.4,19,5,1,3,4,3,1,0,1,0,14821,6.6,16489,231,47,-1223,-2123,23.1,1482.1
4451665703,0,24,3,0,6,7,6,0,0,0,0,16689,7.0,18369,240,50,211,880,24.0,1668.9,16,5,1,7,6,7,0,0,0,0,16478,7.0,17489,214,41,-211,-880,21.4,1647.8
4514595222,1,15,0,1,5,5,4,0,0,0,0,16300,7.2,19402,244,45,955,1833,24.4,1630.0,15,2,0,5,5,3,1,1,0,0,15345,7.0,17569,192,63,-955,-1833,19.2,1534.5
4524220083,1,15,1,1,14,5,10,2,1,1,1,21266,7.4,19884,231,56,7427,6558,23.1,2126.6,9,1,0,5,14,3,0,0,0,0,13839,5.6,13326,129,47,-7427,-6558,12.9,1383.9
4527208167,1,87,2,1,7,10,5,1,1,0,0,16969,7.0,18900,198,52,-877,418,19.8,1696.9,48,1,0,10,7,11,0,0,0,0,17846,7.2,18482,229,34,877,-418,22.9,1784.6
4504999388,1,15,2,0,3,9,4,0,0,0,0,13771,6.8,16290,174,50,-4907,-2874,17.4,1377.1,16,0,1,9,3,12,1,1,0,0,18678,7.2,19164,241,61,4907,2874,24.1,1867.8
4525021746,0,56,3,1,8,2,9,0,0,0,0,17352,6.8,17199,207,46,2841,858,20.7,1735.2,14,0,0,2,8,4,1,1,0,0,14511,6.6,16341,198,69,-2841,-858,19.8,1451.1
4510897345,0,18,4,0,5,6,6,1,0,1,0,15067,6.8,17908,201,49,-2718,-1000,20.1,1506.7,20,6,1,6,5,8,1,1,0,0,17785,7.0,18908,238,64,2718,1000,23.8,1778.5
4515522584,1,19,1,1,9,5,10,1,0,1,1,19294,7.0,18363,234,54,4570,2205,23.4,1929.4,13,4,0,5,9,8,0,0,0,0,14724,6.6,16158,162,46,-4570,-2205,16.2,1472.4
4472209518,1,18,5,1,7,2,7,2,1,1,0,17039,7.2,18656,220,64,3032,2096,22.0,1703.9,20,2,0,2,7,0,0,0,0,0,14007,6.6,16560,185,54,-3032,-2096,18.5,1400.7
4465328371,1,16,1,0,6,3,6,1,1,0,0,15609,6.8,18083,180,67,661,735,18.0,1560.9,14,1,1,3,6,2,0,0,0,0,14948,6.6,17348,199,52,-661,-735,19.9,1494.8
4522853770,1,42,3,0,6,6,5,0,0,0,0,17188,7.4,19429,250,56,326,1163,25.0,1718.8,16,14,1,6,6,6,0,0,0,0,16862,7.2,18266,219,72,-326,-1163,21.9,1686.2
4478567807,0,18,2,0,2,7,2,0,0,0,0,14857,6.4,16453,210,59,-1726,-1890,21.0,1485.7,15,1,1,7,2,17,1,1,0,0,16583,7.2,18343,203,44,1726,1890,20.3,1658.3
4462777872,0,16,5,0,12,5,9,0,0,0,0,18279,7.4,18909,174,54,1236,149,17.4,1827.9,15,4,1,5,12,3,2,1,1,0,17043,7.0,18760,224,60,-1236,-149,22.4,1704.3
4421818869,1,15,5,0,10,3,9,1,1,0,0,17886,7.4,19530,224,62,3854,2986,22.4,1788.6,15,2,1,3,10,2,0,0,0,0,14032,6.6,16544,193,44,-3854,-2986,19.3,1403.2
4472377536,1,14,3,0,6,4,6,1,1,0,0,16416,7.4,19684,211,60,1177,1161,21.1,1641.6,14,0,1,4,6,2,0,0,0,0,15239,7.0,18523,204,71,-1177,-1161,20.4,1523.9
4489696116,0,18,3,0,0,8,0,0,0,0,0,13728,6.6,16556,211,60,-5040,-1496,21.1,1372.8,15,4,1,8,0,8,0,0,0,1,18768,6.6,18052,239,46,5040,1496,23.9,1876.8
4497078527,0,12,3,1,3,7,2,0,0,0,0,15195,7.0,18046,217,64,-2336,-1282,21.7,1519.5,17,0,0,7,3,8,1,1,0,0,17531,7.4,19328,247,60,2336,1282,24.7,1753.1
4459773045,1,22,5,1,11,7,14,1,1,0,1,19465,7.0,17819,214,52,4013,2137,21.4,1946.5,14,1,0,7,11,8,0,0,0,0,15452,6.4,15682,182,29,-4013,-2137,18.2,1545.2
4524404839,1,81,5,0,11,11,14,0,0,0,0,18913,7.0,18431,215,31,1441,922,21.5,1891.3,16,2,1,11,11,11,1,1,0,0,17472,7.0,17509,200,24,-1441,-922,20.0,1747.2
4510870586,1,15,3,1,4,2,5,1,1,0,0,15800,6.8,17445,209,47,295,791,20.9,1580.0,43,2,0,2,4,3,1,0,1,1,15505,6.8,16654,206,45,-295,-791,20.6,1550.5
4505315494,0,11,2,1,6,5,6,1,1,0,0,16186,7.0,18472,225,43,53,-114,22.5,1618.6,12,0,0,5,6,5,0,0,0,0,16133,6.8,18586,205,56,-53,114,20.5,1613.3
4483595782,1,16,7,1,8,6,9,0,0,0,0,18262,7.2,19248,224,58,2537,2412,22.4,1826.2,17,3,0,6,8,6,1,1,0,0,15725,6.6,16836,208,41,-2537,-2412,20.8,1572.5
4517541768,0,20,1,0,9,11,7,0,0,0,1,17951,6.2,16342,207,30,-135,-1288,20.7,1795.1,14,6,1,11,9,11,1,1,0,0,18086,6.6,17630,190,45,135,1288,19.0,1808.6
4489870800,1,50,4,1,13,6,22,1,1,0,0,20876,7.6,21016,226,56,4988,3720,22.6,2087.6,17,4,0,6,13,6,1,0,1,0,15888,6.8,17296,212,51,-4988,-3720,21.2,1588.8
4499868617,0,12,4,0,4,10,3,1,1,0,0,14166,6.6,15959,203,41,-4061,-4397,20.3,1416.6,16,2,1,10,4,6,0,0,0,0,18227,7.4,20356,224,72,4061,4397,22.4,1822.7
4525627724,0,14,0,1,3,6,2,0,0,0,0,15212,6.8,17204,202,59,-1718,-1922,20.2,1521.2,17,1,0,6,3,8,1,0,1,0,16930,7.0,19126,201,64,1718,1922,20.1,1693.0
4520628924,0,16,1,0,5,5,5,0,0,0,0,15068,6.6,16740,208,26,-1933,-1659,20.8,1506.8,12,5,1,5,5,10,1,1,0,0,17001,7.2,18399,212,66,1933,1659,21.2,1700.1
4484379764,1,21,0,1,7,9,8,0,0,0,0,16076,6.8,16620,187,37,-923,-803,18.7,1607.6,14,4,0,9,7,11,1,1,0,0,16999,6.8,17423,197,52,923,803,19.7,1699.9
4525386289,1,14,2,1,10,2,16,1,0,1,0,18195,7.2,19078,220,48,4358,4325,22.0,1819.5,16,1,0,2,10,3,0,0,0,0,13837,6.0,14753,207,44,-4358,-4325,20.7,1383.7
4466982463,1,17,0,1,4,5,2,1,1,0,0,15557,6.8,17180,234,53,-633,-1323,23.4,1555.7,14,1,0,5,4,6,0,0,0,0,16190,7.0,18503,206,54,633,1323,20.6,1619.0
4464904147,0,17,1,1,5,5,3,1,0,1,0,16259,7.2,18538,242,58,-995,181,24.2,1625.9,16,4,0,5,5,5,0,0,0,0,17254,7.2,18357,256,42,995,-181,25.6,1725.4
4426899779,1,17,6,0,12,7,11,0,0,0,0,18028,6.8,16592,179,46,411,1075,17.9,1802.8,25,4,1,7,12,11,2,1,1,1,17617,6.2,15517,176,34,-411,-1075,17.6,1761.7
4521031841,0,12,0,0,1,6,0,1,1,0,0,14112,6.8,17265,232,48,-2720,-2419,23.2,1411.2,52,2,1,6,1,4,1,0,1,0,16832,7.4,19684,247,57,2720,2419,24.7,1683.2
4500388564,1,16,4,1,5,8,5,1,0,1,0,16607,7.0,17949,223,68,-1001,-543,22.3,1660.7,54,2,0,8,5,10,1,1,0,0,17608,7.0,18492,229,41,1001,543,22.9,1760.8
4452361884,1,16,2,1,12,10,20,2,1,1,0,19453,6.8,18043,165,64,1095,94,16.5,1945.3,15,1,0,10,12,17,0,0,0,0,18358,6.8,17949,227,56,-1095,-94,22.7,1835.8
4447986050,1,20,6,1,11,8,12,1,1,0,0,19349,7.2,19673,219,51,2445,1807,21.9,1934.9,15,2,0,8,11,10,0,0,0,0,16904,6.8,17866,194,48,-2445,-1807,19.4,1690.4
4523830779,0,14,1,1,6,10,5,0,0,0,0,17250,7.0,18266,222,60,-862,-1596,22.2,1725.0,11,1,0,10,6,11,0,0,0,0,18112,7.4,19862,216,43,862,1596,21.6,1811.2
4518730282,0,15,1,1,3,9,3,0,0,0,0,14881,6.4,15603,195,64,-1683,-377,19.5,1488.1,15,4,0,9,3,17,1,1,0,0,16564,6.4,15980,185,55,1683,377,18.5,1656.4
4510866403,0,17,1,0,2,3,2,0,0,0,0,14971,7.0,18121,228,49,-682,-89,22.8,1497.1,18,4,1,3,2,5,1,1,0,0,15653,7.2,18210,252,49,682,89,25.2,1565.3
4520626535,1,12,5,0,13,7,13,1,1,0,0,19718,7.6,20453,215,68,3614,3374,21.5,1971.8,18,3,1,7,13,3,1,0,1,0,16104,6.6,17079,192,46,-3614,-3374,19.2,1610.4
4515706467,0,83,13,1,7,11,3,0,0,0,0,15655,6.4,15827,194,25,-3689,-4682,19.4,1565.5,35,2,0,11,7,7,1,1,0,0,19344,7.2,20509,216,59,3689,4682,21.6,1934.4
4523258909,0,57,3,1,8,7,5,0,0,0,0,16204,6.6,17473,184,47,-1016,-1306,18.4,1620.4,17,4,0,7,8,7,1,1,0,0,17220,7.0,18779,210,51,1016,1306,21.0,1722.0
4494780528,0,12,3,0,7,6,8,0,0,0,0,16417,6.6,16981,211,56,557,1061,21.1,1641.7,15,2,1,6,7,9,0,0,0,0,15860,6.8,15920,194,48,-557,-1061,19.4,1586.0
4514156871,1,12,2,1,4,4,2,2,1,1,0,15534,7.0,18339,223,64,-483,-442,22.3,1553.4,14,2,0,4,4,5,0,0,0,0,16017,7.2,18781,266,52,483,442,26.6,1601.7
4517588876,0,20,2,0,2,3,4,1,1,0,0,15178,6.8,17707,236,50,-673,-1332,23.6,1517.8,16,4,1,3,2,5,1,0,1,0,15851,7.2,19039,252,64,673,1332,25.2,1585.1
4519092330,0,15,1,0,1,3,1,0,0,0,0,13943,6.8,17418,235,37,-1661,-1064,23.5,1394.3,14,0,1,3,1,2,0,0,0,0,15604,7.0,18482,241,48,1661,1064,24.1,1560.4
4523469931,1,13,3,1,5,5,5,1,1,0,0,15993,7.0,18392,227,62,-800,72,22.7,1599.3,15,3,0,5,5,6,0,0,0,0,16793,7.2,18320,243,46,800,-72,24.3,1679.3
4514370215,0,23,1,1,4,5,5,0,0,0,0,15943,7.2,19085,239,54,-325,772,23.9,1594.3,16,1,0,5,4,5,1,1,0,0,16268,6.8,18313,226,44,325,-772,22.6,1626.8
4446171042,1,16,4,1,8,4,7,0,0,0,0,17863,7.2,19086,256,33,2590,1850,25.6,1786.3,13,5,0,4,8,4,0,0,0,0,15273,7.0,17236,218,48,-2590,-1850,21.8,1527.3
4500708488,0,12,3,0,3,4,5,0,0,0,0,15537,7.0,18851,231,64,-937,-89,23.1,1553.7,16,5,1,4,3,5,1,1,0,0,16474,7.2,18940,251,68,937,89,25.1,1647.4
4515793486,1,18,2,1,6,3,7,1,1,0,0,16785,7.4,19346,245,45,1901,684,24.5,1678.5,48,1,0,3,6,2,0,0,0,0,14884,7.0,18662,211,68,-1901,-684,21.1,1488.4
4465932394,1,13,4,1,11,10,11,0,0,0,0,18042,6.6,17600,221,46,704,-422,22.1,1804.2,18,4,0,10,11,10,0,0,0,0,17338,7.0,18022,198,42,-704,422,19.8,1733.8
4524296550,0,24,3,0,3,4,6,0,0,0,0,14981,6.8,17082,235,52,-809,638,23.5,1498.1,17,2,1,4,3,7,2,1,1,0,15790,6.8,16444,218,50,809,-638,21.8,1579.0
4462225313,1,14,2,1,4,3,2,1,1,0,0,15257,6.8,18061,221,44,-216,882,22.1,1525.7,16,4,0,3,4,3,0,0,0,0,15473,6.6,17179,244,53,216,-882,24.4,1547.3
4524387920,1,16,2,1,6,2,4,2,1,1,0,17167,7.0,19248,247,67,2793,2280,24.7,1716.7,19,3,0,2,6,0,0,0,0,0,14374,6.6,16968,225,52,-2793,-2280,22.5,1437.4
4523371949,0,12,1,0,5,5,5,0,0,0,0,14712,6.6,16265,174,43,-2908,-1173,17.4,1471.2,12,1,1,5,5,2,2,1,1,1,17620,6.8,17438,240,52,2908,1173,24.0,1762.0
4525072110,1,89,2,1,13,4,13,1,0,1,0,19569,7.2,19298,203,36,5148,2308,20.3,1956.9,42,4,0,4,13,2,1,1,0,0,14421,6.8,16990,179,51,-5148,-2308,17.9,1442.1
4525831226,0,59,1,0,0,1,0,1,1,0,0,14457,7.0,18824,230,72,-832,541,23.0,1445.7,20,0,1,1,0,1,0,0,0,0,15289,7.0,18283,267,63,832,-541,26.7,1528.9
4467109109,1,15,4,1,5,12,3,0,0,0,0,16358,6.8,17640,206,56,-2651,-1695,20.6,1635.8,16,5,0,12,5,14,0,0,0,0,19009,7.2,19335,218,64,2651,1695,21.8,1900.9
4478251083,0,17,2,0,11,11,8,1,1,0,0,17373,6.6,16452,178,41,-1768,-2230,17.8,1737.3,14,0,1,11,11,8,0,0,0,0,19141,7.2,18682,198,41,1768,2230,19.8,1914.1
4518369652,1,16,6,1,7,5,6,1,0,1,0,16887,7.0,18500,212,39,1564,1214,21.2,1688.7,63,4,0,5,7,5,1,1,0,0,15323,6.6,17286,200,47,-1564,-1214,20.0,1532.3
4515740615,1,26,4,0,7,8,6,0,0,0,0,17009,7.2,19047,241,43,45,1199,24.1,1700.9,22,1,1,8,7,9,0,0,0,0,16964,7.0,17848,211,36,-45,-1199,21.1,1696.4
4527229646,0,42,2,0,5,6,3,0,0,0,0,16225,7.0,18754,219,54,-38,1167,21.9,1622.5,15,0,1,6,5,8,0,0,0,0,16263,6.8,17587,239,32,38,-1167,23.9,1626.3
4510367501,0,17,2,1,3,4,4,1,1,0,0,15544,6.8,18579,222,80,-873,300,22.2,1554.4,15,3,0,4,3,2,0,0,0,0,16417,7.0,18279,240,56,873,-300,24.0,1641.7
4519619414,1,12,1,0,6,8,7,1,0,1,1,18155,7.0,19429,231,65,468,558,23.1,1815.5,12,3,1,8,6,11,1,1,0,0,17687,7.0,18871,194,56,-468,-558,19.4,1768.7
4477670126,0,16,2,0,1,9,1,0,0,0,0,13316,6.6,16245,188,49,-4500,-2980,18.8,1331.6,13,2,1,9,1,11,1,1,0,0,17816,7.2,19225,215,44,4500,2980,21.5,1781.6
4514841518,1,14,1,0,5,6,4,0,0,0,0,15195,7.2,17896,196,43,-1573,-1171,19.6,1519.5,12,1,1,6,5,7,1,1,0,0,16768,7.0,19067,202,71,1573,1171,20.2,1676.8
4525064823,1,17,4,0,9,6,7,1,0,1,0,17530,6.8,18078,238,48,2063,1430,23.8,1753.0,40,2,1,6,9,3,0,0,0,0,15467,6.8,16648,189,48,-2063,-1430,18.9,1546.7
4522252175,1,18,4,1,8,9,7,0,0,0,0,17336,7.2,19025,218,60,691,696,21.8,1733.6,20,4,0,9,8,7,0,0,0,0,16645,7.0,18329,192,40,-691,-696,19.2,1664.5
4521200467,0,16,2,0,5,7,6,1,1,0,0,16213,6.6,17532,208,48,-916,483,20.8,1621.3,12,1,1,7,5,12,0,0,0,0,17129,7.0,17049,215,56,916,-483,21.5,1712.9
4521611697,1,34,3,1,9,8,6,0,0,0,0,17532,7.2,18592,233,44,1068,1295,23.3,1753.2,14,4,0,8,9,10,0,0,0,0,16464,6.8,17297,200,39,-1068,-1295,20.0,1646.4
4419611773,1,18,2,1,10,11,13,0,0,0,0,17447,6.4,16191,173,38,-384,-1658,17.3,1744.7,12,1,0,11,10,9,0,0,0,0,17831,7.0,17849,208,40,384,1658,20.8,1783.1
4526966381,0,14,2,0,9,6,8,0,0,0,0,17079,7.0,18150,203,47,899,295,20.3,1707.9,101,4,1,6,9,7,1,1,0,0,16180,7.0,17855,225,36,-899,-295,22.5,1618.0
4511428245,1,15,6,1,11,9,14,0,0,0,0,19645,7.0,18468,246,35,2241,1219,24.6,1964.5,20,3,0,9,11,9,1,1,0,0,17404,6.6,17249,203,60,-2241,-1219,20.3,1740.4
4510011476,1,16,2,1,7,3,9,0,0,0,0,17188,7.2,19483,244,57,2010,1365,24.4,1718.8,10,2,0,3,7,0,0,0,0,0,15178,6.8,18118,226,71,-2010,-1365,22.6,1517.8
4521651698,1,21,1,0,5,2,2,1,1,0,0,16344,7.4,19730,234,59,2032,2833,23.4,1634.4,14,2,1,2,5,2,0,0,0,0,14312,6.8,16897,212,48,-2032,-2833,21.2,1431.2
4514425607,0,17,2,0,7,4,4,1,0,1,0,17994,7.2,20156,269,48,3033,3187,26.9,1799.4,15,2,1,4,7,4,1,1,0,0,14961,6.6,16969,206,44,-3033,-3187,20.6,1496.1
4456337531,1,37,5,1,7,4,10,0,0,0,0,17053,7.0,17515,219,50,1126,71,21.9,1705.3,17,1,0,4,7,5,2,1,1,0,15927,6.8,17444,217,49,-1126,-71,21.7,1592.7
4527696871,1,36,2,1,9,4,11,1,1,0,0,18503,7.4,19717,250,56,2527,1695,25.0,1850.3,26,16,0,4,9,9,0,0,0,0,15976,7.0,18022,210,63,-2527,-1695,21.0,1597.6
4513962663,0,20,2,1,8,7,5,1,0,1,0,16815,7.0,18326,207,41,10,223,20.7,1681.5,19,6,0,7,8,8,0,0,0,0,16805,6.8,18103,241,48,-10,-223,24.1,1680.5
4514076419,1,20,1,1,4,3,7,0,0,0,0,15711,7.0,17395,223,59,886,706,22.3,1571.1,17,4,0,3,4,4,1,1,0,0,14825,6.8,16689,225,40,-886,-706,22.5,1482.5
4520327496,1,26,4,0,5,3,7,0,0,0,0,16784,7.0,18136,252,56,727,-566,25.2,1678.4,13,0,1,3,5,2,0,0,0,0,16057,7.2,18702,221,55,-727,566,22.1,1605.7
4522170496,0,16,3,0,4,6,6,1,1,0,0,15407,6.6,17007,232,24,-1122,-302,23.2,1540.7,15,1,1,6,4,8,0,0,0,0,16529,6.8,17309,214,52,1122,302,21.4,1652.9
4527270675,0,20,4,1,10,6,9,0,0,0,0,18344,7.2,18470,222,55,2326,987,22.2,1834.4,16,4,0,6,10,5,0,0,0,0,16018,7.0,17483,188,56,-2326,-987,18.8,1601.8
4520037654,1,18,3,1,5,2,4,2,1,1,0,15925,6.8,17913,228,56,1946,1292,22.8,1592.5,20,0,0,2,5,2,0,0,0,0,13979,6.8,16621,213,46,-1946,-1292,21.3,1397.9
4511912141,1,12,3,1,8,4,9,1,1,0,0,17779,6.8,18276,247,53,2988,398,24.7,1777.9,14,1,0,4,8,1,0,0,0,0,14791,7.0,17878,210,47,-2988,-398,21.0,1479.1
4464180700,0,15,4,0,2,4,2,0,0,0,0,15096,7.0,17840,228,48,-915,-1035,22.8,1509.6,33,3,1,4,2,4,0,0,0,0,16011,7.2,18875,239,65,915,1035,23.9,1601.1
4513313637,0,13,6,0,2,4,1,0,0,0,0,14155,6.6,16974,226,46,-1735,-1786,22.6,1415.5,17,3,1,4,2,3,1,1,0,0,15890,7.0,18760,258,59,1735,1786,25.8,1589.0
4520976634,0,16,2,1,2,11,2,1,1,0,0,13932,6.4,15660,193,56,-5540,-3682,19.3,1393.2,17,2,0,11,2,13,0,0,0,1,19472,7.2,19342,245,40,5540,3682,24.5,1947.2
4419504973,0,19,4,1,6,9,7,0,0,0,0,16369,7.0,18174,236,51,-1673,-1221,23.6,1636.9,36,6,0,9,6,10,0,0,0,0,18042,7.4,19395,239,40,1673,1221,23.9,1804.2
4524942450,0,14,2,1,9,7,8,1,0,1,1,18253,7.2,19481,203,45,1156,1711,20.3,1825.3,14,2,0,7,9,7,0,0,0,0,17097,7.0,17770,221,38,-1156,-1711,22.1,1709.7
4524354626,0,22,1,1,9,3,16,1,0,1,0,18741,7.2,19102,243,44,3447,1976,24.3,1874.1,15,3,0,3,9,6,1,1,0,0,15294,6.8,17126,210,68,-3447,-1976,21.0,1529.4
4513213507,0,41,2,1,10,11,14,1,1,0,0,19020,6.8,18128,216,52,609,-19,21.6,1902.0,14,7,0,11,10,14,1,0,1,0,18411,6.8,18147,221,31,-609,19,22.1,1841.1
4511125320,1,50,2,1,3,4,3,0,0,0,0,14815,6.4,16774,189,56,-755,-1590,18.9,1481.5,15,0,0,4,3,6,1,1,0,0,15570,7.0,18364,210,64,755,1590,21.0,1557.0
4500724758,0,17,3,1,4,7,4,1,1,0,0,14980,6.4,16983,206,39,-2040,-1012,20.6,1498.0,13,5,0,7,4,6,0,0,0,0,17020,7.0,17995,224,53,2040,1012,22.4,1702.0
4523608047,0,16,1,0,4,7,2,0,0,0,0,16224,7.0,18247,212,64,-294,321,21.2,1622.4,13,4,1,7,4,5,0,0,0,0,16518,7.0,17926,205,40,294,-321,20.5,1651.8
4520558243,1,18,2,1,9,6,7,1,1,0,0,17016,7.2,18560,210,60,338,-232,21.0,1701.6,12,2,0,6,9,7,0,0,0,0,16678,7.0,18792,212,56,-338,232,21.2,1667.8
4523419872,0,18,1,1,3,6,4,0,0,0,0,14422,6.8,16781,201,43,-2346,-1871,20.1,1442.2,13,1,0,6,3,6,0,0,0,0,16768,7.2,18652,237,58,2346,1871,23.7,1676.8
4518182783,0,16,1,0,5,6,6,1,0,1,0,14853,6.4,16170,174,48,-2673,-1867,17.4,1485.3,56,5,1,6,5,8,1,1,0,0,17526,7.0,18037,246,56,2673,1867,24.6,1752.6
4507022630,0,14,1,1,8,4,10,1,0,1,1,18913,7.4,19182,225,60,3240,1787,22.5,1891.3,19,4,0,4,8,6,1,1,0,0,15673,6.8,17395,237,48,-3240,-1787,23.7,1567.3
4423957236,1,15,3,1,11,5,14,1,0,1,0,18856,7.2,19227,231,51,3248,2152,23.1,1885.6,19,3,0,5,11,7,1,1,0,0,15608,6.6,17075,189,58,-3248,-2152,18.9,1560.8
4523702225,0,19,3,1,10,7,9,1,0,1,0,17619,7.2,18563,186,49,1273,622,18.6,1761.9,16,2,0,7,10,4,1,1,0,0,16346,7.0,17941,186,57,-1273,-622,18.6,1634.6
4449098709,1,13,1,1,11,1,10,1,1,0,1,19673,7.6,21261,209,68,5797,4456,20.9,1967.3,13,0,0,1,11,0,0,0,0,0,13876,6.8,16805,218,56,-5797,-4456,21.8,1387.6
4519511299,1,16,3,0,9,5,12,0,0,0,0,18876,7.0,18843,235,50,2201,615,23.5,1887.6,15,3,1,5,9,7,1,1,0,0,16675,7.0,18228,196,66,-2201,-615,19.6,1667.5
4495278718,1,38,3,1,6,6,11,0,0,0,0,17244,7.2,18750,221,51,1091,1084,22.1,1724.4,15,2,0,6,6,12,2,1,1,0,16153,6.8,17666,235,48,-1091,-1084,23.5,1615.3
4517917805,1,17,1,0,6,9,10,1,1,0,0,17217,7.0,18979,222,60,-315,-7,22.2,1721.7,22,2,1,9,6,11,0,0,0,0,17532,7.0,18986,218,52,315,7,21.8,1753.2
4499645547,0,14,1,1,5,8,9,0,0,0,0,15934,6.4,16140,199,45,-2277,-2919,19.9,1593.4,14,4,0,8,5,8,1,1,0,0,18211,7.0,19059,257,64,2277,2919,25.7,1821.1
4480384157,0,17,2,0,4,6,3,0,0,0,0,15773,7.0,17562,238,56,-1254,-567,23.8,1577.3,16,3,1,6,4,10,1,1,0,0,17027,7.0,18129,231,60,1254,567,23.1,1702.7
4503236758,0,17,3,0,6,6,5,0,0,0,0,15384,6.6,17040,189,44,-1495,-801,18.9,1538.4,18,3,1,6,6,7,2,1,1,0,16879,6.8,17841,211,73,1495,801,21.1,1687.9
4524479196,0,11,2,0,1,8,2,0,0,0,0,13841,6.8,16368,216,49,-5048,-4145,21.6,1384.1,18,0,1,8,1,6,1,1,0,0,18889,7.4,20513,268,53,5048,4145,26.8,1888.9
4505357300,1,16,4,0,6,6,5,0,0,0,0,16029,7.0,18567,205,56,-355,233,20.5,1602.9,19,3,1,6,6,5,1,1,0,0,16384,7.0,18334,224,48,355,-233,22.4,1638.4
4518346455,1,13,3,1,6,2,9,0,0,0,0,16803,7.4,19509,242,44,1829,1496,24.2,1680.3,15,1,0,2,6,2,1,1,0,0,14974,7.0,18013,239,48,-1829,-1496,23.9,1497.4
4523309426,1,12,3,0,10,6,10,0,0,0,0,17332,7.0,18045,195,42,1711,1235,19.5,1733.2,15,0,1,6,10,3,0,0,0,0,15621,6.6,16810,203,37,-1711,-1235,20.3,1562.1
4522801781,0,118,4,1,6,8,8,0,0,0,0,16102,6.6,17077,200,45,-1412,-768,20.0,1610.2,20,2,0,8,6,9,0,0,0,0,17514,6.8,17845,227,40,1412,768,22.7,1751.4
4515686692,1,14,3,0,6,5,6,1,1,0,0,16454,6.8,17910,209,52,-247,-20,20.9,1645.4,36,1,1,5,6,6,0,0,0,0,16701,7.0,17930,227,48,247,20,22.7,1670.1
4525920930,0,16,2,0,3,2,4,1,1,0,0,15240,6.6,17591,234,52,323,392,23.4,1524.0,13,2,1,2,3,3,0,0,0,0,14917,6.6,17199,231,56,-323,-392,23.1,1491.7
4499622849,1,16,6,1,5,4,9,0,0,0,0,16415,6.8,17645,247,37,1626,747,24.7,1641.5,17,2,0,4,5,5,1,1,0,0,14789,7.0,16898,203,51,-1626,-747,20.3,1478.9
4521085748,0,15,2,0,5,5,6,0,0,0,0,16372,7.0,18609,234,44,611,817,23.4,1637.2,49,2,1,5,5,5,1,1,0,0,15761,6.8,17792,222,47,-611,-817,22.2,1576.1
4444198769,0,15,1,1,8,6,18,0,0,0,0,17008,6.8,16636,206,40,801,-1533,20.6,1700.8,14,1,0,6,8,6,0,0,0,0,16207,7.0,18169,223,48,-801,1533,22.3,1620.7
4522616210,0,19,0,0,5,3,5,1,0,1,0,15486,7.0,17388,205,52,904,195,20.5,1548.6,18,2,1,3,5,3,1,1,0,0,14582,6.8,17193,216,44,-904,-195,21.6,1458.2
4524432145,0,16,3,0,2,9,2,0,0,0,0,14085,6.4,15408,220,38,-3803,-4020,22.0,1408.5,18,1,1,9,2,4,2,1,1,0,17888,7.2,19428,245,60,3803,4020,24.5,1788.8
4499380853,1,39,3,1,3,4,4,2,1,1,1,16657,7.2,18356,228,52,1129,218,22.8,1665.7,13,1,0,4,3,4,0,0,0,0,15528,7.2,18138,238,40,-1129,-218,23.8,1552.8
4520997585,0,46,4,1,7,4,11,1,1,0,0,16836,7.2,18457,205,48,1138,1758,20.5,1683.6,40,4,0,4,7,3,0,0,0,0,15698,6.6,16699,223,44,-1138,-1758,22.3,1569.8
4512793610,0,21,5,1,2,3,1,0,0,0,0,14868,7.0,17736,257,39,-539,-852,25.7,1486.8,15,7,0,3,2,4,1,0,1,0,15407,7.2,18588,243,58,539,852,24.3,1540.7
4519991691,0,61,0,1,3,13,4,0,0,0,0,13908,5.4,12798,167,38,-4561,-5031,16.7,1390.8,16,2,0,13,3,20,1,1,0,0,18469,7.0,17829,187,58,4561,5031,18.7,1846.9
4527136239,0,19,6,1,13,7,14,1,1,0,0,18839,7.2,18977,189,53,1144,944,18.9,1883.9,16,3,0,7,13,7,0,0,0,0,17695,7.0,18033,228,40,-1144,-944,22.8,1769.5
4479699152,1,14,2,0,9,8,8,0,0,0,0,17642,7.2,18820,227,53,1794,2548,22.7,1764.2,16,2,1,8,9,3,0,0,0,0,15848,6.4,16272,179,48,-1794,-2548,17.9,1584.8
4456971409,0,15,2,1,7,3,5,1,1,0,0,15728,6.8,17209,208,30,989,-477,20.8,1572.8,14,0,0,3,7,2,0,0,0,0,14739,6.6,17686,208,62,-989,477,20.8,1473.9
4472572307,0,16,1,0,5,7,4,0,0,0,0,14874,6.6,16128,182,32,-2189,-1838,18.2,1487.4,49,7,1,7,5,7,1,1,0,0,17063,6.8,17966,207,61,2189,1838,20.7,1706.3
4501021398,0,12,1,0,2,11,2,0,0,0,0,14346,6.4,15676,200,49,-3886,-3453,20.0,1434.6,15,3,1,11,2,10,1,1,0,0,18232,7.2,19129,220,53,3886,3453,22.0,1823.2
4526935015,1,15,6,1,6,3,5,1,1,0,0,16638,7.2,18824,212,67,1402,1512,21.2,1663.8,21,2,0,3,6,3,0,0,0,0,15236,6.8,17312,230,52,-1402,-1512,23.0,1523.6
4492859847,0,16,1,1,6,7,6,0,0,0,0,16777,7.0,18587,212,55,295,857,21.2,1677.7,23,5,0,7,6,7,1,1,0,0,16482,7.0,17730,218,40,-295,-857,21.8,1648.2
4524074861,0,15,0,1,7,9,6,0,0,0,0,16070,6.6,16510,199,44,-1923,-1753,19.9,1607.0,17,1,0,9,7,11,0,0,0,0,17993,7.0,18263,211,60,1923,1753,21.1,1799.3
4510783393,1,18,2,1,5,2,5,1,1,0,0,15931,7.0,17840,231,49,393,111,23.1,1593.1,16,2,0,2,5,3,0,0,0,0,15538,6.8,17729,255,51,-393,-111,25.5,1553.8
4476704273,1,16,0,1,5,6,4,1,1,0,0,16180,7.2,18710,234,60,-1348,-407,23.4,1618.0,16,1,0,6,5,6,0,0,0,0,17528,7.0,19117,245,55,1348,407,24.5,1752.8
4489423422,0,17,4,1,7,8,6,0,0,0,0,16199,6.6,16645,206,48,-811,-798,20.6,1619.9,15,4,0,8,7,8,1,1,0,0,17010,6.8,17443,192,56,811,798,19.2,1701.0
4519044146,0,12,2,1,3,9,2,0,0,0,0,13808,6.2,15418,169,42,-4523,-3729,16.9,1380.8,18,1,0,9,3,9,1,1,0,0,18331,7.2,19147,219,65,4523,3729,21.9,1833.1
4524235691,0,91,4,1,7,6,12,0,0,0,0,17222,7.0,18157,227,48,808,-236,22.7,1722.2,13,3,0,6,7,3,1,1,0,0,16414,7.0,18393,250,53,-808,236,25.0,1641.4
4491903600,1,18,1,1,12,10,13,0,0,0,0,19884,7.4,19673,226,63,1136,2782,22.6,1988.4,14,3,0,10,12,12,0,0,0,0,18748,6.8,16891,211,39,-1136,-2782,21.1,1874.8
4516238123,0,13,3,1,7,6,8,0,0,0,0,16097,6.6,16760,214,42,853,363,21.4,1609.7,17,0,0,6,7,4,1,1,0,0,15244,6.4,16397,182,46,-853,-363,18.2,1524.4
4517167802,0,33,4,0,7,14,10,0,0,0,0,16204,7.0,17704,182,49,-4473,-3040,18.2,1620.4,17,1,1,14,7,19,1,1,0,0,20677,7.4,20744,237,80,4473,3040,23.7,2067.7
4456395862,1,15,2,0,9,12,7,0,0,0,0,17709,6.6,17077,213,35,-653,-1717,21.3,1770.9,14,1,1,12,9,15,0,0,0,0,18362,7.0,18794,193,40,653,1717,19.3,1836.2
4499304151,0,43,5,1,8,2,11,1,1,0,0,17554,7.2,19243,204,51,3255,1724,20.4,1755.4,17,1,0,2,8,1,0,0,0,0,14299,6.8,17519,211,46,-3255,-1724,21.1,1429.9
4478623490,0,21,2,1,7,6,6,0,0,0,0,16760,6.8,17857,206,51,-1052,-1064,20.6,1676.0,17,4,0,6,7,6,1,1,0,0,17812,7.2,18921,231,68,1052,1064,23.1,1781.2
4480431090,0,15,2,0,5,5,7,0,0,0,0,15082,6.8,16399,199,40,-1851,-2039,19.9,1508.2,17,1,1,5,5,4,1,0,1,0,16933,7.0,18438,258,52,1851,2039,25.8,1693.3
4437014946,0,14,2,1,3,2,3,0,0,0,0,15734,7.0,18750,236,68,465,-911,23.6,1573.4,82,3,0,2,3,1,1,1,0,0,15269,7.2,19661,226,76,-465,911,22.6,1526.9
4518204100,0,39,1,0,6,9,5,0,0,0,0,16462,7.2,18654,212,59,-1785,-940,21.2,1646.2,137,3,1,9,6,8,1,1,0,0,18247,7.2,19594,232,54,1785,940,23.2,1824.7
4522433326,0,9,1,0,1,1,0,0,0,0,0,14591,6.8,17823,230,66,-817,-1289,23.0,1459.1,12,2,1,1,1,0,1,1,0,0,15408,7.0,19112,253,76,817,1289,25.3,1540.8
4502808348,0,16,3,0,3,15,3,0,0,0,0,15120,6.8,16829,191,56,-5023,-1374,19.1,1512.0,21,1,1,15,3,28,2,1,1,0,20143,7.2,18203,217,44,5023,1374,21.7,2014.3
4527042510,0,20,1,1,12,4,14,2,1,1,0,19339,7.2,19966,225,66,3708,2901,22.5,1933.9,83,3,0,4,12,3,0,0,0,0,15631,6.8,17065,203,60,-3708,-2901,20.3,1563.1
4519746020,0,17,2,0,3,15,2,1,0,1,0,15320,6.8,16625,176,56,-4348,-4019,17.6,1532.0,33,5,1,15,3,15,1,1,0,0,19668,7.6,20644,208,48,4348,4019,20.8,1966.8
4502009252,1,14,2,0,4,3,6,1,1,0,0,15712,6.8,17867,241,43,66,-361,24.1,1571.2,13,4,1,3,4,4,0,0,0,0,15646,6.8,18228,245,51,-66,361,24.5,1564.6
4519035027,1,13,2,0,3,4,1,1,1,0,0,15115,7.2,19609,219,72,-90,982,21.9,1511.5,18,1,1,4,3,1,1,0,1,0,15205,7.2,18627,213,44,90,-982,21.3,1520.5
4520532306,1,16,1,0,3,9,5,0,0,0,0,14351,6.8,16380,172,62,-3540,-3645,17.2,1435.1,13,3,1,9,3,4,2,1,1,0,17891,7.6,20025,224,69,3540,3645,22.4,1789.1
4526620130,1,13,7,1,10,2,9,2,1,1,0,18137,7.0,18171,231,44,3807,1830,23.1,1813.7,14,4,0,2,10,3,0,0,0,0,14330,6.6,16341,204,43,-3807,-1830,20.4,1433.0
4520967053,1,17,4,1,11,2,13,1,0,1,0,19082,7.6,20858,244,60,4012,3080,24.4,1908.2,16,4,0,2,11,2,0,0,0,0,15070,6.8,17778,230,60,-4012,-3080,23.0,1507.0
4523056452,1,16,2,0,7,5,6,1,1,0,0,16580,7.0,17570,207,36,-334,-1403,20.7,1658.0,15,4,1,5,7,5,0,0,0,0,16914,7.0,18973,228,56,334,1403,22.8,1691.4
4452162573,0,20,3,1,4,4,6,0,0,0,0,15474,6.6,16611,231,28,331,-1585,23.1,1547.4,15,2,0,4,4,5,1,1,0,0,15143,7.2,18196,216,51,-331,1585,21.6,1514.3
4524622541,0,16,1,1,3,5,3,0,0,0,0,14837,6.6,15974,200,44,-1044,-2760,20.0,1483.7,25,5,0,5,3,7,1,1,0,0,15881,7.2,18734,183,68,1044,2760,18.3,1588.1
4524932561,1,15,4,1,6,5,5,1,0,1,0,16698,7.2,19972,238,59,865,2685,23.8,1669.8,22,4,0,5,6,8,1,1,0,0,15833,6.8,17287,213,48,-865,-2685,21.3,1583.3
4454366358,1,20,5,0,14,8,15,0,0,0,1,19950,7.0,18520,212,26,3657,3286,21.2,1995.0,13,4,1,8,14,12,1,1,0,0,16293,6.2,15234,156,49,-3657,-3286,15.6,1629.3
4505244721,0,11,2,0,5,7,6,0,0,0,0,16456,6.6,17035,213,51,355,-798,21.3,1645.6,19,1,1,7,5,5,2,1,1,0,16101,6.8,17833,223,60,-355,798,22.3,1610.1
4494519313,1,12,1,1,13,1,14,0,0,0,1,20699,7.4,19768,249,44,7721,5190,24.9,2069.9,14,0,0,1,13,0,0,0,0,0,12978,6.0,14578,200,40,-7721,-5190,20.0,1297.8
4515736487,0,21,3,0,4,8,3,0,0,0,0,14787,6.6,16543,185,60,-2404,-2013,18.5,1478.7,18,2,1,8,4,8,0,0,0,0,17191,7.0,18556,228,36,2404,2013,22.8,1719.1
4512177311,0,31,2,1,3,8,3,1,1,0,0,15315,6.8,17328,213,48,-2314,-2460,21.3,1531.5,14,6,0,8,3,11,0,0,0,0,17629,7.2,19788,237,61,2314,2460,23.7,1762.9
4522209183,1,13,0,0,12,8,12,0,0,0,0,18968,7.0,18902,201,36,1686,886,20.1,1896.8,17,1,1,8,12,8,0,0,0,0,17282,7.0,18016,186,64,-1686,-886,18.6,1728.2
4459678917,1,13,1,0,4,7,7,0,0,0,0,15520,6.8,18045,199,72,-2195,-291,19.9,1552.0,14,3,1,7,4,8,0,0,0,0,17715,7.0,18336,255,48,2195,291,25.5,1771.5
4517814495,0,16,2,1,14,3,15,1,0,1,1,21055,7.2,19573,219,52,6744,5355,21.9,2105.5,16,3,0,3,14,3,1,1,0,0,14311,6.0,14218,166,53,-6744,-5355,16.6,1431.1
4520934653,1,14,2,0,8,3,8,0,0,0,0,16847,7.2,18705,195,68,1255,2754,19.5,1684.7,13,0,1,3,8,2,0,0,0,0,15592,6.4,15951,247,33,-1255,-2754,24.7,1559.2
4505180174,0,19,1,1,7,7,8,1,1,0,0,17044,7.0,17819,200,55,-115,141,20.0,1704.4,9,3,0,7,7,7,0,0,0,0,17159,7.0,17678,209,56,115,-141,20.9,1715.9
4520358684,0,14,5,0,8,5,9,1,1,0,0,16753,6.8,18557,233,40,204,-830,23.3,1675.3,13,3,1,5,8,4,1,0,1,0,16549,7.2,19387,217,52,-204,830,21.7,1654.9
4520529503,1,12,2,0,1,4,1,0,0,0,0,13943,6.4,17306,229,50,-3461,-1353,22.9,1394.3,17,3,1,4,1,6,2,1,1,1,17404,7.0,18659,244,60,3461,1353,24.4,1740.4
4515442346,0,14,4,0,2,8,2,2,1,1,0,15034,7.0,17176,204,77,-1975,-888,20.4,1503.4,15,4,1,8,2,11,0,0,0,0,17009,7.0,18064,201,44,1975,888,20.1,1700.9
4515579882,0,15,3,0,7,4,7,0,0,0,0,16364,7.2,18941,239,28,687,-291,23.9,1636.4,48,5,1,4,7,7,1,1,0,0,15677,7.2,19232,232,62,-687,291,23.2,1567.7
4503150279,1,18,1,1,7,2,6,0,0,0,0,16647,7.0,18161,214,48,3257,2138,21.4,1664.7,27,2,0,2,7,1,0,0,0,0,13390,6.2,16023,197,44,-3257,-2138,19.7,1339.0
4525034220,1,13,5,1,6,4,7,1,0,1,0,17530,7.2,19895,221,68,2577,2592,22.1,1753.0,17,2,0,4,6,3,1,1,0,0,14953,6.8,17303,196,46,-2577,-2592,19.6,1495.3
4507744435,0,14,1,0,2,7,1,0,0,0,0,14873,6.8,17781,205,72,-2304,31,20.5,1487.3,15,1,1,7,2,9,1,1,0,0,17177,7.0,17750,238,44,2304,-31,23.8,1717.7
4525839083,1,35,3,1,10,5,9,2,1,1,1,19439,7.4,19736,244,50,3863,2639,24.4,1943.9,17,2,0,5,10,5,0,0,0,0,15576,6.6,17097,197,49,-3863,-2639,19.7,1557.6
4495697514,1,19,2,1,8,9,15,0,0,0,0,16730,6.6,16831,221,38,-810,-1226,22.1,1673.0,16,3,0,9,8,10,0,0,0,0,17540,7.2,18057,204,59,810,1226,20.4,1754.0
4497280145,0,13,4,1,5,5,5,1,0,1,0,15204,7.0,17694,182,40,-1578,-1724,18.2,1520.4,17,1,0,5,5,8,0,0,0,0,16782,7.2,19418,250,55,1578,1724,25.0,1678.2
4471257254,1,19,2,1,8,6,11,0,0,0,0,17072,6.4,16658,192,36,1396,89,19.2,1707.2,21,2,0,6,8,15,1,1,0,0,15676,6.8,16569,179,53,-1396,-89,17.9,1567.6
4417615828,0,14,1,0,6,6,7,1,1,0,0,16642,7.0,18251,218,52,-348,-611,21.8,1664.2,15,0,1,6,6,4,1,0,1,0,16990,7.0,18862,237,40,348,611,23.7,1699.0
4525913834,1,18,2,0,3,4,2,0,0,0,0,14830,6.8,16901,184,60,-572,-636,18.4,1483.0,17,3,1,4,3,3,1,1,0,0,15402,7.0,17537,194,56,572,636,19.4,1540.2
4523639973,1,21,2,0,3,5,3,2,1,1,0,16009,7.2,18511,268,55,-473,383,26.8,1600.9,16,6,1,5,3,7,0,0,0,0,16482,6.8,18128,246,46,473,-383,24.6,1648.2
4514715647,0,57,3,0,2,6,1,0,0,0,0,14230,6.6,17035,232,39,-2647,-1872,23.2,1423.0,16,1,1,6,2,6,2,1,1,0,16877,7.0,18907,254,69,2647,1872,25.4,1687.7
4468376648,0,21,3,0,7,6,6,0,0,0,0,17041,7.4,18750,232,52,1016,2078,23.2,1704.1,58,3,1,6,7,7,1,1,0,0,16025,6.6,16672,211,38,-1016,-2078,21.1,1602.5
4522772001,0,14,2,0,4,6,1,0,0,0,0,15310,7.0,18337,221,52,-1038,-1307,22.1,1531.0,15,2,1,6,4,5,2,1,1,0,16348,7.2,19644,226,66,1038,1307,22.6,1634.8
4527261284,0,21,1,1,6,6,9,0,0,0,0,16135,6.6,16582,181,67,-1370,-1220,18.1,1613.5,14,3,0,6,6,8,0,0,0,0,17505,6.8,17802,235,44,1370,1220,23.5,1750.5
4516727076,1,14,1,0,4,9,3,0,0,0,0,16172,6.8,17632,221,48,-1460,-1134,22.1,1617.2,15,1,1,9,4,15,1,1,0,0,17632,7.2,18766,223,56,1460,1134,22.3,1763.2
4506004524,0,43,2,0,5,11,4,1,1,0,0,14763,6.8,16834,179,47,-4462,-2990,17.9,1476.3,13,2,1,11,5,11,0,0,0,0,19225,7.2,19824,255,51,4462,2990,25.5,1922.5
4520050863,0,11,5,0,7,15,5,0,0,0,0,15463,6.4,16063,208,20,-3882,-2253,20.8,1546.3,15,1,1,15,7,15,2,1,1,0,19345,7.0,18316,213,40,3882,2253,21.3,1934.5
4520754348,1,15,5,1,6,5,10,2,1,1,0,17466,7.4,18793,246,48,1499,2469,24.6,1746.6,18,3,0,5,6,8,0,0,0,0,15967,6.6,16324,215,56,-1499,-2469,21.5,1596.7
4505777098,0,91,0,1,3,7,2,0,0,0,0,14725,6.6,17519,210,36,-2686,-1780,21.0,1472.5,12,3,0,7,3,11,0,0,0,0,17411,7.2,19299,242,39,2686,1780,24.2,1741.1
4509069463,1,15,3,1,7,5,8,2,1,1,0,17788,7.0,18965,248,53,1767,1408,24.8,1778.8,11,1,0,5,7,4,0,0,0,0,16021,7.0,17557,221,56,-1767,-1408,22.1,1602.1
4505605320,1,15,4,1,10,4,13,1,1,0,0,17917,7.2,18904,212,37,3058,1325,21.2,1791.7,37,1,0,4,10,2,1,0,1,0,14859,6.8,17579,222,52,-3058,-1325,22.2,1485.9
4523332749,1,9,4,0,6,8,7,0,0,0,0,15982,6.6,18257,186,63,-2221,-365,18.6,1598.2,17,0,1,8,6,15,0,0,0,0,18203,7.2,18622,219,48,2221,365,21.9,1820.3
4518537002,0,14,3,1,10,9,15,0,0,0,0,17892,7.0,18021,190,48,479,52,19.0,1789.2,14,2,0,9,10,19,0,0,0,0,17413,7.0,17969,221,48,-479,-52,22.1,1741.3
4505443284,1,24,8,0,11,4,16,1,0,1,0,18215,7.2,19165,239,47,3672,4732,23.9,1821.5,16,4,1,4,11,6,1,1,0,0,14543,6.2,14433,183,59,-3672,-4732,18.3,1454.3
4524060982,1,41,5,0,7,6,11,1,1,0,0,17094,6.8,17903,205,44,525,44,20.5,1709.4,20,4,1,6,7,6,0,0,0,0,16569,7.0,17859,225,48,-525,-44,22.5,1656.9
4451378349,0,14,0,0,9,15,7,0,0,0,0,17492,7.2,19413,189,60,-1988,-616,18.9,1749.2,51,2,1,15,9,17,2,1,1,0,19480,7.4,20029,204,56,1988,616,20.4,1948.0
4462632051,1,48,4,1,6,6,9,1,1,0,0,16301,6.8,17430,210,51,-303,312,21.0,1630.1,19,6,0,6,6,11,1,0,1,0,16604,6.8,17118,210,59,303,-312,21.0,1660.4
4522819691,0,37,2,0,5,4,3,0,0,0,0,16021,7.2,19551,216,60,-470,1524,21.6,1602.1,16,1,1,4,5,4,0,0,0,0,16491,6.8,18027,237,50,470,-1524,23.7,1649.1
4464852917,1,18,1,0,7,11,10,0,0,0,0,16943,6.8,17177,215,52,-1228,-1785,21.5,1694.3,41,4,1,11,7,11,1,1,0,0,18171,7.4,18962,217,56,1228,1785,21.7,1817.1
4496160453,0,14,2,0,6,7,5,0,0,0,0,16169,6.6,17326,214,42,-620,-1984,21.4,1616.9,18,5,1,7,6,4,2,1,1,0,16789,7.0,19310,237,56,620,1984,23.7,1678.9
4475517974,0,55,2,0,6,5,10,0,0,0,0,16548,6.6,17430,230,23,503,-194,23.0,1654.8,21,3,1,5,6,8,2,1,1,0,16045,7.0,17624,211,67,-503,194,21.1,1604.5
4464447310,1,20,3,0,11,4,13,1,1,0,0,19716,7.2,19989,234,52,5163,3968,23.4,1971.6,15,0,1,4,11,4,0,0,0,0,14553,6.4,16021,182,51,-5163,-3968,18.2,1455.3
4510115879,0,18,2,0,4,12,6,0,0,0,0,15207,6.6,16955,213,44,-5324,-2914,21.3,1520.7,16,1,1,12,4,12,2,1,1,1,20531,7.2,19869,205,64,5324,2914,20.5,2053.1
4526340314,1,18,3,0,10,4,4,0,0,0,0,18581,7.6,19769,249,55,3301,3347,24.9,1858.1,17,3,1,4,10,4,1,1,0,0,15280,6.6,16422,213,40,-3301,-3347,21.3,1528.0
4521731006,0,14,3,0,3,10,6,0,0,0,0,14208,6.4,14744,212,36,-4960,-3887,21.2,1420.8,15,2,1,10,3,17,2,1,1,0,19168,7.2,18631,235,54,4960,3887,23.5,1916.8
4475432693,1,15,3,1,10,4,11,1,1,0,0,18005,7.0,19501,210,60,2962,3043,21.0,1800.5,18,3,0,4,10,1,0,0,0,0,15043,6.6,16458,187,48,-2962,-3043,18.7,1504.3
4526011384,0,35,3,0,0,11,0,0,0,0,0,13590,6.6,16558,200,49,-5691,-3094,20.0,1359.0,13,3,1,11,0,11,1,1,0,0,19281,7.4,19652,220,52,5691,3094,22.0,1928.1
4524369918,0,41,5,1,9,5,9,0,0,0,0,18287,7.2,18535,242,52,2845,2164,24.2,1828.7,16,3,0,5,9,6,0,0,0,0,15442,6.6,16371,233,26,-2845,-2164,23.3,1544.2
4522438327,1,33,5,0,4,4,5,1,1,0,0,16476,6.6,17137,225,50,896,-140,22.5,1647.6,13,5,1,4,4,1,1,0,1,0,15580,6.8,17277,227,54,-896,140,22.7,1558.0
4439479847,0,12,3,1,4,5,4,1,1,0,0,16229,7.2,18834,247,48,960,813,24.7,1622.9,16,3,0,5,4,5,0,0,0,0,15269,6.8,18021,201,51,-960,-813,20.1,1526.9
4525623416,0,21,1,0,2,6,2,1,1,0,0,14294,6.6,17461,220,61,-2820,-2226,22.0,1429.4,14,0,1,6,2,5,1,0,1,0,17114,7.4,19687,236,49,2820,2226,23.6,1711.4
4518159499,0,38,2,0,6,8,8,0,0,0,0,16917,7.2,18964,212,62,-1013,-36,21.2,1691.7,12,1,1,8,6,6,1,1,0,0,17930,7.0,19000,260,56,1013,36,26.0,1793.0
4524024822,1,13,8,1,12,2,10,2,1,1,1,20860,7.4,21006,268,65,8027,7621,26.8,2086.0,17,2,0,2,12,3,0,0,0,0,12833,5.8,13385,165,36,-8027,-7621,16.5,1283.3
4511018113,0,13,1,1,1,3,0,0,0,0,0,14118,7.0,17794,215,64,-2079,-538,21.5,1411.8,14,1,0,3,1,4,0,0,0,0,16197,7.0,18332,244,53,2079,538,24.4,1619.7
4478393634,0,33,6,0,4,12,2,0,0,0,0,15585,6.8,17639,224,42,-3559,-1319,22.4,1558.5,30,2,1,12,4,11,0,0,0,0,19144,7.2,18958,216,44,3559,1319,21.6,1914.4
4522793625,1,18,1,1,7,4,16,1,1,0,0,16282,6.4,16018,173,57,2062,1120,17.3,1628.2,16,1,0,4,7,9,0,0,0,0,14220,6.4,14898,174,44,-2062,-1120,17.4,1422.0
4455227439,1,14,1,0,9,6,10,1,0,1,0,17854,7.0,17358,170,61,2180,462,17.0,1785.4,12,2,1,6,9,6,1,1,0,0,15674,6.8,16896,209,31,-2180,-462,20.9,1567.4
4467363451,1,17,8,1,10,5,13,0,0,0,0,17941,6.8,17529,206,52,1680,1254,20.6,1794.1,18,5,0,5,10,5,0,0,0,0,16261,6.4,16275,215,36,-1680,-1254,21.5,1626.1
4515533339,1,16,2,0,5,12,6,0,0,0,0,16177,6.8,17721,214,56,-2281,-1283,21.4,1617.7,12,2,1,12,5,12,1,1,0,0,18458,7.2,19004,229,52,2281,1283,22.9,1845.8
4458793394,0,17,3,0,1,11,1,0,0,0,0,13265,6.4,15753,195,52,-6200,-3576,19.5,1326.5,18,3,1,11,1,8,1,1,0,1,19465,7.2,19329,248,44,6200,3576,24.8,1946.5
4523323986,0,20,2,1,8,6,10,0,0,0,0,17828,7.0,18836,229,43,1042,-31,22.9,1782.8,16,4,0,6,8,3,0,0,0,0,16786,7.0,18867,231,52,-1042,31,23.1,1678.6
4480691713,0,13,5,0,5,7,4,0,0,0,0,15132,6.6,17149,196,44,-1740,-916,19.6,1513.2,20,3,1,7,5,8,1,1,0,0,16872,6.8,18065,230,56,1740,916,23.0,1687.2
4500489540,0,14,1,0,3,3,3,0,0,0,0,15255,7.0,18312,228,45,-112,233,22.8,1525.5,39,1,1,3,3,3,0,0,0,0,15367,7.0,18079,234,56,112,-233,23.4,1536.7
4519680477,1,18,2,1,8,3,7,1,1,0,0,17828,7.2,19155,242,65,3642,3850,24.2,1782.8,38,6,0,3,8,3,0,0,0,0,14186,6.2,15305,179,34,-3642,-3850,17.9,1418.6
4498675239,0,10,1,0,5,12,7,0,0,0,0,15828,6.6,16976,195,40,-2330,-1189,19.5,1582.8,13,3,1,12,5,12,1,1,0,0,18158,7.0,18165,215,40,2330,1189,21.5,1815.8
4519835151,0,19,3,0,6,9,3,0,0,0,0,16404,6.8,18053,231,40,-554,174,23.1,1640.4,17,4,1,9,6,9,2,1,1,0,16958,6.8,17879,204,41,554,-174,20.4,1695.8
4525865804,1,13,6,1,8,8,7,1,1,0,0,16613,6.8,17888,229,44,-271,99,22.9,1661.3,15,4,0,8,8,4,0,0,0,0,16884,6.8,17789,232,44,271,-99,23.2,1688.4
4525369607,0,16,2,0,8,5,7,0,0,0,0,17337,7.0,18952,228,56,2429,2405,22.8,1733.7,44,3,1,5,8,5,1,1,0,0,14908,6.6,16547,198,46,-2429,-2405,19.8,1490.8
4521897188,1,17,2,1,8,5,4,0,0,0,0,16749,6.8,17788,217,43,1152,400,21.7,1674.9,14,2,0,5,8,7,1,1,0,0,15597,6.6,17388,185,68,-1152,-400,18.5,1559.7
4488944562,1,18,5,1,4,5,7,0,0,0,0,15340,6.6,16902,213,43,-885,-1554,21.3,1534.0,18,7,0,5,4,5,2,1,1,0,16225,7.2,18456,240,60,885,1554,24.0,1622.5
4523445811,0,15,3,1,6,4,6,0,0,0,0,16513,7.2,18896,241,48,752,1146,24.1,1651.3,15,3,0,4,6,6,1,1,0,0,15761,7.0,17750,216,51,-752,-1146,21.6,1576.1
4516695912,0,12,2,1,4,2,2,1,0,1,0,16002,7.2,18467,245,61,1765,701,24.5,1600.2,15,0,0,2,4,1,0,0,0,0,14237,6.8,17766,212,58,-1765,-701,21.2,1423.7
4521129958,1,13,3,1,6,3,5,0,0,0,0,16097,7.0,18426,226,51,1212,1738,22.6,1609.7,13,3,0,3,6,1,2,1,1,0,14885,6.6,16688,216,50,-1212,-1738,21.6,1488.5
4500758872,0,11,0,0,4,8,6,0,0,0,0,14327,6.6,16104,194,30,-3392,-2116,19.4,1432.7,15,2,1,8,4,7,1,1,0,0,17719,6.8,18220,223,41,3392,2116,22.3,1771.9
4497765026,1,10,4,0,2,3,1,0,0,0,0,15568,7.0,18302,245,48,542,1212,24.5,1556.8,16,1,1,3,2,4,1,1,0,0,15026,6.6,17090,209,62,-542,-1212,20.9,1502.6
4429486916,1,18,2,1,9,5,9,0,0,0,0,17941,7.2,19379,230,51,2187,2189,23.0,1794.1,45,3,0,5,9,5,0,0,0,0,15754,7.0,17190,206,52,-2187,-2189,20.6,1575.4
4464569523,1,20,5,1,8,5,11,1,1,0,0,17366,7.0,17659,229,46,1074,52,22.9,1736.6,18,5,0,5,8,3,0,0,0,0,16292,6.8,17607,245,34,-1074,-52,24.5,1629.2
4513785309,0,16,4,0,3,10,3,0,0,0,0,14536,6.6,15452,201,44,-3203,-2199,20.1,1453.6,18,4,1,10,3,8,0,0,0,0,17739,7.2,17651,212,36,3203,2199,21.2,1773.9
4505276282,0,13,3,1,7,13,11,0,0,0,0,16571,6.4,15773,178,44,-1624,-3004,17.8,1657.1,21,2,0,13,7,15,0,0,0,0,18195,7.2,18777,207,32,1624,3004,20.7,1819.5
4517495714,0,18,3,0,3,7,3,0,0,0,0,15355,6.6,17119,204,43,-2215,-2114,20.4,1535.5,16,2,1,7,3,8,2,1,1,0,17570,7.2,19233,240,65,2215,2114,24.0,1757.0
4499761953,0,19,1,0,4,6,6,0,0,0,0,15540,6.8,17724,236,54,-468,-581,23.6,1554.0,15,2,1,6,4,5,2,1,1,0,16008,7.0,18305,234,50,468,581,23.4,1600.8
4526478943,0,16,1,0,5,7,6,0,0,0,0,16132,6.8,17519,210,50,-155,-51,21.0,1613.2,21,3,1,7,5,11,0,0,0,0,16287,7.0,17570,191,54,155,51,19.1,1628.7
4515299761,0,21,3,1,3,2,4,1,1,0,0,15718,7.0,17991,250,53,1464,925,25.0,1571.8,92,5,0,2,3,4,0,0,0,0,14254,6.6,17066,215,52,-1464,-925,21.5,1425.4
4513041823,0,15,2,1,10,14,7,1,1,0,0,17916,6.8,17579,182,61,-2437,-1355,18.2,1791.6,20,2,0,14,10,16,0,0,0,0,20353,7.4,18934,175,54,2437,1355,17.5,2035.3
4526469771,1,45,4,1,14,5,22,0,0,0,0,19551,7.2,18331,198,43,2896,2001,19.8,1955.1,13,5,0,5,14,6,0,0,0,0,16655,6.6,16330,228,35,-2896,-2001,22.8,1665.5
4516368750,0,18,3,1,9,7,8,0,0,0,0,17944,7.2,18559,255,40,1319,41,25.5,1794.4,17,4,0,7,9,4,1,1,0,0,16625,7.0,18518,234,56,-1319,-41,23.4,1662.5
4521545433,1,14,3,1,2,7,2,0,0,0,0,14645,6.8,16717,224,44,-1518,-2542,22.4,1464.5,58,2,0,7,2,4,0,0,0,0,16163,7.2,19259,207,60,1518,2542,20.7,1616.3
4506841392,0,16,3,0,9,5,14,2,1,1,0,17821,7.2,18702,215,46,1855,1520,21.5,1782.1,16,0,1,5,9,4,0,0,0,0,15966,6.6,17182,233,57,-1855,-1520,23.3,1596.6
4462251940,0,18,4,1,10,6,9,0,0,0,0,18725,7.4,19513,243,59,2376,1325,24.3,1872.5,16,3,0,6,10,5,0,0,0,0,16349,7.2,18188,215,52,-2376,-1325,21.5,1634.9
4515588467,1,17,2,1,2,6,2,0,0,0,0,14767,6.6,16585,230,35,-1233,-1450,23.0,1476.7,38,3,0,6,2,7,1,1,0,0,16000,6.8,18035,193,38,1233,1450,19.3,1600.0
4520552197,0,20,4,1,12,7,11,1,1,0,0,18693,7.4,19277,206,50,1581,1899,20.6,1869.3,15,4,0,7,12,11,0,0,0,0,17112,6.6,17378,207,44,-1581,-1899,20.7,1711.2
4513514281,0,11,2,0,6,9,7,0,0,0,0,16522,6.8,17675,223,44,-1128,-2710,22.3,1652.2,18,2,1,9,6,4,1,1,0,0,17650,7.4,20385,224,72,1128,2710,22.4,1765.0
4521842846,1,12,4,0,3,2,2,1,1,0,0,14502,7.0,17745,217,43,-430,53,21.7,1450.2,32,3,1,2,3,1,0,0,0,0,14932,6.8,17692,223,60,430,-53,22.3,1493.2
4458264663,0,16,2,0,3,9,4,0,0,0,0,14471,7.0,17643,208,40,-3385,-2781,20.8,1447.1,16,7,1,9,3,8,1,1,0,0,17856,7.4,20424,223,44,3385,2781,22.3,1785.6
4486077838,0,16,5,1,4,8,7,0,0,0,0,15557,6.6,17145,212,50,-2101,-2009,21.2,1555.7,18,3,0,8,4,11,2,1,1,0,17658,7.2,19154,249,50,2101,2009,24.9,1765.8
4473648726,1,18,2,0,6,7,7,1,1,0,0,16527,6.6,16322,229,40,94,-487,22.9,1652.7,94,3,1,7,6,11,0,0,0,0,16433,6.8,16809,190,37,-94,487,19.0,1643.3
4487544482,1,16,4,0,6,2,9,0,0,0,0,17549,7.2,19231,243,64,2397,1405,24.3,1754.9,21,3,1,2,6,1,1,0,1,0,15152,6.8,17826,248,44,-2397,-1405,24.8,1515.2
4474736524,0,17,2,0,3,9,2,0,0,0,0,14660,6.6,17265,203,45,-3251,-2143,20.3,1466.0,13,4,1,9,3,5,1,1,0,0,17911,7.2,19408,234,52,3251,2143,23.4,1791.1
4523456850,0,14,2,0,5,11,3,0,0,0,1,15961,6.6,16916,199,36,-2066,3,19.9,1596.1,12,1,1,11,5,14,1,1,0,0,18027,6.8,16913,200,56,2066,-3,20.0,1802.7
4523124807,0,18,2,0,6,7,3,0,0,0,0,15777,6.8,18110,203,58,-1838,-366,20.3,1577.7,90,5,1,7,6,8,1,1,0,0,17615,7.0,18476,214,54,1838,366,21.4,1761.5
4456599389,0,15,2,0,7,4,11,1,1,0,0,16464,6.8,17678,206,40,441,130,20.6,1646.4,14,2,1,4,7,5,0,0,0,0,16023,6.8,17548,229,51,-441,-130,22.9,1602.3
4520610441,0,41,2,1,6,7,8,0,0,0,0,15756,6.6,16210,204,49,-1966,-3189,20.4,1575.6,18,4,0,7,6,6,0,0,0,0,17722,7.4,19399,242,60,1966,3189,24.2,1772.2
4509818939,0,66,4,0,1,7,1,0,0,0,0,14252,6.6,16567,229,47,-4219,-3256,22.9,1425.2,78,2,1,7,1,9,2,1,1,0,18471,7.2,19823,268,59,4219,3256,26.8,1847.1
4513335453,0,17,2,0,3,5,4,0,0,0,0,13794,6.0,14884,183,38,-4000,-2533,18.3,1379.4,14,5,1,5,3,5,0,0,0,1,17794,6.8,17417,245,44,4000,2533,24.5,1779.4
4503460732,1,16,1,1,9,2,9,1,0,1,0,17665,7.4,19246,232,45,3642,2198,23.2,1766.5,81,3,0,2,9,1,1,1,0,0,14023,7.0,17048,199,46,-3642,-2198,19.9,1402.3
4447596592,1,37,1,0,4,7,6,1,1,0,0,15245,6.8,17542,210,46,-2220,-1492,21.0,1524.5,14,2,1,7,4,5,0,0,0,0,17465,7.2,19034,218,60,2220,1492,21.8,1746.5
4524698589,1,80,3,1,7,2,7,1,1,0,0,17324,7.2,19349,216,48,3129,2922,21.6,1732.4,18,0,0,2,7,3,0,0,0,0,14195,6.8,16427,208,47,-3129,-2922,20.8,1419.5
4526408967,0,16,2,0,6,9,7,0,0,0,0,16288,6.8,18071,209,56,-1162,-1007,20.9,1628.8,14,3,1,9,6,7,1,0,1,0,17450,7.0,19078,204,56,1162,1007,20.4,1745.0
4525779442,1,16,3,0,3,6,4,1,1,0,0,15208,6.8,17411,224,47,-1318,406,22.4,1520.8,18,1,1,6,3,12,1,0,1,0,16526,7.0,17005,211,47,1318,-406,21.1,1652.6
4447457186,0,17,1,1,2,4,2,1,1,0,0,15198,6.8,17316,235,47,-13,-1792,23.5,1519.8,16,4,0,4,2,3,1,0,1,0,15211,7.0,19108,207,39,13,1792,20.7,1521.1
4525839513,0,12,4,0,6,4,5,1,0,1,0,16293,7.0,18893,229,40,929,1008,22.9,1629.3,15,2,1,4,6,5,0,0,0,0,15364,7.0,17885,227,54,-929,-1008,22.7,1536.4
4459609583,1,20,2,0,7,3,9,0,0,0,0,17354,7.4,20449,224,63,2301,3412,22.4,1735.4,10,2,1,3,7,4,0,0,0,0,15053,6.6,17037,240,44,-2301,-3412,24.0,1505.3
4513729345,1,16,4,1,2,3,1,0,0,0,0,15572,7.2,19166,242,83,902,860,24.2,1557.2,17,0,0,3,2,4,1,1,0,0,14670,6.8,18306,231,47,-902,-860,23.1,1467.0
4461214115,1,12,1,1,6,8,5,0,0,0,0,16560,7.0,18074,203,65,-407,-1257,20.3,1656.0,47,2,0,8,6,7,1,1,0,0,16967,7.4,19331,223,52,407,1257,22.3,1696.7
4462552916,0,16,2,0,2,3,1,0,0,0,0,13581,7.0,17687,201,46,-1885,-366,20.1,1358.1,25,4,1,3,2,5,1,1,0,0,15466,7.2,18053,246,54,1885,366,24.6,1546.6
4455496628,1,94,3,1,9,7,16,1,1,0,1,19459,7.0,17657,206,61,1896,-423,20.6,1945.9,14,2,0,7,9,6,0,0,0,1,17563,7.0,18080,215,48,-1896,423,21.5,1756.3
4526755326,0,17,1,1,3,8,3,0,0,0,0,14494,6.4,15036,208,44,-4235,-4926,20.8,1449.4,14,4,0,8,3,4,1,1,0,1,18729,7.4,19962,254,74,4235,4926,25.4,1872.9
4477669847,1,19,4,1,3,3,3,0,0,0,0,15562,6.8,17070,224,35,472,-797,22.4,1556.2,39,3,0,3,3,3,0,0,0,0,15090,7.0,17867,222,46,-472,797,22.2,1509.0
4500199178,0,16,2,0,5,8,6,1,0,1,0,15717,6.6,16971,196,60,-646,-960,19.6,1571.7,16,3,1,8,5,8,1,1,0,0,16363,6.8,17931,222,31,646,960,22.2,1636.3
4452529666,1,13,1,0,8,5,15,2,1,1,0,17999,7.2,19381,214,82,2711,2160,21.4,1799.9,15,1,1,5,8,3,0,0,0,0,15288,7.0,17221,213,50,-2711,-2160,21.3,1528.8
4498542919,0,13,2,0,9,7,10,1,0,1,1,19581,6.8,18509,232,44,2883,1059,23.2,1958.1,17,0,1,7,9,8,1,1,0,0,16698,7.2,17450,201,48,-2883,-1059,20.1,1669.8
4505464624,0,22,3,0,4,7,2,1,1,0,0,15125,6.8,17495,200,55,-2302,-702,20.0,1512.5,16,0,1,7,4,9,0,0,0,0,17427,6.8,18197,207,48,2302,702,20.7,1742.7
4513445048,1,15,3,1,8,4,10,1,1,0,0,18341,7.4,19070,217,76,3311,2682,21.7,1834.1,14,0,0,4,8,3,0,0,0,0,15030,6.6,16388,228,44,-3311,-2682,22.8,1503.0
4512044253,1,16,5,1,6,9,4,0,0,0,0,15653,6.6,16241,203,40,-2026,-1235,20.3,1565.3,20,5,0,9,6,14,1,1,0,0,17679,7.0,17476,216,51,2026,1235,21.6,1767.9
4473464467,0,13,1,0,4,11,3,1,1,0,0,15225,6.2,16104,187,45,-5182,-3884,18.7,1522.5,13,1,1,11,4,9,1,0,1,2,20407,7.4,19988,246,53,5182,3884,24.6,2040.7
4520396985,0,24,4,0,4,9,7,0,0,0,0,16165,6.6,17638,220,44,-2163,-739,22.0,1616.5,40,5,1,9,4,18,1,1,0,0,18328,7.0,18377,213,56,2163,739,21.3,1832.8
4502034096,0,18,4,0,8,10,10,1,1,0,0,16943,6.8,17157,208,37,-1074,-1632,20.8,1694.3,141,4,1,10,8,10,1,0,1,0,18017,7.0,18789,229,56,1074,1632,22.9,1801.7
4511838244,0,11,2,0,1,6,2,0,0,0,0,13728,6.8,17193,204,48,-3675,-2454,20.4,1372.8,83,1,1,6,1,5,0,0,0,0,17403,7.2,19647,240,56,3675,2454,24.0,1740.3
4513222024,0,16,3,1,3,2,4,1,1,0,0,15496,6.6,16404,238,42,1559,131,23.8,1549.6,15,1,0,2,3,3,1,0,1,0,13937,6.6,16273,197,54,-1559,-131,19.7,1393.7
4521756971,1,55,5,1,17,6,26,0,0,0,0,20604,6.8,18469,194,51,4565,2632,19.4,2060.4,23,5,0,6,17,6,1,1,0,0,16039,6.4,15837,202,32,-4565,-2632,20.2,1603.9
4444346582,1,15,3,0,7,9,8,0,0,0,0,17115,6.8,17857,203,33,47,-856,20.3,1711.5,13,1,1,9,7,6,0,0,0,0,17068,7.0,18713,219,26,-47,856,21.9,1706.8
4524622729,0,15,4,0,6,8,9,0,0,0,0,16116,6.8,17070,196,64,-77,416,19.6,1611.6,14,5,1,8,6,11,1,1,0,0,16193,6.6,16654,204,43,77,-416,20.4,1619.3
4508978752,1,20,4,0,5,7,7,1,1,0,0,15799,6.8,17838,242,35,-1827,-1102,24.2,1579.9,18,5,1,7,5,10,1,0,1,0,17626,7.0,18940,243,48,1827,1102,24.3,1762.6
4495691730,0,11,0,1,5,9,5,0,0,0,0,15081,6.2,15753,195,41,-1492,-1219,19.5,1508.1,19,2,0,9,5,14,0,0,0,0,16573,6.6,16972,218,22,1492,1219,21.8,1657.3
4474045556,0,24,2,0,7,9,5,0,0,0,0,16652,6.8,18147,212,59,-427,-13,21.2,1665.2,13,3,1,9,7,9,0,0,0,0,17079,7.0,18160,226,32,427,13,22.6,1707.9
4468404862,0,24,3,0,5,7,8,1,1,0,0,15173,6.6,17549,186,60,-2159,-1280,18.6,1517.3,15,1,1,7,5,9,0,0,0,0,17332,7.2,18829,227,47,2159,1280,22.7,1733.2
4515648719,0,46,2,1,11,8,13,0,0,0,0,16886,6.6,16618,172,39,-2107,-1458,17.2,1688.6,14,0,0,8,11,8,1,1,0,0,18993,7.2,18076,189,60,2107,1458,18.9,1899.3
4495070442,1,17,2,1,7,3,8,0,0,0,0,16990,6.8,17608,187,60,2565,1235,18.7,1699.0,14,4,0,3,7,2,0,0,0,0,14425,6.4,16373,212,41,-2565,-1235,21.2,1442.5
4513597747,1,21,1,1,5,2,4,1,0,1,0,15887,6.8,17744,240,42,1323,46,24.0,1588.7,17,2,0,2,5,3,1,1,0,0,14564,7.0,17698,208,61,-1323,-46,20.8,1456.4
4516123814,0,22,0,0,6,10,5,0,0,0,0,16108,6.4,16262,211,42,-1701,-771,21.1,1610.8,16,2,1,10,6,16,0,0,0,0,17809,6.8,17033,190,52,1701,771,19.0,1780.9
4524945992,1,11,2,1,11,10,8,1,1,0,0,18104,6.8,17404,205,40,1117,-637,20.5,1810.4,17,0,0,10,11,6,0,0,0,0,16987,6.8,18041,168,41,-1117,637,16.8,1698.7
4525772082,0,19,6,0,2,8,2,1,0,1,0,14970,6.8,17809,235,59,-2366,-340,23.5,1497.0,21,4,1,8,2,14,0,0,0,0,17336,6.8,18149,226,34,2366,340,22.6,1733.6
4457621044,1,47,3,1,2,1,3,1,1,0,0,15420,7.0,18204,230,65,661,139,23.0,1542.0,14,2,0,1,2,2,0,0,0,0,14759,6.6,18065,245,56,-661,-139,24.5,1475.9
4510687386,0,13,3,0,3,7,2,0,0,0,0,15226,6.8,17102,210,64,-1207,-218,21.0,1522.6,22,1,1,7,3,7,0,0,0,0,16433,6.6,17320,215,44,1207,218,21.5,1643.3
4522235409,1,14,4,1,9,1,9,1,1,0,0,18964,7.2,19620,255,44,5436,3459,25.5,1896.4,26,0,0,1,9,1,0,0,0,0,13528,6.4,16161,183,50,-5436,-3459,18.3,1352.8
4449686178,1,32,7,1,7,6,6,1,1,0,0,16356,7.2,19371,219,47,38,1241,21.9,1635.6,12,1,0,6,7,5,1,0,1,0,16318,7.0,18130,226,40,-38,-1241,22.6,1631.8
4522256108,0,80,2,1,7,11,4,1,0,1,0,15904,6.4,15750,198,36,-1597,-1321,19.8,1590.4,16,3,0,11,7,15,1,1,0,0,17501,6.8,17071,170,63,1597,1321,17.0,1750.1
4521873427,1,14,3,0,8,4,8,0,0,0,0,16733,7.4,19524,193,57,479,929,19.3,1673.3,17,4,1,4,8,3,1,1,0,0,16254,7.0,18595,233,67,-479,-929,23.3,1625.4
4523826301,1,41,4,0,8,9,5,0,0,0,0,16608,7.2,18490,201,40,-114,1359,20.1,1660.8,20,3,1,9,8,10,1,1,0,0,16722,6.8,17131,200,50,114,-1359,20.0,1672.2
4484642493,1,15,2,1,6,3,5,0,0,0,0,16542,7.0,19014,214,63,1428,1200,21.4,1654.2,17,3,0,3,6,4,1,1,0,0,15114,7.0,17814,238,56,-1428,-1200,23.8,1511.4
4526921944,1,16,5,0,7,6,9,1,1,0,0,17108,7.0,18548,230,59,990,1798,23.0,1710.8,51,6,1,6,7,6,0,0,0,0,16118,6.6,16750,218,48,-990,-1798,21.8,1611.8
4522251387,1,12,3,1,9,5,9,0,0,0,0,17309,7.0,18904,221,36,1425,728,22.1,1730.9,14,2,0,5,9,3,2,1,1,0,15884,6.8,18176,208,44,-1425,-728,20.8,1588.4
4527567652,0,18,2,1,7,6,11,1,1,0,0,16135,6.6,17299,216,43,-153,-1105,21.6,1613.5,17,2,0,6,7,7,0,0,0,0,16288,7.0,18404,241,52,153,1105,24.1,1628.8
4521383938,1,36,3,0,4,6,2,1,0,1,0,15862,7.2,19244,229,60,-988,470,22.9,1586.2,17,2,1,6,4,6,1,1,0,0,16850,7.0,18774,232,56,988,-470,23.2,1685.0
4494603900,0,20,5,1,2,7,1,1,0,1,0,14752,6.8,17234,239,48,-2406,-2686,23.9,1475.2,16,2,0,7,2,8,1,1,0,0,17158,7.2,19920,218,72,2406,2686,21.8,1715.8
4527061275,0,14,2,0,5,8,4,0,0,0,0,15921,6.8,17466,203,40,-1110,-721,20.3,1592.1,14,2,1,8,5,6,0,0,0,0,17031,7.2,18187,215,49,1110,721,21.5,1703.1
4514358264,1,15,7,0,4,2,3,1,1,0,0,15444,7.0,17833,236,53,1019,708,23.6,1544.4,17,1,1,2,4,0,0,0,0,0,14425,6.6,17125,229,44,-1019,-708,22.9,1442.5
4524846678,0,15,2,0,7,5,11,0,0,0,0,17450,7.0,18559,236,54,1294,213,23.6,1745.0,14,2,1,5,7,4,0,0,0,0,16156,7.2,18346,213,58,-1294,-213,21.3,1615.6
4507890297,1,17,3,1,6,3,8,1,0,1,0,16481,7.0,18642,229,47,760,45,22.9,1648.1,18,0,0,3,6,3,1,1,0,0,15721,7.0,18597,232,65,-760,-45,23.2,1572.1
4475950279,0,12,1,0,5,13,5,0,0,0,0,15881,6.6,16662,215,52,-3438,-2574,21.5,1588.1,19,3,1,13,5,9,1,1,0,0,19319,7.2,19236,222,52,3438,2574,22.2,1931.9
4518115415,0,40,2,1,4,7,4,0,0,0,0,16262,7.0,18551,224,70,-1293,-625,22.4,1626.2,13,1,0,7,4,5,0,0,0,0,17555,7.2,19176,243,50,1293,625,24.3,1755.5
4484079489,0,16,1,0,6,6,8,0,0,0,0,16421,7.4,18535,222,52,121,-123,22.2,1642.1,15,3,1,6,6,4,1,1,0,0,16300,7.2,18658,240,52,-121,123,24.0,1630.0
4515291762,1,14,3,1,5,2,5,1,1,0,0,15790,7.2,18873,216,56,1074,1004,21.6,1579.0,55,1,0,2,5,1,0,0,0,0,14716,7.0,17869,211,72,-1074,-1004,21.1,1471.6
4517659672,0,15,2,1,4,3,4,1,1,0,0,15010,6.8,16558,211,58,-782,-1431,21.1,1501.0,16,4,0,3,4,3,0,0,0,0,15792,7.0,17989,248,54,782,1431,24.8,1579.2
4508966614,0,20,4,0,7,11,7,1,1,0,0,15890,6.4,16536,201,39,-3280,-2301,20.1,1589.0,20,4,1,11,7,14,1,0,1,0,19170,7.4,18837,223,47,3280,2301,22.3,1917.0
4525911373,1,26,1,1,15,3,24,2,1,1,2,23701,7.8,21188,239,70,8863,5411,23.9,2370.1,12,1,0,3,15,2,0,0,0,0,14838,6.4,15777,197,44,-8863,-5411,19.7,1483.8
4523957266,0,19,2,0,4,7,2,0,0,0,0,15649,7.2,18614,234,66,-1975,-1115,23.4,1564.9,24,4,1,7,4,7,1,1,0,0,17624,7.2,19729,243,55,1975,1115,24.3,1762.4
4525124678,0,34,3,0,6,7,7,0,0,0,0,16728,7.2,18284,221,66,-1071,-1471,22.1,1672.8,14,4,1,7,6,8,1,1,0,0,17799,7.4,19755,248,55,1071,1471,24.8,1779.9
4503018701,0,21,6,1,4,5,5,2,1,1,0,16427,7.0,18982,250,59,-342,-623,25.0,1642.7,19,4,0,5,4,5,0,0,0,0,16769,7.2,19605,247,63,342,623,24.7,1676.9
4502671483,0,13,3,1,5,9,7,2,1,1,0,15090,6.6,15998,176,56,-3684,-3135,17.6,1509.0,15,1,0,9,5,11,0,0,0,0,18774,7.0,19133,246,51,3684,3135,24.6,1877.4
4495636315,1,13,1,1,4,3,5,0,0,0,0,17262,7.0,18608,248,52,1673,1200,24.8,1726.2,12,1,0,3,4,2,2,1,1,0,15589,6.8,17408,197,69,-1673,-1200,19.7,1558.9
4527168732,1,20,2,0,5,7,10,1,0,1,0,15793,6.4,16329,215,64,-1254,-293,21.5,1579.3,16,4,1,7,5,11,0,0,0,0,17047,6.8,16622,188,37,1254,293,18.8,1704.7
4511697354,1,16,3,1,11,6,17,0,0,0,0,17895,6.8,16640,191,38,2088,-118,19.1,1789.5,16,3,0,6,11,5,1,1,0,0,15807,6.6,16758,202,41,-2088,118,20.2,1580.7
4510873008,1,12,1,0,3,8,5,2,1,1,0,14591,6.2,15636,177,55,-2658,-3328,17.7,1459.1,41,2,1,8,3,9,0,0,0,0,17249,7.0,18964,209,52,2658,3328,20.9,1724.9
4505187643,1,66,2,1,10,3,11,1,0,1,0,17992,7.0,18842,212,51,3313,1465,21.2,1799.2,13,0,0,3,10,4,1,1,0,0,14679,6.8,17377,217,52,-3313,-1465,21.7,1467.9
4522319938,1,44,3,0,13,12,17,1,1,0,0,20175,7.4,20673,215,72,1610,2488,21.5,2017.5,14,14,1,12,13,13,0,0,0,0,18565,6.8,18185,212,36,-1610,-2488,21.2,1856.5
4521438360,1,15,2,1,6,3,3,1,1,0,0,17602,7.4,19787,251,73,2849,1925,25.1,1760.2,39,3,0,3,6,3,0,0,0,0,14753,6.8,17862,196,54,-2849,-1925,19.6,1475.3
4516181057,0,12,2,0,3,12,4,0,0,0,0,14015,6.4,15677,178,36,-4929,-3345,17.8,1401.5,15,3,1,12,3,16,1,1,0,0,18944,7.2,19022,228,48,4929,3345,22.8,1894.4
4497614780,1,54,6,0,7,6,5,0,0,0,0,17042,7.6,20182,189,62,1264,2805,18.9,1704.2,17,1,1,6,7,4,2,1,1,0,15778,6.8,17377,225,46,-1264,-2805,22.5,1577.8
4513403175,1,21,2,1,10,1,14,2,1,1,0,19263,7.2,19673,236,59,4739,2119,23.6,1926.3,15,5,0,1,10,0,0,0,0,0,14524,6.8,17554,231,60,-4739,-2119,23.1,1452.4
4487632164,1,17,5,1,11,7,12,0,0,0,0,19308,7.2,18764,243,49,2036,2183,24.3,1930.8,17,2,0,7,11,9,0,0,0,0,17272,6.6,16581,164,44,-2036,-2183,16.4,1727.2
4521510642,1,41,4,1,7,4,7,2,1,1,0,18047,7.2,19362,228,64,3255,2259,22.8,1804.7,18,5,0,4,7,3,0,0,0,0,14792,6.8,17103,197,52,-3255,-2259,19.7,1479.2
4487682437,1,15,2,0,4,8,4,1,0,1,0,15658,6.6,17351,222,42,-1624,-2019,22.2,1565.8,16,1,1,8,4,8,1,1,0,0,17282,7.4,19370,207,61,1624,2019,20.7,1728.2
4475151034,0,15,1,1,2,3,6,0,0,0,0,15007,7.2,17469,232,56,-302,-646,23.2,1500.7,33,1,0,3,2,3,0,0,0,0,15309,6.8,18115,248,56,302,646,24.8,1530.9
4464340157,0,13,0,0,5,12,11,1,1,0,0,14353,6.2,15067,168,48,-4550,-3483,16.8,1435.3,11,1,1,12,5,19,0,0,0,0,18903,7.2,18550,216,39,4550,3483,21.6,1890.3
4496996454,0,12,3,0,3,9,4,0,0,0,0,13842,6.4,15669,181,42,-4256,-3319,18.1,1384.2,17,3,1,9,3,11,1,1,0,0,18098,7.0,18988,240,52,4256,3319,24.0,1809.8
4520785581,0,12,2,0,7,8,7,0,0,0,0,16304,6.8,17825,201,51,-28,-63,20.1,1630.4,14,1,1,8,7,4,0,0,0,0,16332,6.8,17888,209,41,28,63,20.9,1633.2
4499463282,0,17,3,0,5,8,6,2,1,1,0,15494,6.4,16228,187,59,-3528,-2277,18.7,1549.4,16,4,1,8,5,8,0,0,0,0,19022,7.0,18505,260,44,3528,2277,26.0,1902.2
4484067506,0,13,1,0,3,6,4,0,0,0,0,14545,6.6,16581,190,51,-1199,-752,19.0,1454.5,48,1,1,6,3,6,1,1,0,0,15744,6.8,17333,203,50,1199,752,20.3,1574.4
4498547883,1,18,3,0,13,7,11,0,0,0,0,19907,7.6,20865,231,52,3079,2098,23.1,1990.7,17,1,1,7,13,7,1,1,0,0,16828,7.0,18767,186,75,-3079,-2098,18.6,1682.8
4504901140,1,13,5,0,12,8,15,1,1,0,0,19362,7.2,18101,221,36,870,130,22.1,1936.2,38,2,1,8,12,8,1,0,1,1,18492,7.0,17971,216,36,-870,-130,21.6,1849.2
4509008728,0,18,3,1,5,2,4,2,1,1,0,16419,7.0,19317,248,57,1994,2643,24.8,1641.9,16,5,0,2,5,3,0,0,0,0,14425,6.6,16674,238,36,-1994,-2643,23.8,1442.5
4520912575,0,16,2,1,9,9,6,0,0,0,0,17299,7.0,18742,200,43,176,789,20.0,1729.9,15,4,0,9,9,8,0,0,0,0,17123,7.0,17953,221,52,-176,-789,22.1,1712.3
4502093881,1,17,6,1,9,4,8,0,0,0,0,18439,7.0,19278,249,38,3020,2593,24.9,1843.9,12,2,0,4,9,8,0,0,0,0,15419,6.6,16685,211,46,-3020,-2593,21.1,1541.9
4524133023,0,16,2,1,5,11,7,1,1,0,0,14587,6.2,14862,171,42,-3541,-4118,17.1,1458.7,12,1,0,11,5,12,0,0,0,0,18128,7.2,18980,218,40,3541,4118,21.8,1812.8
4524977254,1,50,5,1,12,9,17,1,1,0,0,18857,7.2,18670,195,50,1292,812,19.5,1885.7,38,1,0,9,12,10,0,0,0,0,17565,7.0,17858,207,48,-1292,-812,20.7,1756.5
4525247260,1,18,9,1,9,1,13,1,1,0,0,17461,7.2,18412,235,48,3119,896,23.5,1746.1,44,2,0,1,9,1,1,0,1,0,14342,7.0,17516,228,56,-3119,-896,22.8,1434.2
4523427539,0,13,1,1,2,6,3,1,1,0,0,14377,7.0,17055,210,48,-2511,-2347,21.0,1437.7,33,2,0,6,2,8,0,0,0,0,16888,7.2,19402,249,60,2511,2347,24.9,1688.8
4511226212,1,31,5,1,6,4,6,0,0,0,0,17631,7.0,18398,261,53,2803,2471,26.1,1763.1,18,5,0,4,6,7,1,0,1,0,14828,6.6,15927,188,46,-2803,-2471,18.8,1482.8
4495446798,1,11,4,1,16,5,16,2,1,1,0,20218,7.0,18749,207,58,4266,2910,20.7,2021.8,20,1,0,5,16,6,0,0,0,0,15952,6.4,15839,226,35,-4266,-2910,22.6,1595.2
4527589890,1,40,3,1,2,3,2,2,1,1,0,15723,7.2,19631,246,72,139,260,24.6,1572.3,16,2,0,3,2,2,0,0,0,0,15584,7.4,19371,253,61,-139,-260,25.3,1558.4
4527079464,1,20,2,1,8,7,12,1,1,0,0,17065,7.0,18597,229,48,878,460,22.9,1706.5,12,7,0,7,8,8,0,0,0,0,16187,6.8,18137,204,52,-878,-460,20.4,1618.7
4508732146,1,86,1,1,13,10,15,0,0,0,0,20067,7.0,18286,206,43,2778,-247,20.6,2006.7,17,2,0,10,13,4,1,1,0,0,17289,7.0,18533,184,44,-2778,247,18.4,1728.9
4464866964,1,38,2,0,5,4,4,0,0,0,0,15936,7.0,18595,234,47,254,140,23.4,1593.6,15,2,1,4,5,2,1,1,0,0,15682,7.0,18455,205,63,-254,-140,20.5,1568.2
4387776096,0,16,2,1,7,13,6,0,0,0,0,16039,6.8,16809,179,46,-2168,-2823,17.9,1603.9,14,3,0,13,7,9,1,1,0,0,18207,7.4,19632,185,46,2168,2823,18.5,1820.7
4520878997,1,38,4,0,0,4,0,0,0,0,0,14144,6.6,16975,228,60,-1473,-29,22.8,1414.4,18,3,1,4,0,6,1,1,0,0,15617,6.6,17004,228,49,1473,29,22.8,1561.7
4510100587,0,14,1,0,2,6,3,0,0,0,0,14950,7.0,18134,234,42,-1889,-723,23.4,1495.0,14,1,1,6,2,6,1,1,0,0,16839,7.0,18857,229,49,1889,723,22.9,1683.9
4495207982,1,17,6,1,6,5,3,2,1,1,0,15711,6.8,18516,196,56,458,2243,19.6,1571.1,23,2,0,5,6,4,0,0,0,0,15253,6.6,16273,219,32,-458,-2243,21.9,1525.3
4491707815,1,18,4,0,13,2,18,0,0,0,0,19470,7.4,20453,243,51,6297,5777,24.3,1947.0,16,4,1,2,13,1,1,1,0,0,13173,6.0,14676,189,42,-6297,-5777,18.9,1317.3
4524035367,0,17,4,0,1,1,1,0,0,0,0,14018,7.0,16730,233,51,152,-1124,23.3,1401.8,41,3,1,1,1,1,1,1,0,0,13866,7.2,17854,220,56,-152,1124,22.0,1386.6
4515648647,0,16,3,1,6,6,5,1,0,1,0,17360,7.4,19151,250,48,1259,1281,25.0,1736.0,19,2,0,6,6,8,1,1,0,0,16101,7.0,17870,201,60,-1259,-1281,20.1,1610.1
4516036728,1,14,4,1,7,6,7,2,1,1,0,17588,7.0,18328,233,63,1219,292,23.3,1758.8,15,2,0,6,7,10,0,0,0,0,16369,6.8,18036,216,45,-1219,-292,21.6,1636.9
4526573339,0,55,2,1,8,6,7,1,1,0,0,17403,7.4,19112,215,47,1518,1874,21.5,1740.3,17,1,0,6,8,9,0,0,0,0,15885,6.6,17238,192,40,-1518,-1874,19.2,1588.5
4483893838,1,16,1,1,8,9,14,2,1,1,0,18532,7.2,18460,240,55,1428,295,24.0,1853.2,17,1,0,9,8,9,0,0,0,0,17104,7.0,18165,201,48,-1428,-295,20.1,1710.4
4489090931,0,15,3,1,5,6,7,0,0,0,0,15684,6.8,17384,170,56,-1434,-1409,17.0,1568.4,17,4,0,6,5,3,1,0,1,0,17118,7.2,18793,223,52,1434,1409,22.3,1711.8
4519385513,0,12,1,0,2,4,2,0,0,0,0,14319,6.6,16364,219,51,-1272,-2335,21.9,1431.9,12,1,1,4,2,1,0,0,0,0,15591,7.2,18699,236,48,1272,2335,23.6,1559.1
4518274507,0,15,5,0,6,8,8,1,1,0,0,15977,6.8,16880,206,47,-588,-1142,20.6,1597.7,55,2,1,8,6,10,0,0,0,0,16565,7.0,18022,220,44,588,1142,22.0,1656.5
4513396657,0,14,1,1,5,7,6,1,1,0,0,15776,6.8,16824,199,36,-400,-1311,19.9,1577.6,17,1,0,7,5,6,0,0,0,0,16176,6.8,18135,217,43,400,1311,21.7,1617.6
4490390200,1,13,3,0,7,5,2,1,1,0,0,17247,7.2,19189,249,63,2152,2575,24.9,1724.7,17,2,1,5,7,7,0,0,0,0,15095,6.8,16614,178,40,-2152,-2575,17.8,1509.5
4478470273,0,20,4,1,5,10,8,2,1,1,0,15156,6.4,16017,156,53,-2997,-3052,15.6,1515.6,29,7,0,10,5,5,0,0,0,0,18153,7.0,19069,222,49,2997,3052,22.2,1815.3
4516990759,1,57,5,1,6,4,3,0,0,0,0,16601,7.0,18618,242,52,1235,1010,24.2,1660.1,15,3,0,4,6,5,0,0,0,0,15366,6.8,17608,201,44,-1235,-1010,20.1,1536.6
4522564019,0,20,3,1,9,6,12,0,0,0,0,17898,6.8,18357,215,58,1388,441,21.5,1789.8,41,4,0,6,9,10,1,1,0,0,16510,7.0,17916,212,48,-1388,-441,21.2,1651.0
4480275637,1,17,4,1,4,4,4,0,0,0,0,15967,7.0,17892,225,62,-553,284,22.5,1596.7,18,1,0,4,4,4,2,1,1,1,16520,6.8,17608,217,44,553,-284,21.7,1652.0
4495292630,1,13,4,1,3,7,4,1,0,1,0,15088,6.6,16413,209,44,-1685,-2902,20.9,1508.8,19,4,0,7,3,6,0,0,0,0,16773,7.4,19315,235,55,1685,2902,23.5,1677.3
4521257483,1,10,2,1,7,8,9,0,0,0,0,17371,7.0,18243,227,41,-50,563,22.7,1737.1,19,2,0,8,7,9,1,1,0,0,17421,6.8,17680,222,56,50,-563,22.2,1742.1
4511423675,1,18,3,0,12,5,10,0,0,0,0,17827,6.8,18481,208,35,1756,1128,20.8,1782.7,33,1,1,5,12,6,1,1,0,0,16071,6.8,17353,188,61,-1756,-1128,18.8,1607.1
4525555487,0,14,0,1,4,11,3,0,0,0,0,15294,6.4,16497,202,63,-3442,-2915,20.2,1529.4,13,0,0,11,4,16,0,0,0,0,18736,7.2,19412,221,56,3442,2915,22.1,1873.6
4517721011,1,15,4,0,8,9,4,0,0,0,0,16566,7.2,18723,214,48,-1838,-1127,21.4,1656.6,16,1,1,9,8,7,2,1,1,0,18404,7.2,19850,238,60,1838,1127,23.8,1840.4
4519379201,1,53,2,0,7,17,5,0,0,0,0,15664,6.6,16740,174,48,-4732,-1805,17.4,1566.4,16,4,1,17,7,20,1,1,0,0,20396,7.0,18545,228,38,4732,1805,22.8,2039.6
4526467348,0,12,2,0,8,12,5,1,1,0,0,16964,6.8,18163,214,48,-2935,-1462,21.4,1696.4,15,2,1,12,8,15,0,0,0,0,19899,7.4,19625,235,59,2935,1462,23.5,1989.9
4489343082,1,17,2,1,9,2,12,1,1,0,0,18581,6.8,17855,229,55,4279,1907,22.9,1858.1,13,2,0,2,9,3,0,0,0,0,14302,6.4,15948,239,44,-4279,-1907,23.9,1430.2
4470222425,1,17,3,1,4,5,6,1,1,0,0,16003,6.8,17885,238,44,-1084,-1632,23.8,1600.3,14,1,0,5,4,8,0,0,0,0,17087,7.2,19517,244,66,1084,1632,24.4,1708.7
4410192659,0,13,1,0,6,8,6,0,0,0,0,15883,6.8,16480,228,28,-791,-2157,22.8,1588.3,17,0,1,8,6,7,0,0,0,0,16674,6.8,18637,213,48,791,2157,21.3,1667.4
4467843663,1,13,0,1,7,4,10,0,0,0,0,16597,6.8,17747,232,36,2296,773,23.2,1659.7,13,0,0,4,7,4,0,0,0,0,14301,6.8,16974,153,55,-2296,-773,15.3,1430.1
4522608036,0,22,4,0,7,2,5,0,0,0,0,16696,7.2,18900,225,68,1945,2614,22.5,1669.6,17,4,1,2,7,3,0,0,0,0,14751,6.4,16286,196,52,-1945,-2614,19.6,1475.1
4478004780,0,33,5,1,4,4,5,1,1,0,0,15716,6.8,17691,235,53,-1555,-1025,23.5,1571.6,18,2,0,4,4,4,1,0,1,1,17271,7.0,18716,237,54,1555,1025,23.7,1727.1
4520639999,1,40,1,0,5,3,5,0,0,0,0,16418,7.2,19182,242,60,1234,962,24.2,1641.8,18,14,1,3,5,3,2,1,1,0,15184,6.8,18220,215,56,-1234,-962,21.5,1518.4
4524480759,0,19,1,0,1,9,2,0,0,0,0,13119,6.2,15498,199,36,-6878,-4956,19.9,1311.9,19,7,1,9,1,9,2,1,1,1,19997,7.4,20454,275,56,6878,4956,27.5,1999.7
4504703082,0,11,4,1,6,10,6,0,0,0,0,15161,6.6,16711,187,36,-3312,-3119,18.7,1516.1,13,1,0,10,6,11,1,0,1,0,18473,7.4,19830,223,48,3312,3119,22.3,1847.3
4473903480,0,14,4,0,6,7,3,0,0,0,0,15827,6.6,17709,218,47,-1694,-603,21.8,1582.7,13,2,1,7,6,6,1,0,1,0,17521,7.0,18312,239,50,1694,603,23.9,1752.1
4521458621,0,105,2,0,3,8,2,0,0,0,0,14533,6.8,17818,198,56,-4033,-1850,19.8,1453.3,14,2,1,8,3,9,1,1,0,0,18566,7.2,19668,220,64,4033,1850,22.0,1856.6
4521875899,1,15,4,1,11,5,12,2,1,1,0,19787,7.2,19493,242,51,4284,2585,24.2,1978.7,17,3,0,5,11,6,0,0,0,0,15503,6.8,16908,205,52,-4284,-2585,20.5,1550.3
4500754839,1,14,4,0,4,10,4,1,1,0,0,15082,6.8,17691,211,49,-2924,-1587,21.1,1508.2,14,0,1,10,4,6,0,0,0,0,18006,7.4,19278,216,62,2924,1587,21.6,1800.6
4511051805,1,15,2,0,5,8,4,0,0,0,0,16697,7.0,18216,214,62,-63,-779,21.4,1669.7,37,3,1,8,5,4,1,1,0,0,16760,7.2,18995,219,58,63,779,21.9,1676.0
4475134384,1,31,1,1,2,3,2,0,0,0,0,15705,6.6,17630,230,57,856,-268,23.0,1570.5,134,2,0,3,2,6,1,1,0,0,14849,7.0,17898,219,56,-856,268,21.9,1484.9
4490315006,1,21,3,0,9,4,7,1,1,0,0,17951,6.8,18031,234,44,3432,2317,23.4,1795.1,16,1,1,4,9,9,0,0,0,0,14519,6.4,15714,183,45,-3432,-2317,18.3,1451.9
4479819493,0,19,2,0,2,8,3,0,0,0,0,13925,6.6,16354,198,43,-4527,-3126,19.8,1392.5,17,4,1,8,2,8,1,1,0,0,18452,7.2,19480,229,55,4527,3126,22.9,1845.2
4519032722,0,16,3,0,3,3,1,1,1,0,0,15127,7.0,17750,238,52,-5,-269,23.8,1512.7,37,2,1,3,3,3,0,0,0,0,15132,7.0,18019,203,60,5,269,20.3,1513.2
4494877366,1,90,1,0,6,7,6,1,1,0,0,17242,7.0,18478,230,75,1291,2116,23.0,1724.2,18,3,1,7,6,8,0,0,0,0,15951,6.6,16362,171,27,-1291,-2116,17.1,1595.1
4518121275,1,20,1,1,7,6,8,1,1,0,0,16417,6.8,17202,205,56,161,130,20.5,1641.7,11,2,0,6,7,11,0,0,0,0,16256,6.8,17072,209,60,-161,-130,20.9,1625.6
4525542584,0,14,1,1,5,3,2,1,0,1,0,15358,6.6,17220,223,40,543,-624,22.3,1535.8,11,2,0,3,5,3,1,1,0,0,14815,7.0,17844,199,67,-543,624,19.9,1481.5
4479540109,0,14,3,0,2,7,1,0,0,0,0,15373,7.2,18734,252,68,-1942,140,25.2,1537.3,81,1,1,7,2,10,2,1,1,0,17315,7.2,18594,226,52,1942,-140,22.6,1731.5
4518125145,0,17,2,1,8,8,13,0,0,0,0,16934,6.4,16045,193,44,247,-775,19.3,1693.4,15,1,0,8,8,6,1,1,0,0,16687,6.6,16820,191,56,-247,775,19.1,1668.7
4503626292,1,15,1,1,14,4,14,0,0,0,0,19600,7.4,20132,218,56,5344,3506,21.8,1960.0,12,1,0,4,14,1,0,0,0,0,14256,6.8,16626,194,47,-5344,-3506,19.4,1425.6
4498101728,0,13,1,0,5,12,5,1,1,0,0,15224,6.6,16423,203,45,-4927,-5216,20.3,1522.4,40,2,1,12,5,11,0,0,0,0,20151,7.8,21639,231,63,4927,5216,23.1,2015.1
4520727440,0,14,2,0,2,9,2,0,0,0,0,14646,6.6,16931,219,48,-5036,-2248,21.9,1464.6,16,3,1,9,2,12,2,1,1,1,19682,7.4,19179,262,68,5036,2248,26.2,1968.2
4479492497,1,12,2,1,14,6,10,1,0,1,1,20225,6.6,17976,194,50,4453,2458,19.4,2022.5,17,2,0,6,14,6,1,1,0,0,15772,6.6,15518,189,40,-4453,-2458,18.9,1577.2
4524924160,1,17,2,1,5,4,3,1,1,0,0,16315,7.0,18479,256,44,763,1243,25.6,1631.5,14,3,0,4,5,3,0,0,0,0,15552,6.8,17236,218,52,-763,-1243,21.8,1555.2
4464951728,1,17,3,1,1,2,2,1,1,0,0,14116,6.8,16837,217,51,-2421,-1685,21.7,1411.6,18,5,0,2,1,2,1,0,1,1,16537,6.8,18522,264,47,2421,1685,26.4,1653.7
4513442931,0,40,4,1,7,5,9,0,0,0,0,17003,6.6,18007,214,40,1331,1287,21.4,1700.3,16,1,0,5,7,8,0,0,0,0,15672,6.8,16720,190,52,-1331,-1287,19.0,1567.2
4487211504,1,22,1,0,3,5,2,0,0,0,0,14027,6.6,16596,219,32,-2105,-1815,21.9,1402.7,19,4,1,5,3,4,0,0,0,0,16132,7.0,18411,261,44,2105,1815,26.1,1613.2
4526119590,0,17,3,1,11,8,10,0,0,0,0,18459,7.0,17481,224,39,1536,624,22.4,1845.9,15,1,0,8,11,12,1,1,0,0,16923,6.6,16857,197,55,-1536,-624,19.7,1692.3
4468676047,0,13,2,1,6,9,7,2,1,1,0,15928,6.4,16033,173,67,-1885,-1025,17.3,1592.8,12,0,0,9,6,10,0,0,0,0,17813,6.8,17058,233,17,1885,1025,23.3,1781.3
4500882500,1,15,3,0,9,9,10,0,0,0,0,17312,6.6,17334,231,35,-674,530,23.1,1731.2,14,0,1,9,9,13,0,0,0,0,17986,6.8,16804,200,52,674,-530,20.0,1798.6
4521281079,0,15,2,0,3,9,4,1,0,1,0,14812,6.8,16674,199,64,-3244,-1208,19.9,1481.2,13,4,1,9,3,12,1,1,0,0,18056,6.8,17882,205,52,3244,1208,20.5,1805.6
4524693952,0,53,2,0,6,8,8,1,1,0,0,15128,6.2,15881,172,37,-1187,-1137,17.2,1512.8,20,2,1,8,6,9,0,0,0,0,16315,6.8,17018,179,40,1187,1137,17.9,1631.5
4450343886,0,16,1,1,8,7,9,0,0,0,0,17169,7.0,17752,210,51,734,-965,21.0,1716.9,61,2,0,7,8,5,0,0,0,0,16435,7.0,18717,207,58,-734,965,20.7,1643.5
4516090718,0,21,1,0,3,7,2,0,0,0,0,14552,6.6,16760,222,49,-3408,-1490,22.2,1455.2,17,4,1,7,3,5,2,1,1,1,17960,7.0,18250,228,44,3408,1490,22.8,1796.0
4503433498,0,12,15,1,4,4,2,1,0,1,0,15661,7.2,18861,232,51,62,1154,23.2,1566.1,40,1,0,4,4,5,1,1,0,0,15599,6.8,17707,202,66,-62,-1154,20.2,1559.9
4523728441,1,7,0,1,9,11,10,1,1,0,0,18601,7.0,18627,220,63,1939,166,22.0,1860.1,13,1,0,11,9,7,0,0,0,0,16662,7.0,18461,174,44,-1939,-166,17.4,1666.2
4515801443,0,13,1,1,4,1,5,2,1,1,0,15869,7.2,18711,249,64,453,76,24.9,1586.9,20,4,0,1,4,1,0,0,0,0,15416,7.0,18635,265,68,-453,-76,26.5,1541.6
4469812384,1,16,7,1,4,5,5,0,0,0,0,14707,6.6,16234,213,36,-2268,-2502,21.3,1470.7,22,4,0,5,4,5,1,1,0,0,16975,7.2,18736,254,62,2268,2502,25.4,1697.5
4516861860,1,16,5,1,4,3,4,0,0,0,0,16313,6.8,17824,240,47,1128,498,24.0,1631.3,28,3,0,3,4,5,0,0,0,0,15185,6.8,17326,220,41,-1128,-498,22.0,1518.5
4505369566,1,13,6,1,13,3,19,1,1,0,2,21872,7.2,19671,225,36,7404,5156,22.5,2187.2,14,0,0,3,13,3,0,0,0,0,14468,6.2,14515,169,50,-7404,-5156,16.9,1446.8
4524183803,1,15,1,0,9,8,9,0,0,0,0,16872,7.0,17906,199,36,-1232,-272,19.9,1687.2,17,1,1,8,9,6,1,1,0,0,18104,7.0,18178,225,48,1232,272,22.5,1810.4
4472854192,1,18,4,1,7,4,7,1,1,0,0,17221,7.4,18574,199,68,1823,1574,19.9,1722.1,16,2,0,4,7,3,0,0,0,0,15398,6.6,17000,208,60,-1823,-1574,20.8,1539.8
4493982450,0,81,2,0,3,7,3,1,1,0,0,15058,6.8,17113,223,55,-2588,-497,22.3,1505.8,14,0,1,7,3,3,0,0,0,1,17646,6.8,17610,223,44,2588,497,22.3,1764.6
4513437508,1,14,3,1,7,1,5,0,0,0,0,16961,7.2,19188,245,43,4060,3257,24.5,1696.1,16,0,0,1,7,1,0,0,0,0,12901,6.4,15931,176,45,-4060,-3257,17.6,1290.1
4523048704,1,19,4,1,10,6,10,1,1,0,0,18013,7.2,18223,228,51,1446,-143,22.8,1801.3,18,5,0,6,10,5,0,0,0,0,16567,7.0,18366,216,63,-1446,143,21.6,1656.7
4492216281,0,20,0,0,6,10,4,0,0,0,0,14626,6.4,16067,154,43,-4726,-2067,15.4,1462.6,11,3,1,10,6,11,1,1,0,1,19352,7.0,18134,224,52,4726,2067,22.4,1935.2
4478403685,0,18,2,1,10,8,12,0,0,0,0,17883,6.8,17407,198,40,1485,-264,19.8,1788.3,16,3,0,8,10,10,1,1,0,0,16398,6.8,17671,194,52,-1485,264,19.4,1639.8
4501370502,0,15,1,1,5,5,2,1,1,0,0,16299,7.2,18568,225,62,1063,-125,22.5,1629.9,14,0,0,5,5,3,0,0,0,0,15236,7.0,18693,202,57,-1063,125,20.2,1523.6
4527587697,0,18,3,1,10,6,7,1,1,0,0,18302,7.2,18149,215,40,2617,1172,21.5,1830.2,15,4,0,6,10,4,1,0,1,0,15685,6.8,16977,178,63,-2617,-1172,17.8,1568.5
4519405060,1,46,0,1,8,3,14,1,1,0,0,17520,7.0,18610,211,55,1892,890,21.1,1752.0,11,2,0,3,8,4,0,0,0,0,15628,6.8,17720,250,52,-1892,-890,25.0,1562.8
4475829266,0,18,4,1,8,6,9,2,1,1,0,18010,7.2,20078,224,66,2120,2095,22.4,1801.0,17,3,0,6,8,5,0,0,0,0,15890,7.0,17983,229,36,-2120,-2095,22.9,1589.0
4445985804,1,19,4,1,7,2,8,1,1,0,0,17459,7.2,19021,231,64,2929,1296,23.1,1745.9,15,1,0,2,7,2,0,0,0,0,14530,7.0,17725,191,64,-2929,-1296,19.1,1453.0
4527162732,0,89,5,0,7,4,9,0,0,0,0,16860,7.0,17641,218,48,1293,-262,21.8,1686.0,14,1,1,4,7,2,0,0,0,0,15567,6.8,17903,219,55,-1293,262,21.9,1556.7
4489000836,1,11,4,0,9,8,13,0,0,0,0,17190,6.8,16876,204,36,329,-298,20.4,1719.0,16,2,1,8,9,10,1,1,0,0,16861,7.0,17174,206,44,-329,298,20.6,1686.1
4521806282,1,16,0,1,8,6,4,0,0,0,0,16818,7.0,18842,213,52,588,1104,21.3,1681.8,12,0,0,6,8,7,1,1,0,0,16230,7.0,17738,232,45,-588,-1104,23.2,1623.0
4521908299,1,15,1,1,11,1,8,2,1,1,0,18635,7.2,19958,230,64,4368,3523,23.0,1863.5,14,2,0,1,11,0,0,0,0,0,14267,6.6,16435,208,64,-4368,-3523,20.8,1426.7
4495141032,0,38,3,1,7,2,11,0,0,0,0,17371,6.6,17488,209,47,3058,1096,20.9,1737.1,15,4,0,2,7,2,0,0,0,0,14313,6.6,16392,230,35,-3058,-1096,23.0,1431.3
4519775605,0,25,3,1,9,5,6,1,0,1,0,16782,7.0,18450,218,44,-34,-122,21.8,1678.2,18,5,0,5,9,3,1,1,0,0,16816,7.0,18572,234,56,34,122,23.4,1681.6
4520307330,0,13,1,0,10,6,10,0,0,0,0,16744,7.0,19007,183,42,-645,426,18.3,1674.4,13,1,1,6,10,3,0,0,0,0,17389,7.0,18581,224,52,645,-426,22.4,1738.9
4510083368,0,15,1,0,6,13,5,0,0,0,0,16345,6.8,17662,209,42,-2154,-2348,20.9,1634.5,15,1,1,13,6,13,0,0,0,0,18499,7.4,20010,225,36,2154,2348,22.5,1849.9
4468173353,0,12,2,0,6,12,6,0,0,0,0,15595,6.4,15756,159,48,-3682,-4566,15.9,1559.5,17,1,1,12,6,13,0,0,0,0,19277,7.6,20322,240,54,3682,4566,24.0,1927.7
4475799088,0,20,0,0,8,12,9,0,0,0,0,16830,7.0,17100,206,59,-1619,265,20.6,1683.0,21,4,1,12,8,19,1,0,1,0,18449,7.0,16835,158,45,1619,-265,15.8,1844.9
4497712537,1,17,4,1,6,6,11,1,1,0,0,17731,7.2,18498,257,59,1870,1167,25.7,1773.1,20,1,0,6,6,6,1,0,1,0,15861,6.8,17331,216,42,-1870,-1167,21.6,1586.1
4514036288,1,15,4,1,4,9,2,0,0,0,0,14887,6.4,15841,209,38,-3088,-2028,20.9,1488.7,17,2,0,9,4,12,0,0,0,0,17975,6.8,17869,203,39,3088,2028,20.3,1797.5
4465066223,1,13,1,0,6,9,2,1,1,0,0,16250,7.0,17537,228,55,-556,-235,22.8,1625.0,17,1,1,9,6,13,0,0,0,0,16806,6.8,17772,143,60,556,235,14.3,1680.6
4477354923,1,17,1,1,9,9,12,1,1,0,0,17101,6.8,16986,194,47,359,-1714,19.4,1710.1,39,2,0,9,9,7,0,0,0,0,16742,7.0,18700,197,56,-359,1714,19.7,1674.2
4471698975,1,24,2,0,6,5,9,1,1,0,0,15112,6.6,16369,184,43,-973,-674,18.4,1511.2,17,1,1,5,6,4,0,0,0,0,16085,6.8,17043,231,50,973,674,23.1,1608.5
4454235667,1,19,3,0,9,5,9,1,1,0,0,18449,7.2,19139,257,45,2334,1246,25.7,1844.9,62,3,1,5,9,6,0,0,0,0,16115,6.8,17893,231,48,-2334,-1246,23.1,1611.5
4384417283,1,19,2,0,10,3,13,1,1,0,0,17951,7.2,18502,226,44,3022,2631,22.6,1795.1,13,4,1,3,10,5,0,0,0,0,14929,6.6,15871,209,44,-3022,-2631,20.9,1492.9
4506399392,1,18,4,1,6,5,9,0,0,0,0,16693,7.0,18761,227,57,897,1090,22.7,1669.3,16,4,0,5,6,7,0,0,0,0,15796,7.0,17671,237,36,-897,-1090,23.7,1579.6
4498448542,0,21,2,0,3,3,3,2,1,1,0,15956,6.8,18145,215,73,656,526,21.5,1595.6,15,5,1,3,3,5,0,0,0,0,15300,6.8,17619,212,50,-656,-526,21.2,1530.0
4525141412,0,13,1,0,9,7,10,0,0,0,0,16017,6.8,17022,182,34,-58,13,18.2,1601.7,14,2,1,7,9,3,1,1,0,0,16075,6.8,17009,228,37,58,-13,22.8,1607.5
4469763796,1,14,1,1,11,3,14,1,1,0,1,19278,7.4,19529,226,42,4230,3209,22.6,1927.8,14,2,0,3,11,3,0,0,0,0,15048,6.4,16320,186,66,-4230,-3209,18.6,1504.8
4506933329,1,15,1,0,4,6,2,1,1,0,0,15340,7.2,18245,228,44,-1031,122,22.8,1534.0,13,4,1,6,4,7,0,0,0,0,16371,7.0,18123,228,51,1031,-122,22.8,1637.1
4523830454,0,14,1,1,5,5,8,0,0,0,0,15656,6.6,16766,230,40,-384,-2030,23.0,1565.6,13,1,0,5,5,2,1,1,0,0,16040,7.0,18796,233,56,384,2030,23.3,1604.0
4522076814,1,16,5,1,8,6,7,1,1,0,0,17751,7.2,19165,238,60,1570,643,23.8,1775.1,38,3,0,6,8,1,0,0,0,0,16181,7.0,18522,226,52,-1570,-643,22.6,1618.1
4525197768,1,13,2,0,5,1,5,0,0,0,0,15885,7.0,17852,250,45,2107,464,25.0,1588.5,14,1,1,1,5,1,1,1,0,0,13778,6.6,17388,231,38,-2107,-464,23.1,1377.8
4491027419,0,21,5,0,3,4,2,1,0,1,0,15759,7.0,17815,245,53,-183,-779,24.5,1575.9,114,6,1,4,3,3,1,1,0,0,15942,7.4,18594,230,64,183,779,23.0,1594.2
4438353686,0,17,5,0,5,11,5,0,0,0,0,16228,6.6,17098,232,40,-1957,-963,23.2,1622.8,20,3,1,11,5,14,2,1,1,0,18185,7.0,18061,188,52,1957,963,18.8,1818.5
4521949489,1,15,1,0,4,4,4,2,1,1,0,16337,7.0,18992,251,67,1260,1487,25.1,1633.7,35,1,1,4,4,2,0,0,0,0,15077,6.8,17505,204,48,-1260,-1487,20.4,1507.7
4495531076,0,12,4,1,7,11,10,0,0,0,0,16575,6.8,17151,194,46,-1655,-1744,19.4,1657.5,16,1,0,11,7,7,1,1,0,0,18230,7.2,18895,208,52,1655,1744,20.8,1823.0
4508634893,0,12,2,0,2,6,1,0,0,0,0,14095,6.8,17286,196,60,-3628,-2009,19.6,1409.5,14,2,1,6,2,4,1,1,0,0,17723,7.0,19295,266,60,3628,2009,26.6,1772.3
4479045303,1,14,3,0,4,7,7,1,1,0,0,15261,6.8,15935,227,40,-1107,-2894,22.7,1526.1,16,1,1,7,4,4,0,0,0,0,16368,7.2,18829,224,68,1107,2894,22.4,1636.8
4466017126,0,16,1,0,9,10,9,0,0,0,0,16731,7.0,17994,191,52,-1625,-442,19.1,1673.1,13,5,1,10,9,12,0,0,0,0,18356,7.0,18436,229,34,1625,442,22.9,1835.6
4527394584,1,16,1,0,7,7,5,0,0,0,0,16354,6.8,18198,213,41,-1256,-559,21.3,1635.4,17,2,1,7,7,5,2,1,1,0,17610,7.0,18757,226,62,1256,559,22.6,1761.0
4526116329,1,15,1,1,8,6,5,0,0,0,0,17693,7.0,18557,251,40,2501,2231,25.1,1769.3,15,1,0,6,8,7,0,0,0,0,15192,6.4,16326,176,52,-2501,-2231,17.6,1519.2
4527552331,1,36,4,0,11,13,11,0,0,0,0,17166,6.8,17136,165,36,-1030,-319,16.5,1716.6,16,5,1,13,11,8,1,0,1,0,18196,6.6,17455,203,44,1030,319,20.3,1819.6
4519998641,0,41,3,0,8,9,7,0,0,0,0,16272,6.6,16687,179,41,-1117,-1207,17.9,1627.2,16,4,1,9,8,7,1,1,0,0,17389,6.8,17894,223,52,1117,1207,22.3,1738.9
4464132605,1,15,2,0,4,3,2,2,1,1,0,15517,6.8,17441,215,52,697,951,21.5,1551.7,12,3,1,3,4,3,0,0,0,0,14820,6.8,16490,211,48,-697,-951,21.1,1482.0
4493157099,1,14,0,1,8,8,8,2,1,1,0,18068,6.8,18462,204,76,719,387,20.4,1806.8,11,2,0,8,8,8,0,0,0,0,17349,6.8,18075,203,51,-719,-387,20.3,1734.9
4525536243,0,15,3,0,3,7,3,0,0,0,0,14056,6.6,16342,193,50,-2129,-1542,19.3,1405.6,18,2,1,7,3,12,1,1,0,0,16185,7.0,17884,217,34,2129,1542,21.7,1618.5
4475861894,0,18,10,1,2,5,3,1,1,0,0,15158,6.8,17387,250,43,-627,183,25.0,1515.8,45,8,0,5,2,9,0,0,0,0,15785,6.8,17204,243,24,627,-183,24.3,1578.5
4459022414,1,14,1,0,11,11,12,0,0,0,0,18409,7.0,17925,219,36,-206,290,21.9,1840.9,17,1,1,11,11,12,0,0,0,0,18615,7.0,17635,174,55,206,-290,17.4,1861.5
4476065129,0,17,7,0,6,6,9,0,0,0,0,16812,7.2,18466,269,40,-66,-1073,26.9,1681.2,19,5,1,6,6,3,1,1,0,0,16878,7.0,19539,245,56,66,1073,24.5,1687.8
4524830174,1,15,2,1,10,2,18,1,1,0,0,17559,7.0,17788,217,24,3158,1518,21.7,1755.9,13,1,0,2,10,3,0,0,0,0,14401,6.4,16270,184,47,-3158,-1518,18.4,1440.1
4482355547,0,23,1,1,8,10,8,1,1,0,0,17321,7.0,18683,205,59,-78,-155,20.5,1732.1,13,2,0,10,8,7,1,0,1,0,17399,7.4,18838,207,40,78,155,20.7,1739.9
4470558521,1,37,4,1,4,6,3,0,0,0,0,14659,6.6,16241,192,48,-1962,-2464,19.2,1465.9,16,2,0,6,4,6,0,0,0,0,16621,7.0,18705,244,39,1962,2464,24.4,1662.1
4519025105,0,14,4,0,9,8,11,1,0,1,0,17472,7.2,17708,180,50,-423,-1210,18.0,1747.2,15,4,1,8,9,11,1,1,0,0,17895,7.2,18918,221,54,423,1210,22.1,1789.5
4518241123,0,14,0,0,4,11,4,0,0,0,0,12178,4.6,10098,120,20,-6754,-5726,12.0,1217.8,15,2,1,11,4,14,0,0,0,1,18932,6.4,15824,203,36,6754,5726,20.3,1893.2
4518145521,1,25,2,0,11,5,10,1,0,1,1,18888,7.0,18915,204,44,2840,1792,20.4,1888.8,17,1,1,5,11,8,1,1,0,0,16048,6.8,17123,205,52,-2840,-1792,20.5,1604.8
4516786355,1,16,3,1,5,6,8,1,0,1,0,15927,6.6,17498,220,58,-412,-609,22.0,1592.7,16,3,0,6,5,8,1,1,0,0,16339,6.6,18107,234,37,412,609,23.4,1633.9
4491653265,0,33,3,0,9,12,10,0,0,0,0,18082,7.2,18637,209,54,24,235,20.9,1808.2,52,4,1,12,9,11,2,1,1,0,18058,7.0,18402,200,44,-24,-235,20.0,1805.8
4505405974,0,18,4,0,3,4,3,0,0,0,0,14511,6.6,16462,212,42,-342,-2245,21.2,1451.1,18,2,1,4,3,1,1,1,0,0,14853,7.4,18707,212,43,342,2245,21.2,1485.3
4521659923,1,13,1,1,8,3,8,1,1,0,0,18404,7.4,19768,245,60,3993,2165,24.5,1840.4,62,2,0,3,8,6,0,0,0,0,14411,7.2,17603,188,44,-3993,-2165,18.8,1441.1
4509514810,1,18,3,0,8,8,8,1,1,0,0,18253,6.8,17351,240,50,1683,-172,24.0,1825.3,18,4,1,8,8,6,0,0,0,0,16570,6.8,17523,203,41,-1683,172,20.3,1657.0
4527368569,1,16,3,1,7,5,11,0,0,0,0,17940,7.4,19767,242,55,1938,738,24.2,1794.0,13,3,0,5,7,3,1,1,0,0,16002,7.2,19029,221,75,-1938,-738,22.1,1600.2
4515587675,1,17,3,1,13,9,22,0,0,0,0,19542,7.0,17935,207,31,2081,466,20.7,1954.2,17,4,0,9,13,11,0,0,0,0,17461,7.0,17469,200,44,-2081,-466,20.0,1746.1
4475833403,0,14,3,1,8,5,11,0,0,0,0,18074,7.4,19746,235,54,1887,1295,23.5,1807.4,15,2,0,5,8,4,0,0,0,0,16187,7.0,18451,220,64,-1887,-1295,22.0,1618.7
4512153524,0,16,4,1,3,7,4,0,0,0,0,15033,6.6,16265,226,47,-1520,-613,22.6,1503.3,24,2,0,7,3,14,0,0,0,0,16553,6.6,16878,201,53,1520,613,20.1,1655.3
4526919278,0,18,4,1,4,3,5,1,1,0,0,16122,6.8,17673,223,44,385,-1446,22.3,1612.2,16,5,0,3,4,2,1,0,1,0,15737,7.2,19119,240,64,-385,1446,24.0,1573.7
4520787933,1,22,7,1,8,7,11,1,1,0,0,17525,7.0,17738,202,61,-425,-1057,20.2,1752.5,17,8,0,7,8,6,0,0,0,0,17950,7.0,18795,264,54,425,1057,26.4,1795.0
4497700990,1,16,5,1,7,5,11,0,0,0,0,16541,6.4,17099,231,39,2555,2123,23.1,1654.1,43,4,0,5,7,6,0,0,0,0,13986,6.2,14976,146,40,-2555,-2123,14.6,1398.6
4518445145,1,15,1,1,5,1,5,2,1,1,0,17065,7.0,18930,220,54,2717,1557,22.0,1706.5,12,4,0,1,5,1,0,0,0,0,14348,7.0,17373,227,62,-2717,-1557,22.7,1434.8
4524590914,0,15,3,0,7,11,4,0,0,0,0,15967,6.8,17259,205,47,-2068,36,20.5,1596.7,22,5,1,11,7,12,0,0,0,0,18035,6.8,17223,210,28,2068,-36,21.0,1803.5
4519467350,0,14,1,0,6,7,10,2,1,1,0,15931,7.0,17903,202,48,-1613,-836,20.2,1593.1,17,1,1,7,6,10,0,0,0,0,17544,7.2,18739,217,58,1613,836,21.7,1754.4
4515734376,0,12,0,1,3,8,3,0,0,0,0,15206,6.8,17404,205,59,-1711,-1201,20.5,1520.6,20,3,0,8,3,11,1,1,0,0,16917,7.0,18605,217,43,1711,1201,21.7,1691.7
4455592163,1,19,3,1,6,5,7,1,1,0,0,16028,6.8,17147,220,45,192,-1312,22.0,1602.8,14,2,0,5,6,3,0,0,0,0,15836,7.2,18459,211,56,-192,1312,21.1,1583.6
4499992790,0,38,2,1,4,4,4,1,1,0,0,16907,7.2,18996,259,55,1559,814,25.9,1690.7,16,19,0,4,4,7,0,0,0,0,15348,6.8,18182,189,56,-1559,-814,18.9,1534.8
4518554441,0,17,2,0,5,11,3,1,1,0,0,14801,6.2,16202,209,42,-3527,-1901,20.9,1480.1,19,3,1,11,5,12,0,0,0,0,18328,7.0,18103,230,43,3527,1901,23.0,1832.8
4526284156,1,19,1,0,7,9,8,0,0,0,0,16481,7.0,17470,223,44,-246,-1064,22.3,1648.1,11,1,1,9,7,6,0,0,0,0,16727,7.0,18534,220,31,246,1064,22.0,1672.7
4446037103,0,21,4,1,5,6,3,0,0,0,0,16507,7.2,18410,228,58,731,44,22.8,1650.7,20,4,0,6,5,8,1,0,1,0,15776,7.2,18366,203,47,-731,-44,20.3,1577.6
4519568491,1,16,1,0,7,5,8,0,0,0,0,17830,7.0,18550,214,55,1299,8,21.4,1783.0,12,3,1,5,7,4,2,1,1,0,16531,7.2,18542,217,64,-1299,-8,21.7,1653.1
4523282532,0,10,6,1,6,9,8,0,0,0,0,16356,6.4,16343,202,47,-2865,-3840,20.2,1635.6,18,3,0,9,6,10,2,1,1,0,19221,7.4,20183,223,59,2865,3840,22.3,1922.1
4520840056,0,53,2,0,2,4,2,0,0,0,0,14026,6.8,17348,210,45,-2478,-1258,21.0,1402.6,18,2,1,4,2,7,0,0,0,0,16504,7.2,18606,244,66,2478,1258,24.4,1650.4
4513160500,1,19,4,0,11,6,9,1,0,1,0,17612,6.8,18342,212,46,1227,1050,21.2,1761.2,17,4,1,6,11,5,0,0,0,0,16385,6.8,17292,169,41,-1227,-1050,16.9,1638.5
4524546910,0,146,0,0,1,11,1,0,0,0,0,13943,6.2,16274,204,56,-5302,-3981,20.4,1394.3,50,3,1,11,1,13,0,0,0,0,19245,7.4,20255,238,64,5302,3981,23.8,1924.5
4523430704,1,15,2,1,9,6,10,1,1,0,0,18447,7.4,20232,243,69,1745,1766,24.3,1844.7,14,2,0,6,9,7,0,0,0,0,16702,7.2,18466,240,47,-1745,-1766,24.0,1670.2
4525324183,0,15,3,0,6,5,9,1,1,0,0,15368,6.4,16039,169,55,71,-679,16.9,1536.8,16,2,1,5,6,2,0,0,0,0,15297,6.4,16718,198,51,-71,679,19.8,1529.7
4464361893,1,19,1,0,8,7,11,0,0,0,0,18672,7.2,19296,250,55,2427,742,25.0,1867.2,15,2,1,7,8,5,1,1,0,0,16245,7.0,18554,184,49,-2427,-742,18.4,1624.5
4476715890,1,16,3,1,11,4,7,1,1,0,0,18303,7.2,19093,214,54,3586,2697,21.4,1830.3,16,1,0,4,11,2,0,0,0,0,14717,6.4,16396,180,46,-3586,-2697,18.0,1471.7
4518154341,0,11,2,1,2,2,0,0,0,0,0,15652,7.6,19647,270,68,-194,459,27.0,1565.2,14,1,0,2,2,2,1,1,0,0,15846,7.0,19188,276,60,194,-459,27.6,1584.6
4519495727,0,16,4,0,11,8,17,1,0,1,0,18053,6.6,17357,189,47,620,339,18.9,1805.3,16,4,1,8,11,10,0,0,0,0,17433,6.4,17018,196,38,-620,-339,19.6,1743.3
4496800946,1,40,2,1,2,2,3,2,1,1,0,14653,7.0,17643,224,44,758,502,22.4,1465.3,17,4,0,2,2,0,0,0,0,0,13895,6.8,17141,221,50,-758,-502,22.1,1389.5
4523323682,0,15,4,1,7,6,8,0,0,0,0,16495,6.8,17444,211,48,222,-72,21.1,1649.5,17,2,0,6,7,6,1,1,0,0,16273,6.8,17516,205,52,-222,72,20.5,1627.3
4518246316,1,14,3,0,9,6,12,1,1,0,0,18054,7.2,18465,241,52,1859,1271,24.1,1805.4,39,0,1,6,9,11,0,0,0,0,16195,6.8,17194,197,55,-1859,-1271,19.7,1619.5
4414955673,1,21,2,1,2,1,1,0,0,0,0,16528,7.4,20454,262,92,2617,3735,26.2,1652.8,12,3,0,1,2,1,1,1,0,0,13911,6.6,16719,231,48,-2617,-3735,23.1,1391.1
4516120877,0,41,3,0,3,11,4,1,0,1,0,14423,6.8,16642,190,51,-4452,-3726,19.0,1442.3,15,4,1,11,3,8,1,1,0,0,18875,7.4,20368,238,64,4452,3726,23.8,1887.5
4423131691,0,15,4,1,4,6,4,1,0,1,0,15320,7.0,16960,217,40,-1152,-1535,21.7,1532.0,49,6,0,6,4,5,1,1,0,0,16472,7.0,18495,225,56,1152,1535,22.5,1647.2
4469837233,1,12,1,1,1,6,1,0,0,0,0,14577,6.8,17474,263,43,-1742,-1210,26.3,1457.7,15,2,0,6,1,6,1,1,0,0,16319,7.0,18684,234,52,1742,1210,23.4,1631.9
4521775433,1,45,2,0,5,8,6,0,0,0,0,16936,6.8,17513,215,63,-301,71,21.5,1693.6,44,7,1,8,5,10,1,1,0,0,17237,7.0,17442,187,60,301,-71,18.7,1723.7
4526188851,1,18,2,1,14,6,10,1,0,1,0,19203,7.4,20047,220,49,3548,3559,22.0,1920.3,16,1,0,6,14,7,1,1,0,0,15655,6.6,16488,204,30,-3548,-3559,20.4,1565.5
4476038312,0,20,2,1,4,8,5,1,1,0,0,15524,6.6,17508,214,60,-2752,-2170,21.4,1552.4,16,3,0,8,4,9,0,0,0,0,18276,7.4,19678,252,63,2752,2170,25.2,1827.6
4519568635,0,16,2,0,3,9,4,0,0,0,0,15279,6.8,17220,206,67,-3702,-1251,20.6,1527.9,17,3,1,9,3,14,2,1,1,1,18981,7.0,18471,237,52,3702,1251,23.7,1898.1
4523704429,0,20,3,1,12,10,12,1,1,0,0,17804,6.6,16151,168,29,-612,-1019,16.8,1780.4,14,5,0,10,12,13,0,0,0,0,18416,6.6,17170,171,52,612,1019,17.1,1841.6
4494818670,1,13,7,1,6,5,8,1,1,0,0,16283,7.0,18397,228,44,-152,71,22.8,1628.3,19,1,0,5,6,8,0,0,0,0,16435,6.8,18326,253,40,152,-71,25.3,1643.5
4476300500,0,18,1,0,0,8,0,0,0,0,0,13537,6.2,15367,208,52,-3752,-3349,20.8,1353.7,16,2,1,8,0,10,1,1,0,0,17289,7.4,18716,242,40,3752,3349,24.2,1728.9
4521511498,1,15,0,0,5,7,4,1,1,0,0,15681,6.6,16896,205,50,-1058,-1404,20.5,1568.1,15,2,1,7,5,10,0,0,0,0,16739,7.0,18300,224,49,1058,1404,22.4,1673.9
4479670533,1,16,9,0,3,5,6,2,1,1,0,15911,7.0,18170,231,63,-357,221,23.1,1591.1,20,4,1,5,3,7,0,0,0,0,16268,7.0,17949,224,51,357,-221,22.4,1626.8
4419367000,1,41,3,0,4,17,4,0,0,0,0,15488,6.6,16539,184,47,-4903,-3146,18.4,1548.8,23,6,1,17,4,16,1,1,0,0,20391,7.4,19685,204,48,4903,3146,20.4,2039.1
4522419081,1,15,5,1,7,6,6,1,0,1,0,17409,6.8,18063,241,51,1430,107,24.1,1740.9,18,2,0,6,7,7,1,1,0,0,15979,7.0,17956,173,54,-1430,-107,17.3,1597.9
4521835528,0,22,3,0,6,4,9,0,0,0,0,16726,7.0,18564,234,54,897,366,23.4,1672.6,13,6,1,4,6,2,1,1,0,0,15829,7.0,18198,214,69,-897,-366,21.4,1582.9
4457247520,1,122,2,1,15,10,9,1,0,1,0,19204,7.6,20520,215,54,1902,3370,21.5,1920.4,13,4,0,10,15,12,0,0,0,0,17302,6.8,17150,183,27,-1902,-3370,18.3,1730.2
4493828380,0,13,3,1,5,6,3,0,0,0,0,15964,7.2,19695,206,59,-226,972,20.6,1596.4,20,5,0,6,5,7,1,1,0,0,16190,7.2,18723,208,40,226,-972,20.8,1619.0
4513214208,0,42,3,0,7,8,10,0,0,0,0,16337,6.8,17367,197,47,-38,281,19.7,1633.7,15,4,1,8,7,4,1,1,0,0,16375,6.6,17086,192,43,38,-281,19.2,1637.5
4510666820,1,41,1,1,12,5,18,1,1,0,0,18567,7.0,18176,227,40,1526,472,22.7,1856.7,17,1,0,5,12,7,0,0,0,0,17041,6.8,17704,203,56,-1526,-472,20.3,1704.1
4508144536,0,14,2,0,2,8,3,0,0,0,0,14348,7.0,17150,196,56,-3489,-2633,19.6,1434.8,21,1,1,8,2,12,1,1,0,0,17837,7.4,19783,239,52,3489,2633,23.9,1783.7
4511237975,1,18,1,0,3,7,3,0,0,0,0,15008,6.8,17439,214,56,-3688,-2808,21.4,1500.8,15,2,1,7,3,9,1,1,0,0,18696,7.4,20247,258,64,3688,2808,25.8,1869.6
4477428362,1,12,1,1,3,5,3,0,0,0,0,15708,6.8,17721,226,52,-564,-1862,22.6,1570.8,16,4,0,5,3,5,1,1,0,0,16272,7.2,19583,243,60,564,1862,24.3,1627.2
4516281243,1,16,2,1,13,4,15,1,0,1,1,19547,6.6,17353,207,44,3967,593,20.7,1954.7,16,3,0,4,13,5,0,0,0,0,15580,6.8,16760,212,51,-3967,-593,21.2,1558.0
4512603224,1,16,1,1,5,3,6,1,1,0,0,15343,7.0,17430,210,56,1184,848,21.0,1534.3,25,2,0,3,5,3,0,0,0,0,14159,6.4,16582,213,33,-1184,-848,21.3,1415.9
4521009917,0,21,4,1,2,5,4,0,0,0,0,15020,7.0,17488,224,64,-1756,-985,22.4,1502.0,14,2,0,5,2,8,2,1,1,0,16776,7.0,18473,275,48,1756,985,27.5,1677.6
4489939324,1,17,4,0,4,12,4,1,0,1,1,16643,6.6,15836,202,51,-1111,-1185,20.2,1664.3,15,3,1,12,4,15,1,1,0,1,17754,6.4,17021,188,40,1111,1185,18.8,1775.4
4503336333,1,16,2,0,9,10,9,0,0,0,0,17776,6.8,17464,211,33,90,-540,21.1,1777.6,15,2,1,10,9,10,0,0,0,0,17686,6.8,18004,203,44,-90,540,20.3,1768.6
4513493153,0,53,5,1,10,8,10,0,0,0,0,17573,7.0,17180,205,42,-81,-1466,20.5,1757.3,15,7,0,8,10,6,1,1,0,0,17654,7.0,18646,227,57,81,1466,22.7,1765.4
4526622079,1,15,2,0,10,2,7,1,1,0,0,17955,7.4,20629,241,54,3912,5044,24.1,1795.5,15,0,1,2,10,3,0,0,0,0,14043,6.2,15585,182,52,-3912,-5044,18.2,1404.3
4526112177,0,41,3,1,7,8,4,0,0,0,0,16667,7.4,18874,213,44,-692,-987,21.3,1666.7,16,4,0,8,7,6,1,1,0,0,17359,7.4,19861,245,56,692,987,24.5,1735.9
4514470040,0,11,1,0,3,10,1,0,0,0,0,14637,6.6,17059,210,55,-3368,-2587,21.0,1463.7,36,1,1,10,3,10,1,1,0,0,18005,7.4,19646,236,41,3368,2587,23.6,1800.5
4524662465,1,16,1,0,11,4,18,1,1,0,0,19695,7.2,19512,258,48,3936,2111,25.8,1969.5,12,2,1,4,11,4,1,0,1,0,15759,7.0,17401,205,68,-3936,-2111,20.5,1575.9
4468826145,0,15,2,0,6,9,3,1,1,0,0,15512,6.6,17704,198,50,-2399,-1527,19.8,1551.2,15,1,1,9,6,5,0,0,0,0,17911,7.2,19231,222,48,2399,1527,22.2,1791.1
4474087282,1,41,3,0,6,4,5,0,0,0,0,15724,6.8,17512,217,46,81,1865,21.7,1572.4,21,3,1,4,6,7,1,1,0,0,15643,6.4,15647,219,58,-81,-1865,21.9,1564.3
4505453773,0,44,4,0,5,12,6,0,0,0,0,15851,6.6,16800,182,56,-3248,-2442,18.2,1585.1,19,0,1,12,5,9,1,1,0,0,19099,7.2,19242,243,44,3248,2442,24.3,1909.9
4522000980,0,14,0,1,8,8,6,1,1,0,0,16809,7.0,18470,210,44,-12,-151,21.0,1680.9,13,2,0,8,8,6,0,0,0,0,16821,7.2,18621,221,48,12,151,22.1,1682.1
4507840588,1,14,2,1,6,4,8,1,1,0,0,16521,7.0,17693,203,56,1490,1461,20.3,1652.1,14,2,0,4,6,6,0,0,0,0,15031,6.4,16232,216,39,-1490,-1461,21.6,1503.1
4506848642,1,21,3,1,6,2,6,1,1,0,0,17303,7.0,18810,234,64,3643,3695,23.4,1730.3,16,0,0,2,6,3,0,0,0,0,13660,6.2,15115,179,52,-3643,-3695,17.9,1366.0
4518069605,1,77,2,0,4,3,7,1,1,0,0,16321,7.0,18950,250,52,508,-183,25.0,1632.1,15,4,1,3,4,7,0,0,0,0,15813,7.0,19133,225,74,-508,183,22.5,1581.3
4524941419,1,13,0,0,22,6,29,1,0,1,1,23205,7.0,17846,208,23,7600,1865,20.8,2320.5,15,1,1,6,22,9,0,0,0,0,15605,6.4,15981,171,58,-7600,-1865,17.1,1560.5
4466944349,0,20,2,0,4,6,3,0,0,0,0,15518,6.8,18114,241,44,-1630,-531,24.1,1551.8,16,3,1,6,4,8,1,1,0,0,17148,7.2,18645,243,64,1630,531,24.3,1714.8
4499945956,0,12,6,1,5,8,4,0,0,0,0,16116,6.8,16953,233,43,-89,-953,23.3,1611.6,16,2,0,8,5,3,1,1,0,0,16205,6.8,17906,213,52,89,953,21.3,1620.5
4510180756,0,35,3,1,8,4,11,1,1,0,0,17857,7.2,19272,239,51,2374,1332,23.9,1785.7,16,3,0,4,8,3,0,0,0,0,15483,7.0,17940,239,52,-2374,-1332,23.9,1548.3
4521139386,0,15,2,0,3,3,4,0,0,0,0,14298,6.4,17567,228,40,-873,-736,22.8,1429.8,15,4,1,3,3,2,0,0,0,0,15171,7.0,18303,238,51,873,736,23.8,1517.1
4519394715,0,15,5,0,5,8,5,0,0,0,0,16372,6.6,16747,230,43,53,-48,23.0,1637.2,72,3,1,8,5,8,1,1,0,0,16319,6.8,16795,186,42,-53,48,18.6,1631.9
4500860380,1,20,5,1,7,2,8,1,1,0,0,17199,7.4,19353,235,68,3013,2244,23.5,1719.9,13,1,0,2,7,0,0,0,0,0,14186,6.6,17109,205,61,-3013,-2244,20.5,1418.6
4486740435,0,13,2,0,4,13,2,0,0,0,0,14969,6.6,16183,208,43,-4486,-5334,20.8,1496.9,23,2,1,13,4,8,0,0,0,0,19455,7.6,21517,222,59,4486,5334,22.2,1945.5
4524320720,0,32,2,0,4,10,3,1,1,0,0,15571,6.8,17116,228,63,-3481,-1919,22.8,1557.1,15,3,1,10,4,13,1,0,1,0,19052,7.4,19035,258,36,3481,1919,25.8,1905.2
4518495220,1,14,0,1,8,8,4,2,1,1,0,16459,6.8,17550,190,48,-335,-213,19.0,1645.9,16,0,0,8,8,7,0,0,0,0,16794,7.0,17763,209,57,335,213,20.9,1679.4
4488272023,1,40,4,0,7,4,6,0,0,0,0,16972,7.2,19381,222,57,1992,3174,22.2,1697.2,16,6,1,4,7,6,1,1,0,0,14980,6.4,16207,221,36,-1992,-3174,22.1,1498.0
4527225150,1,38,3,0,8,6,8,2,1,1,0,16294,6.6,17550,186,44,-445,-293,18.6,1629.4,89,2,1,6,8,6,0,0,0,0,16739,6.8,17843,193,58,445,293,19.3,1673.9
4523654573,1,12,3,1,7,4,6,1,1,0,0,17914,7.0,18528,240,62,3410,2524,24.0,1791.4,38,1,0,4,7,7,0,0,0,0,14504,6.4,16004,187,48,-3410,-2524,18.7,1450.4
4518022998,0,23,5,1,7,7,6,0,0,0,0,16313,6.8,16697,201,40,-1249,-3078,20.1,1631.3,17,8,0,7,7,5,0,0,0,0,17562,7.4,19775,228,59,1249,3078,22.8,1756.2
4525060117,1,18,3,1,7,2,5,1,1,0,0,16860,6.8,18168,226,49,2984,1565,22.6,1686.0,22,3,0,2,7,1,0,0,0,0,13876,6.6,16603,216,40,-2984,-1565,21.6,1387.6
4518820210,0,12,1,0,2,6,2,0,0,0,0,14295,6.4,16196,211,40,-2514,-2762,21.1,1429.5,56,3,1,6,2,6,1,1,0,0,16809,7.2,18958,219,67,2514,2762,21.9,1680.9
4517721680,1,16,3,0,2,7,4,1,1,0,0,14558,6.8,17024,206,63,-2564,-1959,20.6,1455.8,18,3,1,7,2,8,1,0,1,0,17122,7.2,18983,222,48,2564,1959,22.2,1712.2
4524174567,1,15,1,0,1,4,1,1,1,0,0,14911,6.8,18362,238,60,-626,895,23.8,1491.1,19,2,1,4,1,4,0,0,0,0,15537,6.8,17467,230,39,626,-895,23.0,1553.7
4526764469,1,15,4,1,13,7,15,1,1,0,0,18236,6.8,17766,202,32,2369,1517,20.2,1823.6,13,2,0,7,13,6,0,0,0,0,15867,6.8,16249,191,43,-2369,-1517,19.1,1586.7
4525170767,0,16,4,0,14,10,23,0,0,0,0,19139,6.8,17648,180,28,814,82,18.0,1913.9,19,3,1,10,14,14,0,0,0,0,18325,7.0,17566,203,46,-814,-82,20.3,1832.5
4465999094,1,13,0,1,5,3,6,0,0,0,0,15284,6.6,16690,187,51,-480,-607,18.7,1528.4,15,1,0,3,5,3,1,1,0,0,15764,6.6,17297,230,60,480,607,23.0,1576.4
4502952363,0,78,3,1,7,7,15,0,0,0,0,16250,6.8,17026,157,54,-1661,-1369,15.7,1625.0,19,5,0,7,7,9,0,0,0,0,17911,7.2,18395,243,51,1661,1369,24.3,1791.1
4516121686,0,25,1,1,6,6,11,1,1,0,0,17831,6.8,18269,240,43,965,-878,24.0,1783.1,17,2,0,6,6,7,0,0,0,0,16866,7.0,19147,233,51,-965,878,23.3,1686.6
4500843362,1,14,3,1,4,6,6,0,0,0,0,15260,6.8,17024,201,32,-1443,-1629,20.1,1526.0,16,2,0,6,4,9,1,1,0,0,16703,7.4,18653,212,74,1443,1629,21.2,1670.3
4442215686,0,20,2,1,5,5,7,0,0,0,0,16110,7.0,18673,222,53,-146,557,22.2,1611.0,15,4,0,5,5,7,0,0,0,0,16256,7.0,18116,217,64,146,-557,21.7,1625.6
4527431708,1,14,1,1,8,3,4,2,1,1,1,17827,7.2,19215,229,44,3073,1928,22.9,1782.7,7,1,0,3,8,2,0,0,0,0,14754,6.8,17287,182,54,-3073,-1928,18.2,1475.4
4495426871,1,12,1,1,9,3,10,1,1,0,0,17347,7.0,18131,230,51,2547,1386,23.0,1734.7,16,0,0,3,9,7,0,0,0,0,14800,6.6,16745,208,60,-2547,-1386,20.8,1480.0
4469933897,1,17,4,1,13,5,11,2,1,1,0,19639,7.2,19564,239,56,5025,3609,23.9,1963.9,13,3,0,5,13,8,0,0,0,0,14614,6.4,15955,147,52,-5025,-3609,14.7,1461.4
4462313921,1,57,4,1,17,5,25,0,0,0,2,23359,7.4,20348,237,56,7776,6703,23.7,2335.9,14,5,0,5,17,7,0,0,0,0,15583,5.8,13645,134,41,-7776,-6703,13.4,1558.3
4431359943,0,17,2,0,6,10,7,1,1,0,0,15336,6.6,16676,187,56,-2735,-2136,18.7,1533.6,15,1,1,10,6,9,1,0,1,0,18071,7.0,18812,226,46,2735,2136,22.6,1807.1
4508028772,0,13,2,0,6,5,4,1,1,0,0,15655,6.8,17386,203,53,-693,-919,20.3,1565.5,14,1,1,5,6,5,0,0,0,0,16348,7.0,18305,234,56,693,919,23.4,1634.8
4495165878,0,17,2,1,4,9,2,0,0,0,0,14706,6.6,16463,195,44,-3856,-1959,19.5,1470.6,28,5,0,9,4,14,0,0,0,0,18562,7.0,18422,250,48,3856,1959,25.0,1856.2
4496152088,1,13,1,1,2,4,1,1,1,0,0,14492,7.0,16869,211,57,-611,-1958,21.1,1449.2,24,1,0,4,2,3,0,0,0,0,15103,7.2,18827,230,57,611,1958,23.0,1510.3
4492296802,0,11,6,0,5,2,8,1,1,0,0,16496,6.8,18200,251,64,1506,-169,25.1,1649.6,46,2,1,2,5,1,1,0,1,0,14990,7.0,18369,224,68,-1506,169,22.4,1499.0
4525869315,0,15,4,0,8,10,11,2,1,1,0,17351,6.6,16649,204,44,-780,63,20.4,1735.1,26,4,1,10,8,14,0,0,0,0,18131,6.8,16586,193,52,780,-63,19.3,1813.1
4526078316,1,33,5,1,10,4,11,1,1,0,0,17593,7.0,17874,190,41,2596,1052,19.0,1759.3,20,4,0,4,10,5,0,0,0,0,14997,6.6,16822,207,52,-2596,-1052,20.7,1499.7
4469779402,0,15,3,0,6,12,5,0,0,0,0,15794,6.8,17285,192,49,-4649,-1914,19.2,1579.4,18,2,1,12,6,11,1,1,0,1,20443,7.4,19199,213,47,4649,1914,21.3,2044.3
4518093474,0,17,3,1,8,9,7,1,1,0,0,16527,6.6,16884,194,52,-233,-754,19.4,1652.7,39,6,0,9,8,12,1,0,1,0,16760,6.8,17638,197,38,233,754,19.7,1676.0
4513621339,1,41,1,1,4,9,5,1,1,0,0,15316,6.6,17118,198,52,-2986,-3369,19.8,1531.6,13,9,0,9,4,3,0,0,0,0,18302,7.4,20487,247,64,2986,3369,24.7,1830.2
4521901284,1,17,6,1,8,4,10,1,1,0,0,17496,7.2,18253,246,31,2013,247,24.6,1749.6,16,4,0,4,8,3,0,0,0,0,15483,7.0,18006,229,60,-2013,-247,22.9,1548.3
4524227003,0,16,8,0,3,8,3,1,0,1,0,15330,7.0,18294,230,57,-2105,-1066,23.0,1533.0,24,5,1,8,3,8,1,1,0,0,17435,7.2,19360,225,60,2105,1066,22.5,1743.5
4461961055,0,20,6,1,6,5,7,1,0,1,0,16008,6.8,17798,216,44,-904,-178,21.6,1600.8,86,6,0,5,6,4,0,0,0,0,16912,7.0,17976,257,47,904,178,25.7,1691.2
4527646038,0,16,5,0,10,11,12,0,0,0,0,17788,6.8,17829,159,59,-275,-739,15.9,1778.8,20,4,1,11,10,7,0,0,0,0,18063,7.0,18568,212,55,275,739,21.2,1806.3
4483939120,1,16,1,1,3,5,5,0,0,0,0,15441,7.0,18222,226,55,329,601,22.6,1544.1,14,1,0,5,3,3,2,1,1,0,15112,6.8,17621,203,56,-329,-601,20.3,1511.2
4525174199,1,16,2,0,3,2,3,1,1,0,0,15356,7.0,18787,212,64,420,521,21.2,1535.6,20,4,1,2,3,1,0,0,0,0,14936,7.0,18266,230,57,-420,-521,23.0,1493.6
4524274738,1,15,1,0,2,8,0,0,0,0,0,13636,6.6,16872,190,46,-3455,-2405,19.0,1363.6,59,3,1,8,2,8,0,0,0,0,17091,7.0,19277,217,42,3455,2405,21.7,1709.1
4439155186,1,16,4,0,7,6,9,0,0,0,0,16869,7.2,18297,230,55,713,-58,23.0,1686.9,19,2,1,6,7,9,1,1,0,0,16156,6.8,18355,213,48,-713,58,21.3,1615.6
4505284268,0,14,3,1,3,10,5,0,0,0,0,14826,6.6,16636,185,56,-3607,-2956,18.5,1482.6,16,2,0,10,3,12,1,1,0,0,18433,7.4,19592,257,41,3607,2956,25.7,1843.3
4520333259,1,16,5,0,6,4,7,0,0,0,0,16619,7.2,18958,226,51,1552,1488,22.6,1661.9,31,4,1,4,6,5,0,0,0,0,15067,6.8,17470,213,52,-1552,-1488,21.3,1506.7
4501115839,1,35,2,1,11,8,14,0,0,0,0,18302,6.8,17304,235,36,2178,31,23.5,1830.2,16,18,0,8,11,5,0,0,0,0,16124,6.8,17273,192,44,-2178,-31,19.2,1612.4
4521990616,1,21,2,1,9,6,7,0,0,0,0,18229,6.8,18093,230,46,2765,1407,23.0,1822.9,17,5,0,6,9,5,2,1,1,0,15464,6.6,16686,195,56,-2765,-1407,19.5,1546.4
4523329461,0,19,5,0,5,6,2,0,0,0,0,15807,7.2,18325,231,43,-281,497,23.1,1580.7,16,7,1,6,5,5,0,0,0,0,16088,7.0,17828,230,48,281,-497,23.0,1608.8
4470324396,0,18,1,0,4,7,6,1,1,0,0,14487,6.4,16054,170,52,-2088,-2747,17.0,1448.7,14,1,1,7,4,6,0,0,0,0,16575,7.4,18801,217,40,2088,2747,21.7,1657.5
4465123889,1,16,3,0,8,11,11,0,0,0,0,17554,6.6,16706,227,43,-1548,-1988,22.7,1755.4,20,7,1,11,8,13,2,1,1,0,19102,7.0,18694,225,58,1548,1988,22.5,1910.2
4503193235,0,17,5,0,2,8,3,0,0,0,0,14176,6.8,17054,194,48,-3360,-1842,19.4,1417.6,19,3,1,8,2,7,1,1,0,0,17536,7.2,18896,228,56,3360,1842,22.8,1753.6
4492994895,1,11,2,1,4,4,0,1,0,1,0,15620,7.2,18558,239,56,-1761,-385,23.9,1562.0,18,0,0,4,4,8,1,1,0,1,17381,7.4,18943,243,54,1761,385,24.3,1738.1
4524725570,0,26,1,1,7,9,9,1,0,1,0,16682,7.0,18002,180,59,-1370,-1269,18.0,1668.2,15,0,0,9,7,14,1,1,0,0,18052,7.4,19271,221,44,1370,1269,22.1,1805.2
4493753428,1,17,4,0,5,5,7,1,0,1,0,17135,7.4,19139,242,52,1046,815,24.2,1713.5,19,3,1,5,5,6,1,1,0,0,16089,7.0,18324,233,48,-1046,-815,23.3,1608.9
4465110023,1,14,3,1,6,1,5,1,1,0,0,17001,7.0,18549,240,49,3156,1621,24.0,1700.1,14,2,0,1,6,2,0,0,0,0,13845,6.8,16928,206,47,-3156,-1621,20.6,1384.5
4502862242,1,13,1,0,6,7,5,2,1,1,0,15235,6.6,16288,189,44,-1747,-1827,18.9,1523.5,73,2,1,7,6,9,0,0,0,0,16982,6.8,18115,223,47,1747,1827,22.3,1698.2
4517773743,0,16,0,1,4,9,1,0,0,0,0,14939,6.8,17241,195,68,-4843,-2306,19.5,1493.9,38,3,0,9,4,17,2,1,1,1,19782,7.0,19547,227,63,4843,2306,22.7,1978.2
4525957901,0,42,1,1,12,11,10,1,1,0,0,18159,7.0,18557,207,37,-48,482,20.7,1815.9,22,5,0,11,12,16,0,0,0,0,18207,7.2,18075,159,46,48,-482,15.9,1820.7
4525326999,1,40,3,1,3,3,3,1,1,0,0,14977,7.0,17698,223,44,98,161,22.3,1497.7,15,19,0,3,3,4,0,0,0,0,14879,6.8,17537,224,44,-98,-161,22.4,1487.9
4525122306,1,21,1,0,5,10,4,0,0,0,0,15363,6.4,16498,206,45,-2623,-2312,20.6,1536.3,14,4,1,10,5,16,1,0,1,0,17986,7.0,18810,226,33,2623,2312,22.6,1798.6
4527240593,0,38,1,1,9,5,8,0,0,0,0,18174,7.0,18815,232,55,3242,2227,23.2,1817.4,34,3,0,5,9,7,1,1,0,0,14932,6.8,16588,191,40,-3242,-2227,19.1,1493.2
4522266897,0,18,3,0,8,14,4,0,0,0,0,15070,6.4,15375,142,40,-4245,-3073,14.2,1507.0,20,0,1,14,8,12,2,1,1,0,19315,7.0,18448,193,48,4245,3073,19.3,1931.5
4522527253,1,16,1,1,5,2,6,0,0,0,0,16398,7.0,17792,234,39,1343,519,23.4,1639.8,12,1,0,2,5,1,1,1,0,0,15055,6.8,17273,225,63,-1343,-519,22.5,1505.5
4485937828,1,18,3,1,11,11,17,0,0,0,0,17571,6.8,16712,174,31,-3024,-2806,17.4,1757.1,18,2,0,11,11,9,1,0,1,1,20595,7.2,19518,243,51,3024,2806,24.3,2059.5
4519487063,0,15,0,0,6,5,6,0,0,0,0,16676,7.0,18660,238,60,333,926,23.8,1667.6,15,1,1,5,6,9,0,0,0,0,16343,6.8,17734,241,44,-333,-926,24.1,1634.3
4481252753,1,38,3,1,10,4,10,1,1,0,0,17870,7.2,18803,177,59,1872,1869,17.7,1787.0,62,2,0,4,10,4,0,0,0,0,15998,6.8,16934,225,52,-1872,-1869,22.5,1599.8
4512953268,0,9,4,0,7,9,6,0,0,0,0,16939,6.8,17715,223,43,-398,-1977,22.3,1693.9,40,2,1,9,7,8,1,1,0,0,17337,7.2,19692,202,60,398,1977,20.2,1733.7
4515342462,0,15,1,0,7,11,7,0,0,0,0,15225,6.4,16334,180,40,-3230,-3243,18.0,1522.5,17,3,1,11,7,7,1,1,0,0,18455,7.2,19577,227,52,3230,3243,22.7,1845.5
4522475191,0,16,3,0,1,5,1,0,0,0,0,13976,6.6,17001,210,58,-2555,-1896,21.0,1397.6,17,4,1,5,1,4,1,1,0,0,16531,7.2,18897,234,68,2555,1896,23.4,1653.1
4520639515,0,15,7,0,7,10,5,1,0,1,0,17119,6.8,18614,216,44,-977,271,21.6,1711.9,18,3,1,10,7,12,1,1,0,0,18096,7.0,18343,215,55,977,-271,21.5,1809.6
4450720876,1,16,2,0,2,4,3,0,0,0,0,14592,7.0,17915,217,60,-2168,-1356,21.7,1459.2,15,4,1,4,2,7,1,1,0,0,16760,7.2,19271,221,76,2168,1356,22.1,1676.0
4525350807,0,14,3,0,5,4,3,0,0,0,0,16293,6.8,17793,218,55,1006,1171,21.8,1629.3,17,2,1,4,5,5,1,1,0,0,15287,6.6,16622,207,52,-1006,-1171,20.7,1528.7
4522688388,1,16,3,1,12,6,16,2,1,1,1,21437,7.2,20067,229,60,7370,5454,22.9,2143.7,16,3,0,6,12,11,0,0,0,0,14067,5.8,14613,133,39,-7370,-5454,13.3,1406.7
4424011852,0,12,17,0,5,2,6,1,1,0,0,16196,7.0,18411,238,46,1106,1014,23.8,1619.6,39,0,1,2,5,3,0,0,0,0,15090,6.8,17397,216,55,-1106,-1014,21.6,1509.0
4526594871,1,38,4,0,5,4,5,0,0,0,0,16508,7.2,18959,230,56,616,1673,23.0,1650.8,14,2,1,4,5,6,0,0,0,0,15892,6.8,17286,238,48,-616,-1673,23.8,1589.2
4470015740,1,19,3,1,4,2,7,1,0,1,0,15648,6.8,17420,216,65,1187,285,21.6,1564.8,20,4,0,2,4,2,1,1,0,0,14461,6.6,17135,215,60,-1187,-285,21.5,1446.1
4518631058,1,19,5,1,8,4,8,0,0,0,0,17041,6.8,17082,227,47,2263,1326,22.7,1704.1,19,5,0,4,8,5,1,1,0,0,14778,6.4,15756,179,55,-2263,-1326,17.9,1477.8
4524603410,1,15,1,1,8,7,6,1,1,0,0,17850,7.2,19943,238,71,1097,1914,23.8,1785.0,16,2,0,7,8,6,0,0,0,0,16753,7.0,18029,224,40,-1097,-1914,22.4,1675.3
4522596312,1,54,1,1,15,2,15,1,1,0,0,19848,7.2,19712,224,52,5275,3662,22.4,1984.8,13,2,0,2,15,0,0,0,0,0,14573,6.6,16050,227,56,-5275,-3662,22.7,1457.3
4513537755,1,11,3,1,8,3,4,1,1,0,0,17499,7.2,19191,231,44,2644,2337,23.1,1749.9,20,0,0,3,8,2,0,0,0,0,14855,6.6,16854,208,39,-2644,-2337,20.8,1485.5
4466163546,1,22,4,0,5,8,6,0,0,0,0,17175,7.0,18994,264,51,-680,567,26.4,1717.5,14,5,1,8,5,11,1,1,0,0,17855,7.0,18427,239,41,680,-567,23.9,1785.5
4512745203,1,17,6,1,12,8,12,1,1,0,0,18821,7.0,18407,203,51,1618,514,20.3,1882.1,24,3,0,8,12,7,1,0,1,0,17203,7.2,17893,181,49,-1618,-514,18.1,1720.3
4523059751,1,15,3,0,4,4,3,0,0,0,0,16669,7.4,19026,266,51,565,275,26.6,1666.9,19,4,1,4,4,5,1,1,0,0,16104,7.2,18751,238,56,-565,-275,23.8,1610.4
4451562915,1,14,0,1,10,8,7,0,0,0,0,17677,7.0,17477,184,67,-44,-2245,18.4,1767.7,14,4,0,8,10,9,0,0,0,0,17721,7.4,19722,224,40,44,2245,22.4,1772.1
4513284283,1,14,3,0,9,5,11,1,1,0,0,17299,7.0,18277,213,44,2079,1371,21.3,1729.9,21,2,1,5,9,4,0,0,0,0,15220,6.6,16906,193,51,-2079,-1371,19.3,1522.0
4521007618,0,13,2,0,4,11,4,2,1,1,0,14926,6.6,16530,210,45,-4847,-2983,21.0,1492.6,32,2,1,11,4,12,0,0,0,1,19773,7.4,19513,218,49,4847,2983,21.8,1977.3
4525620906,1,15,3,0,4,7,2,0,0,0,0,15547,6.8,18141,214,56,-539,723,21.4,1554.7,15,2,1,7,4,6,1,1,0,0,16086,7.0,17418,207,43,539,-723,20.7,1608.6
4519991680,0,16,3,1,6,10,3,0,0,0,0,14812,6.8,17359,183,36,-2393,-881,18.3,1481.2,16,0,0,10,6,8,0,0,0,0,17205,7.0,18240,214,43,2393,881,21.4,1720.5
4523506086,0,17,2,0,1,3,1,0,0,0,0,14735,7.0,18220,234,63,-665,-337,23.4,1473.5,47,5,1,3,1,3,1,1,0,0,15400,7.0,18557,227,65,665,337,22.7,1540.0
4478937217,1,43,4,1,13,4,24,1,1,0,0,19669,7.0,17978,207,32,6876,6535,20.7,1966.9,15,0,0,4,13,8,0,0,0,0,12793,5.2,11443,149,8,-6876,-6535,14.9,1279.3
4522164250,0,15,6,0,2,7,2,0,0,0,0,14329,6.6,16330,211,47,-1966,-3591,21.1,1432.9,18,1,1,7,2,1,1,1,0,0,16295,7.2,19921,217,64,1966,3591,21.7,1629.5
4525378713,1,16,2,0,6,7,5,1,1,0,0,15391,6.6,16901,182,56,-1595,-907,18.2,1539.1,14,2,1,7,6,5,0,0,0,0,16986,6.8,17808,201,64,1595,907,20.1,1698.6
4472747889,1,73,1,1,4,5,4,0,0,0,0,15463,6.8,17936,215,45,-338,-9,21.5,1546.3,14,4,0,5,4,6,1,1,0,0,15801,7.2,17945,217,58,338,9,21.7,1580.1
4520875987,0,16,1,0,4,10,6,0,0,0,0,15430,6.8,16509,207,40,-2763,-1881,20.7,1543.0,17,0,1,10,4,13,0,0,0,0,18193,7.0,18390,218,47,2763,1881,21.8,1819.3
4523427313,1,17,3,0,5,4,7,1,1,0,0,16459,7.2,18670,222,60,785,1188,22.2,1645.9,33,1,1,4,5,1,0,0,0,0,15674,6.6,17482,229,64,-785,-1188,22.9,1567.4
4476720209,1,15,3,0,6,4,3,1,1,0,0,15981,7.0,18320,219,60,354,1465,21.9,1598.1,18,5,1,4,6,4,0,0,0,0,15627,6.6,16855,217,47,-354,-1465,21.7,1562.7
4520494989,1,17,2,1,12,2,11,0,0,0,0,18927,7.4,19861,231,44,4006,3678,23.1,1892.7,16,2,0,2,12,2,0,0,0,0,14921,6.4,16183,176,60,-4006,-3678,17.6,1492.1
4498748724,1,35,2,1,5,3,7,1,0,1,0,15588,6.6,16904,202,44,414,-1224,20.2,1558.8,40,3,0,3,5,2,1,1,0,0,15174,7.0,18128,207,68,-414,1224,20.7,1517.4
4525058248,0,20,2,0,4,6,2,0,0,0,0,15152,6.8,17748,229,48,-619,190,22.9,1515.2,15,6,1,6,4,13,1,1,0,0,15771,6.6,17558,188,50,619,-190,18.8,1577.1
4502201524,0,16,0,0,1,10,0,1,0,1,0,13589,6.6,16161,207,60,-5793,-4650,20.7,1358.9,16,2,1,10,1,12,1,1,0,0,19382,7.8,20811,250,60,5793,4650,25.0,1938.2
4458863956,1,58,1,1,10,2,17,1,1,0,1,19483,7.0,18561,211,56,5415,2991,21.1,1948.3,16,1,0,2,10,4,0,0,0,0,14068,6.4,15570,203,48,-5415,-2991,20.3,1406.8
4449958772,1,13,0,1,8,9,10,1,0,1,0,17563,7.0,18068,190,55,268,789,19.0,1756.3,21,0,0,9,8,13,0,0,0,0,17295,6.6,17279,234,34,-268,-789,23.4,1729.5
4525574521,0,44,6,1,5,3,8,2,1,1,0,17492,7.4,19477,244,59,1708,419,24.4,1749.2,95,7,0,3,5,3,0,0,0,0,15784,7.2,19058,237,54,-1708,-419,23.7,1578.4
4495791670,1,38,3,1,13,2,9,0,0,0,0,20043,7.8,21800,264,64,5300,4813,26.4,2004.3,34,12,0,2,13,0,1,0,1,0,14743,6.6,16987,230,52,-5300,-4813,23.0,1474.3
4524524540,0,16,2,0,10,13,12,0,0,0,0,18178,6.8,17540,200,35,-286,-494,20.0,1817.8,17,4,1,13,10,12,1,1,0,0,18464,6.8,18034,171,40,286,494,17.1,1846.4
4471123041,0,54,3,0,4,2,6,1,1,0,0,15812,7.0,17882,229,53,1325,479,22.9,1581.2,15,3,1,2,4,1,1,0,1,0,14487,7.0,17403,218,54,-1325,-479,21.8,1448.7
4501257883,0,17,4,1,5,3,9,0,0,0,0,16725,7.0,18674,228,66,1279,384,22.8,1672.5,19,2,0,3,5,1,1,1,0,0,15446,7.0,18290,251,52,-1279,-384,25.1,1544.6
4510920346,1,21,1,1,7,3,4,1,1,0,0,17911,7.2,18635,248,60,3969,1119,24.8,1791.1,14,3,0,3,7,2,0,0,0,0,13942,6.8,17516,164,37,-3969,-1119,16.4,1394.2
4518326207,1,15,2,0,11,4,11,0,0,0,0,18470,7.4,19952,231,59,3418,3608,23.1,1847.0,37,0,1,4,11,3,0,0,0,0,15052,6.4,16344,214,36,-3418,-3608,21.4,1505.2
4517689949,1,11,2,0,6,6,4,0,0,0,0,16556,7.2,18696,231,56,399,147,23.1,1655.6,15,1,1,6,6,4,2,1,1,0,16157,7.0,18549,239,54,-399,-147,23.9,1615.7
4520674839,1,20,7,0,7,4,10,0,0,0,0,16082,6.8,17134,199,49,287,289,19.9,1608.2,31,4,1,4,7,4,0,0,0,0,15795,6.6,16845,209,52,-287,-289,20.9,1579.5
4512970043,0,40,2,0,1,5,2,0,0,0,0,13951,7.0,17688,211,49,-2847,-318,21.1,1395.1,13,10,1,5,1,7,1,1,0,0,16798,7.2,18006,239,56,2847,318,23.9,1679.8
4479126740,0,61,3,0,8,10,8,0,0,0,0,16780,6.8,17484,209,39,-1226,48,20.9,1678.0,18,4,1,10,8,12,1,1,0,0,18006,6.8,17436,225,36,1226,-48,22.5,1800.6
4494806155,1,21,2,1,5,1,4,0,0,0,0,16751,7.2,19355,245,53,3029,1278,24.5,1675.1,13,0,0,1,5,1,1,1,0,0,13722,6.8,18077,189,66,-3029,-1278,18.9,1372.2
4526707938,0,87,1,0,9,9,8,1,0,1,1,19206,7.0,17896,219,30,2422,1048,21.9,1920.6,14,3,1,9,9,15,1,1,0,0,16784,6.6,16848,181,39,-2422,-1048,18.1,1678.4
4515523477,1,19,5,0,2,4,2,0,0,0,0,15202,7.2,19256,225,60,-31,849,22.5,1520.2,72,4,1,4,2,3,1,1,0,0,15233,7.2,18407,218,60,31,-849,21.8,1523.3
4450965514,0,18,5,0,8,14,10,0,0,0,0,17157,6.6,17475,200,36,-2095,-2096,20.0,1715.7,18,4,1,14,8,15,0,0,0,0,19252,7.4,19571,206,44,2095,2096,20.6,1925.2
4526385006,1,14,1,0,7,3,7,1,1,0,0,17342,7.2,18792,248,56,2783,1844,24.8,1734.2,11,1,1,3,7,3,0,0,0,0,14559,6.8,16948,197,52,-2783,-1844,19.7,1455.9
4519649944,1,35,1,0,4,4,8,1,1,0,0,15689,7.0,18377,211,64,673,1681,21.1,1568.9,16,1,1,4,4,5,0,0,0,0,15016,6.6,16696,210,43,-673,-1681,21.0,1501.6
4463067805,1,16,2,0,6,5,3,1,1,0,0,16912,7.0,19261,253,60,750,1293,25.3,1691.2,17,3,1,5,6,3,0,0,0,0,16162,7.0,17968,233,40,-750,-1293,23.3,1616.2
4456461566,1,16,1,1,4,5,4,0,0,0,0,15845,6.8,17682,225,48,463,-8,22.5,1584.5,20,1,0,5,4,5,0,0,0,0,15382,7.0,17690,214,42,-463,8,21.4,1538.2
4506198990,0,14,0,0,0,8,0,0,0,0,0,12682,6.6,15784,173,50,-4944,-3928,17.3,1268.2,13,2,1,8,0,4,1,1,0,0,17626,7.4,19712,233,60,4944,3928,23.3,1762.6
4454104065,1,19,4,0,10,5,8,0,0,0,0,17907,7.4,19004,203,43,1227,2404,20.3,1790.7,38,7,1,5,10,11,0,0,0,0,16680,6.6,16600,218,40,-1227,-2404,21.8,1668.0
4477445574,1,17,4,1,4,2,3,0,0,0,0,16267,6.8,18319,246,52,1362,699,24.6,1626.7,16,1,0,2,4,4,2,1,1,0,14905,7.0,17620,228,64,-1362,-699,22.8,1490.5
4481459325,0,22,3,0,5,6,5,1,0,1,0,15766,6.8,17649,209,48,-1219,-759,20.9,1576.6,114,7,1,6,5,10,1,1,0,0,16985,7.0,18408,227,59,1219,759,22.7,1698.5
4475515736,0,14,2,0,4,7,5,0,0,0,0,14488,6.4,16390,197,36,-3152,-2754,19.7,1448.8,37,0,1,7,4,7,1,1,0,0,17640,7.2,19144,196,84,3152,2754,19.6,1764.0
4509107682,1,17,2,0,6,7,8,0,0,0,0,16107,7.2,17763,231,39,-621,-23,23.1,1610.7,16,5,1,7,6,9,1,1,0,0,16728,6.8,17786,216,43,621,23,21.6,1672.8
4494974867,0,11,2,0,3,5,3,0,0,0,0,15673,7.2,18504,234,47,-546,760,23.4,1567.3,14,0,1,5,3,3,2,1,1,0,16219,6.8,17744,237,55,546,-760,23.7,1621.9
4458509653,1,21,4,1,5,5,9,0,0,0,0,16766,7.0,18538,231,47,1543,828,23.1,1676.6,19,5,0,5,5,2,1,1,0,0,15223,6.8,17710,208,52,-1543,-828,20.8,1522.3
4512078045,0,36,4,0,5,5,5,1,0,1,0,15963,7.2,18713,218,62,-985,-93,21.8,1596.3,22,2,1,5,5,5,1,1,0,0,16948,7.2,18806,262,61,985,93,26.2,1694.8
4450278971,1,21,5,1,7,6,6,2,1,1,0,17088,7.2,19719,220,55,1358,641,22.0,1708.8,16,4,0,6,7,4,0,0,0,0,15730,7.2,19078,211,50,-1358,-641,21.1,1573.0
4464596479,0,14,3,0,4,6,4,0,0,0,0,14805,6.6,17323,209,43,-1506,-412,20.9,1480.5,17,3,1,6,4,7,1,1,0,0,16311,7.0,17735,231,44,1506,412,23.1,1631.1
4520633128,1,16,1,0,11,8,13,1,0,1,0,18625,6.6,17323,190,45,1430,916,19.0,1862.5,14,4,1,8,11,9,1,1,0,0,17195,6.6,16407,215,54,-1430,-916,21.5,1719.5
4505401172,0,15,5,1,7,7,6,1,1,0,0,15472,6.8,17032,181,54,-1851,-1875,18.1,1547.2,18,4,0,7,7,4,0,0,0,0,17323,7.2,18907,211,56,1851,1875,21.1,1732.3
4503426918,1,47,3,0,9,3,10,1,0,1,0,16795,7.4,19175,203,41,2011,2996,20.3,1679.5,88,1,1,3,9,3,1,1,0,0,14784,6.6,16179,202,46,-2011,-2996,20.2,1478.4
4525139082,1,18,3,0,7,6,9,0,0,0,0,16711,6.6,17570,207,48,259,-527,20.7,1671.1,14,3,1,6,7,3,0,0,0,0,16452,6.8,18097,221,51,-259,527,22.1,1645.2
4522252623,0,10,3,0,8,11,9,1,1,0,0,16599,6.6,16907,189,39,-2683,-1320,18.9,1659.9,18,2,1,11,8,17,1,0,1,0,19282,7.2,18227,209,53,2683,1320,20.9,1928.2
4509249134,0,17,2,1,4,11,4,1,1,0,0,16231,7.2,18316,211,56,-2932,-2135,21.1,1623.1,40,2,0,11,4,15,0,0,0,0,19163,7.4,20451,215,52,2932,2135,21.5,1916.3
4525082822,0,14,5,0,3,8,4,0,0,0,0,15333,7.2,18245,220,60,-3737,-1022,22.0,1533.3,21,1,1,8,3,12,2,1,1,1,19070,7.4,19267,260,44,3737,1022,26.0,1907.0
4524313607,0,15,2,1,5,6,8,0,0,0,0,15292,7.0,18345,187,54,-1805,-504,18.7,1529.2,18,3,0,6,5,10,1,1,0,0,17097,7.0,18849,241,64,1805,504,24.1,1709.7
4493057531,1,17,2,0,9,6,9,1,1,0,0,17835,7.4,19830,246,39,2177,1584,24.6,1783.5,15,2,1,6,9,4,0,0,0,0,15658,6.8,18246,213,46,-2177,-1584,21.3,1565.8
4524882681,1,14,1,1,7,3,10,1,0,1,0,17326,7.2,18459,224,56,1639,-213,22.4,1732.6,17,2,0,3,7,3,1,1,0,0,15687,7.0,18672,248,68,-1639,213,24.8,1568.7
