gameId,blueWins,blueWardsPlaced,blueWardsDestroyed,blueFirstBlood,blueKills,blueDeaths,blueAssists,blueEliteMonsters,blueDragons,blueHeralds,blueTowersDestroyed,blueTotalGold,blueAvgLevel,blueTotalExperience,blueTotalMinionsKilled,blueTotalJungleMinionsKilled,blueGoldDiff,blueExperienceDiff,blueCSPerMin,blueGoldPerMin,redWardsPlaced,redWardsDestroyed,redFirstBlood,redKills,redDeaths,redAssists,redEliteMonsters,redDragons,redHeralds,redTowersDestroyed,redTotalGold,redAvgLevel,redTotalExperience,redTotalMinionsKilled,redTotalJungleMinionsKilled,redGoldDiff,redExperienceDiff,redCSPerMin,redGoldPerMin
4510707082,1,13,1,1,8,8,7,1,1,0,0,16493,7.0,17450,175,44,-862,-1734,17.5,1649.3,32,2,0,8,8,5,1,0,1,0,17355,7.2,19184,223,55,862,1734,22.3,1735.5
4522023642,0,13,1,0,4,12,4,0,0,0,0,13973,6.2,15260,166,45,-6801,-4611,16.6,1397.3,77,4,1,12,4,14,1,0,1,1,20774,7.4,19871,234,44,6801,4611,23.4,2077.4
4475616584,0,17,3,0,4,7,4,0,0,0,0,14927,6.8,17831,205,52,-2435,-850,20.5,1492.7,25,0,1,7,4,12,1,1,0,0,17362,7.2,18681,227,59,2435,850,22.7,1736.2
4494055420,1,15,5,0,8,7,8,1,0,1,0,16463,6.4,16544,186,40,-460,-1189,18.6,1646.3,18,3,1,7,8,4,0,0,0,0,16923,6.8,17733,238,48,460,1189,23.8,1692.3
4526904265,1,17,1,1,7,4,6,0,0,0,0,16649,7.0,17555,212,52,1535,220,21.2,1664.9,11,2,0,4,7,4,2,1,1,0,15114,7.0,17335,222,53,-1535,-220,22.2,1511.4
4523337230,0,13,3,0,3,12,5,0,0,0,0,15051,6.8,17568,211,47,-4401,-3035,21.1,1505.1,14,3,1,12,3,12,0,0,0,0,19452,7.6,20603,239,48,4401,3035,23.9,1945.2
4454677034,0,15,4,0,8,11,9,1,0,1,0,17080,7.2,18330,196,41,-2247,-1938,19.6,1708.0,17,2,1,11,8,6,0,0,0,0,19327,7.4,20268,227,60,2247,1938,22.7,1932.7
4516130084,0,15,3,0,3,6,0,0,0,0,0,14686,6.8,17861,238,44,-3597,-862,23.8,1468.6,20,3,1,6,3,8,1,1,0,1,18283,7.0,18723,243,52,3597,862,24.3,1828.3
4509014561,1,14,13,1,7,1,3,2,1,1,0,16817,7.2,19506,237,64,3021,2386,23.7,1681.7,37,0,0,1,7,0,0,0,0,0,13796,6.8,17120,214,44,-3021,-2386,21.4,1379.6
4505173550,0,57,3,0,4,6,3,0,0,0,0,15492,6.6,17869,218,44,-310,-392,21.8,1549.2,17,4,1,6,4,7,1,1,0,0,15802,7.2,18261,192,67,310,392,19.2,1580.2
4520855860,0,16,3,1,5,6,10,0,0,0,0,15862,6.6,16175,229,39,-971,-1588,22.9,1586.2,19,2,0,6,5,6,1,0,1,0,16833,6.8,17763,195,59,971,1588,19.5,1683.3
4459452565,1,19,0,0,2,4,2,1,1,0,0,14707,7.0,18199,209,64,-410,-194,20.9,1470.7,14,2,1,4,2,3,0,0,0,0,15117,7.0,18393,201,52,410,194,20.1,1511.7
4489091340,1,18,3,1,4,9,6,0,0,0,0,15445,6.8,17126,225,44,-3056,-2938,22.5,1544.5,43,5,0,9,4,8,1,1,0,0,18501,7.4,20064,221,68,3056,2938,22.1,1850.1
4521194399,1,16,6,1,5,7,4,0,0,0,0,16097,6.8,17793,243,52,-143,462,24.3,1609.7,19,3,0,7,5,8,0,0,0,0,16240,6.6,17331,198,48,143,-462,19.8,1624.0
4458421453,1,26,2,0,7,7,4,0,0,0,0,16875,7.2,18652,214,52,-191,533,21.4,1687.5,16,2,1,7,7,13,1,1,0,0,17066,7.0,18119,230,40,191,-533,23.0,1706.6
4520878592,0,14,1,0,5,6,3,1,0,1,0,14644,6.8,16269,201,31,-2896,-2725,20.1,1464.4,91,3,1,6,5,5,1,1,0,0,17540,7.2,18994,242,56,2896,2725,24.2,1754.0
4465375225,1,12,2,0,8,2,15,1,1,0,0,17392,7.0,18794,215,53,2865,2606,21.5,1739.2,16,1,1,2,8,3,0,0,0,0,14527,6.4,16188,225,52,-2865,-2606,22.5,1452.7
4495408942,1,19,3,1,11,2,20,0,0,0,0,18963,7.4,19079,239,40,5337,3334,23.9,1896.3,15,4,0,2,11,2,1,1,0,0,13626,6.6,15745,179,44,-5337,-3334,17.9,1362.6
4495688378,0,17,2,0,5,5,5,1,1,0,0,15514,7.0,18547,200,56,-1509,-358,20.0,1551.4,14,3,1,5,5,4,0,0,0,0,17023,7.0,18905,259,58,1509,358,25.9,1702.3
4519724135,0,14,0,1,8,10,11,0,0,0,0,16052,6.4,15330,159,44,-1825,-1458,15.9,1605.2,18,1,0,10,8,14,1,1,0,0,17877,6.6,16788,213,41,1825,1458,21.3,1787.7
4520302933,0,48,4,1,7,3,9,2,1,1,1,17669,7.0,18012,221,47,2925,1304,22.1,1766.9,14,2,0,3,7,5,0,0,0,0,14744,6.6,16708,219,52,-2925,-1304,21.9,1474.4
4477737633,0,17,2,0,6,14,8,0,0,0,0,15729,6.6,16459,186,30,-5830,-3608,18.6,1572.9,17,4,1,14,6,14,1,0,1,1,21559,7.4,20067,225,56,5830,3608,22.5,2155.9
4473949665,1,26,4,1,15,3,12,1,0,1,0,21202,7.8,21701,238,59,6577,4426,23.8,2120.2,16,1,0,3,15,3,0,0,0,0,14625,7.0,17275,188,57,-6577,-4426,18.8,1462.5
4524003545,1,14,1,1,4,4,5,2,1,1,0,16370,7.0,18289,257,48,1504,2057,25.7,1637.0,8,1,0,4,4,6,0,0,0,0,14866,6.8,16232,191,52,-1504,-2057,19.1,1486.6
4524303571,0,124,3,1,5,4,6,1,0,1,0,16243,7.0,18154,225,51,1034,706,22.5,1624.3,17,4,0,4,5,2,0,0,0,0,15209,6.8,17448,227,47,-1034,-706,22.7,1520.9
4517829998,0,14,1,1,9,5,11,1,0,1,1,18967,7.2,17807,231,42,3652,1542,23.1,1896.7,40,1,0,5,9,7,0,0,0,0,15315,6.4,16265,194,44,-3652,-1542,19.4,1531.5
4472722581,0,13,4,0,5,4,4,0,0,0,0,17039,7.4,19626,261,60,1116,1123,26.1,1703.9,17,1,1,4,5,3,1,1,0,0,15923,7.0,18503,221,60,-1116,-1123,22.1,1592.3
4508668617,0,17,3,0,6,4,8,0,0,0,0,16990,7.0,18051,244,50,1954,1045,24.4,1699.0,15,3,1,4,6,3,1,1,0,0,15036,6.8,17006,225,40,-1954,-1045,22.5,1503.6
4523466253,0,18,3,0,2,10,3,0,0,0,0,13855,6.4,15500,215,35,-5043,-4627,21.5,1385.5,38,3,1,10,2,9,1,1,0,0,18898,7.2,20127,244,60,5043,4627,24.4,1889.8
4492870605,1,18,1,1,7,2,6,1,1,0,0,16580,7.4,19213,210,48,1586,1273,21.0,1658.0,30,1,0,2,7,1,0,0,0,0,14994,7.0,17940,232,68,-1586,-1273,23.2,1499.4
4505797125,1,15,1,1,9,5,9,0,0,0,1,18391,6.6,17080,183,43,2040,725,18.3,1839.1,16,0,0,5,9,3,1,0,1,1,16351,6.6,16355,203,44,-2040,-725,20.3,1635.1
4510619110,1,14,2,1,10,6,9,1,1,0,0,18655,7.6,19797,254,44,3212,3245,25.4,1865.5,12,2,0,6,10,8,0,0,0,0,15443,6.8,16552,170,52,-3212,-3245,17.0,1544.3
4493965558,1,77,4,0,7,7,9,1,1,0,0,16937,7.0,18017,214,49,375,-566,21.4,1693.7,17,2,1,7,7,7,0,0,0,0,16562,7.0,18583,194,49,-375,566,19.4,1656.2
4512329437,0,55,1,0,4,5,7,0,0,0,0,15900,7.0,17743,187,68,-688,-230,18.7,1590.0,13,3,1,5,4,4,1,1,0,0,16588,6.8,17973,236,51,688,230,23.6,1658.8
4513456323,1,13,4,0,5,2,5,2,1,1,0,17020,7.2,19853,238,52,1686,2152,23.8,1702.0,18,1,1,2,5,3,0,0,0,0,15334,7.0,17701,253,56,-1686,-2152,25.3,1533.4
4499238278,1,30,3,1,5,5,6,1,0,1,1,18317,7.0,19181,238,60,3006,1814,23.8,1831.7,37,2,0,5,5,5,1,1,0,0,15311,6.8,17367,208,48,-3006,-1814,20.8,1531.1
4502257750,0,17,2,1,6,9,5,0,0,0,0,15900,6.6,16277,208,40,-3237,-2680,20.8,1590.0,38,4,0,9,6,6,1,0,1,1,19137,7.0,18957,219,52,3237,2680,21.9,1913.7
4518934441,0,16,5,1,3,9,1,0,0,0,0,14302,6.6,15878,211,51,-3025,-2906,21.1,1430.2,36,1,0,9,3,9,2,1,1,0,17327,7.2,18784,212,64,3025,2906,21.2,1732.7
4475645172,0,36,1,0,2,2,3,1,1,0,0,15313,7.0,18483,221,66,496,1365,22.1,1531.3,16,1,1,2,2,2,0,0,0,0,14817,6.8,17118,237,48,-496,-1365,23.7,1481.7
4519451852,0,15,1,0,1,9,1,0,0,0,0,13627,6.4,15650,206,48,-3366,-1822,20.6,1362.7,15,3,1,9,1,9,1,1,0,0,16993,6.8,17472,205,45,3366,1822,20.5,1699.3
4521631816,0,17,1,0,3,9,2,1,1,0,0,14665,6.2,15990,188,42,-2705,-1757,18.8,1466.5,16,3,1,9,3,9,0,0,0,0,17370,7.2,17747,226,32,2705,1757,22.6,1737.0
4519912865,1,13,3,0,12,4,11,0,0,0,0,19331,7.2,19387,255,50,4003,2566,25.5,1933.1,17,1,1,4,12,5,1,1,0,0,15328,6.8,16821,215,50,-4003,-2566,21.5,1532.8
4427465886,1,15,3,0,9,5,12,2,1,1,0,17112,7.0,18205,204,52,2199,1291,20.4,1711.2,14,0,1,5,9,9,0,0,0,0,14913,7.0,16914,197,36,-2199,-1291,19.7,1491.3
4524765955,0,18,0,0,4,7,4,0,0,0,0,15362,6.2,15828,206,48,-1894,-2184,20.6,1536.2,13,2,1,7,4,4,1,0,1,1,17256,7.0,18012,196,52,1894,2184,19.6,1725.6
4512105521,0,16,4,0,9,6,9,1,1,0,0,17059,7.0,18302,214,52,977,1247,21.4,1705.9,16,1,1,6,9,5,0,0,0,0,16082,6.6,17055,203,52,-977,-1247,20.3,1608.2
4492609650,1,17,4,1,5,4,2,2,1,1,0,15660,6.8,18225,224,53,413,947,22.4,1566.0,25,5,0,4,5,2,0,0,0,0,15247,6.8,17278,226,33,-413,-947,22.6,1524.7
4523577373,1,16,2,1,11,7,13,1,0,1,0,19497,7.2,18445,221,55,3611,2847,22.1,1949.7,15,0,0,7,11,9,0,0,0,0,15886,6.4,15598,165,40,-3611,-2847,16.5,1588.6
4482236619,1,36,4,1,7,4,13,1,1,0,0,17470,7.0,18062,206,64,2335,979,20.6,1747.0,12,2,0,4,7,4,0,0,0,0,15135,6.8,17083,215,48,-2335,-979,21.5,1513.5
4508863080,1,16,6,0,3,5,3,1,1,0,0,16040,7.0,18690,248,72,-877,-813,24.8,1604.0,14,2,1,5,3,6,0,0,0,0,16917,7.2,19503,264,52,877,813,26.4,1691.7
4524617778,0,37,8,1,3,2,2,1,0,1,0,16091,7.6,20383,256,76,1188,2851,25.6,1609.1,20,2,0,2,3,3,1,1,0,0,14903,7.0,17532,244,56,-1188,-2851,24.4,1490.3
4515575207,1,18,1,1,13,2,11,1,1,0,0,19867,7.0,19401,236,58,6977,5303,23.6,1986.7,13,1,0,2,13,4,0,0,0,0,12890,5.8,14098,168,33,-6977,-5303,16.8,1289.0
4452038425,1,22,2,1,6,0,8,1,1,0,0,17359,7.4,20592,265,59,2923,2787,26.5,1735.9,15,7,0,0,6,0,0,0,0,0,14436,6.8,17805,242,48,-2923,-2787,24.2,1443.6
4479476013,1,15,2,0,7,4,9,0,0,0,0,16556,6.6,16868,215,36,2139,850,21.5,1655.6,12,3,1,4,7,4,1,1,0,0,14417,6.4,16018,176,47,-2139,-850,17.6,1441.7
4505140854,0,80,5,0,2,6,3,0,0,0,0,14806,6.8,17653,211,66,-2194,-1240,21.1,1480.6,22,3,1,6,2,7,1,1,0,0,17000,7.0,18893,247,44,2194,1240,24.7,1700.0
4517734306,0,15,2,1,6,7,8,0,0,0,0,16308,7.0,17279,217,48,-313,-1056,21.7,1630.8,35,2,0,7,6,10,1,1,0,0,16621,7.0,18335,207,59,313,1056,20.7,1662.1
4469416246,1,15,4,1,10,8,7,1,0,1,0,17664,7.0,18757,233,53,563,442,23.3,1766.4,13,4,0,8,10,6,0,0,0,0,17101,7.0,18315,219,39,-563,-442,21.9,1710.1
4510662629,1,18,2,1,10,4,7,1,1,0,0,18089,7.0,19431,235,43,2696,2452,23.5,1808.9,11,1,0,4,10,4,0,0,0,0,15393,6.6,16979,196,51,-2696,-2452,19.6,1539.3
4518376722,1,13,1,1,8,3,9,2,1,1,0,18343,7.2,19519,235,59,3049,1511,23.5,1834.3,13,3,0,3,8,2,0,0,0,0,15294,7.0,18008,234,54,-3049,-1511,23.4,1529.4
4470192893,0,13,1,1,3,9,4,1,1,0,0,15009,6.8,17067,207,56,-2492,-1526,20.7,1500.9,16,1,0,9,3,13,0,0,0,0,17501,7.4,18593,204,50,2492,1526,20.4,1750.1
4517744758,1,15,2,1,8,3,7,1,0,1,0,17194,7.2,18529,197,48,2772,2140,19.7,1719.4,56,3,0,3,8,3,0,0,0,0,14422,6.6,16389,188,44,-2772,-2140,18.8,1442.2
4507834811,1,18,1,0,8,6,9,1,1,0,0,17178,7.0,17854,209,44,1260,-55,20.9,1717.8,10,3,1,6,8,3,0,0,0,0,15918,6.8,17909,233,36,-1260,55,23.3,1591.8
4510942047,1,14,3,1,10,4,12,1,1,0,0,19017,7.2,19432,240,54,5117,4126,24.0,1901.7,15,5,0,4,10,4,0,0,0,0,13900,6.4,15306,193,34,-5117,-4126,19.3,1390.0
4478167956,1,13,1,0,14,2,19,1,1,0,0,19133,7.2,19406,200,56,4531,2978,20.0,1913.3,12,2,1,2,14,3,0,0,0,0,14602,6.6,16428,211,60,-4531,-2978,21.1,1460.2
4464908218,1,15,7,1,8,4,4,1,0,1,0,18075,7.4,19469,237,49,2859,2944,23.7,1807.5,16,4,0,4,8,6,0,0,0,0,15216,6.6,16525,224,48,-2859,-2944,22.4,1521.6
4509934873,0,14,3,1,6,3,4,0,0,0,0,16982,7.0,18435,242,51,1277,297,24.2,1698.2,54,2,0,3,6,4,1,1,0,0,15705,6.8,18138,218,75,-1277,-297,21.8,1570.5
4525936315,1,54,4,1,7,9,6,1,1,0,0,16437,6.8,16958,195,48,-222,17,19.5,1643.7,18,6,0,9,7,12,0,0,0,0,16659,6.8,16941,208,34,222,-17,20.8,1665.9
4492702497,1,15,2,1,8,2,12,0,0,0,0,17253,7.2,18869,218,40,1887,519,21.8,1725.3,12,0,0,2,8,3,1,1,0,0,15366,7.0,18350,233,76,-1887,-519,23.3,1536.6
4521047659,1,19,2,0,4,3,4,1,1,0,0,16235,7.0,18651,260,58,584,370,26.0,1623.5,16,2,1,3,4,7,0,0,0,0,15651,7.0,18281,221,68,-584,-370,22.1,1565.1
4516109227,0,13,1,0,6,3,3,1,1,0,0,16658,7.0,18573,251,42,1951,1640,25.1,1665.8,11,1,1,3,6,3,0,0,0,0,14707,6.6,16933,203,50,-1951,-1640,20.3,1470.7
4524577169,1,20,5,1,9,8,13,1,1,0,0,17283,6.6,16810,205,28,-428,5,20.5,1728.3,18,3,0,8,9,7,1,0,1,0,17711,6.6,16805,213,36,428,-5,21.3,1771.1
4507095951,0,14,0,1,9,2,11,1,1,0,0,18804,7.2,19826,272,51,4607,2975,27.2,1880.4,10,3,0,2,9,2,0,0,0,0,14197,6.6,16851,197,52,-4607,-2975,19.7,1419.7
4510713012,1,24,3,0,3,3,5,0,0,0,0,15933,7.2,19079,259,52,75,536,25.9,1593.3,15,1,1,3,3,4,1,1,0,0,15858,7.2,18543,262,56,-75,-536,26.2,1585.8
4513310043,1,18,7,1,7,8,3,0,0,0,0,16863,6.8,17725,206,42,783,-301,20.6,1686.3,18,5,0,8,7,7,1,1,0,0,16080,7.0,18026,186,44,-783,301,18.6,1608.0
4527780032,1,16,3,0,1,2,0,1,1,0,0,14603,7.0,18478,232,71,670,1446,23.2,1460.3,38,3,1,2,1,5,0,0,0,0,13933,6.8,17032,197,52,-670,-1446,19.7,1393.3
4422174919,1,14,2,0,0,3,0,0,0,0,0,13954,6.8,17057,231,60,-936,-624,23.1,1395.4,18,2,1,3,0,3,0,0,0,0,14890,7.0,17681,199,47,936,624,19.9,1489.0
4512271556,1,13,3,1,11,4,8,2,1,1,1,19377,7.4,20008,233,44,3806,2161,23.3,1937.7,15,0,0,4,11,4,0,0,0,0,15571,7.0,17847,231,44,-3806,-2161,23.1,1557.1
4514844694,0,18,3,1,6,2,5,1,1,0,0,16610,7.0,18058,227,48,2044,378,22.7,1661.0,16,1,0,2,6,2,0,0,0,0,14566,7.0,17680,220,54,-2044,-378,22.0,1456.6
4500484679,0,15,2,0,5,5,9,1,0,1,0,16624,6.8,18064,208,62,1060,2796,20.8,1662.4,15,3,1,5,5,7,1,1,0,0,15564,6.6,15268,190,44,-1060,-2796,19.0,1556.4
4524924561,0,14,2,0,3,6,4,0,0,0,0,16354,7.0,17848,252,46,176,-172,25.2,1635.4,51,3,1,6,3,7,1,1,0,0,16178,6.8,18020,202,55,-176,172,20.2,1617.8
4413326513,1,35,2,0,3,5,3,0,0,0,0,15908,7.4,18487,220,60,-1194,-1133,22.0,1590.8,17,3,1,5,3,4,1,1,0,0,17102,7.2,19620,255,56,1194,1133,25.5,1710.2
4519445793,0,20,4,1,5,6,2,2,1,1,0,15304,6.6,17175,195,44,-1469,116,19.5,1530.4,17,3,0,6,5,8,0,0,0,0,16773,6.8,17059,238,46,1469,-116,23.8,1677.3
4448321721,0,18,3,1,4,8,3,2,1,1,0,15815,7.2,18069,245,41,-1110,-391,24.5,1581.5,14,7,0,8,4,10,0,0,0,0,16925,7.0,18460,229,45,1110,391,22.9,1692.5
4518690389,0,19,0,0,5,5,1,0,0,0,0,14594,6.8,17746,184,47,-1087,-108,18.4,1459.4,15,1,1,5,5,3,0,0,0,0,15681,7.0,17854,220,52,1087,108,22.0,1568.1
4521580882,1,18,3,0,5,5,3,2,1,1,0,15193,6.8,16642,208,50,-404,-419,20.8,1519.3,39,4,1,5,5,11,0,0,0,0,15597,6.8,17061,216,42,404,419,21.6,1559.7
4497827663,1,40,4,0,8,6,8,0,0,0,0,17564,7.2,18892,232,40,1156,916,23.2,1756.4,53,5,1,6,8,5,0,0,0,0,16408,7.0,17976,211,65,-1156,-916,21.1,1640.8
4509159917,0,13,1,0,8,12,8,1,1,0,0,16484,6.4,16372,176,39,-2146,-3245,17.6,1648.4,15,4,1,12,8,7,0,0,0,0,18630,7.2,19617,204,55,2146,3245,20.4,1863.0
4526108615,0,16,3,0,7,11,11,0,0,0,0,16792,6.4,16518,198,52,-2787,-2662,19.8,1679.2,13,6,1,11,7,11,2,1,1,0,19579,7.2,19180,216,63,2787,2662,21.6,1957.9
4524881120,0,15,1,0,4,5,3,1,1,0,0,15158,7.0,17680,219,52,-1529,-1177,21.9,1515.8,52,1,1,5,4,7,0,0,0,0,16687,7.2,18857,213,59,1529,1177,21.3,1668.7
4470312208,1,16,4,0,10,6,14,0,0,0,0,17769,7.2,18832,207,44,1417,1116,20.7,1776.9,14,4,1,6,10,3,1,1,0,0,16352,7.0,17716,215,58,-1417,-1116,21.5,1635.2
4524049652,1,15,2,1,9,4,10,0,0,0,0,18168,7.4,20892,254,45,2527,3473,25.4,1816.8,14,0,0,4,9,6,0,0,0,0,15641,6.8,17419,220,52,-2527,-3473,22.0,1564.1
4478110348,0,14,5,1,3,4,2,0,0,0,0,14490,6.8,17534,226,37,-1759,-2019,22.6,1449.0,41,3,0,4,3,1,1,1,0,0,16249,7.2,19553,247,58,1759,2019,24.7,1624.9
4527036536,1,81,2,0,7,6,9,0,0,0,0,15685,6.6,16091,179,34,-817,-968,17.9,1568.5,16,2,1,6,7,9,0,0,0,0,16502,6.6,17059,209,45,817,968,20.9,1650.2
4497854220,0,17,2,0,9,5,12,1,1,0,0,17525,7.0,19083,221,40,1270,365,22.1,1752.5,34,5,1,5,9,2,0,0,0,0,16255,7.4,18718,218,60,-1270,-365,21.8,1625.5
4518317987,0,18,5,0,6,5,4,0,0,0,0,15959,6.8,16675,236,40,66,-115,23.6,1595.9,19,5,1,5,6,5,1,1,0,0,15893,6.6,16790,187,47,-66,115,18.7,1589.3
4501242317,1,50,5,1,4,0,6,0,0,0,0,17339,7.2,19573,237,74,3652,1943,23.7,1733.9,17,1,0,0,4,0,1,1,0,0,13687,6.8,17630,217,68,-3652,-1943,21.7,1368.7
4525765947,0,12,3,1,4,9,6,0,0,0,0,14902,6.8,17309,198,57,-2168,-2144,19.8,1490.2,54,2,0,9,4,9,1,1,0,0,17070,7.2,19453,204,52,2168,2144,20.4,1707.0
4506279067,0,13,5,0,2,7,1,0,0,0,0,13946,6.4,16248,227,22,-2727,-2041,22.7,1394.6,19,5,1,7,2,10,1,1,0,0,16673,7.0,18289,220,58,2727,2041,22.0,1667.3
4513797565,1,16,1,1,11,5,10,1,1,0,0,19245,7.6,20286,245,60,3108,2974,24.5,1924.5,58,2,0,5,11,6,0,0,0,0,16137,6.8,17312,194,64,-3108,-2974,19.4,1613.7
4526672320,0,12,2,0,2,4,3,1,1,0,0,14120,6.4,16943,217,51,-1443,-36,21.7,1412.0,12,2,1,4,2,5,1,0,1,0,15563,6.8,16979,214,51,1443,36,21.4,1556.3
4448615908,1,151,3,0,5,4,2,2,1,1,0,15551,6.6,17239,209,52,-284,-260,20.9,1555.1,16,3,1,4,5,5,0,0,0,0,15835,6.8,17499,228,51,284,260,22.8,1583.5
4518473968,1,13,3,1,7,6,6,0,0,0,0,17106,6.8,17550,226,47,1138,558,22.6,1710.6,16,1,0,6,7,5,1,0,1,0,15968,6.8,16992,202,39,-1138,-558,20.2,1596.8
4517907047,0,16,1,1,4,10,3,0,0,0,0,15419,6.4,17517,191,43,-2636,-839,19.1,1541.9,14,2,0,10,4,9,0,0,0,0,18055,6.8,18356,225,48,2636,839,22.5,1805.5
4473277944,0,14,1,1,4,6,7,0,0,0,0,16636,7.2,18650,243,52,668,-462,24.3,1663.6,14,1,0,6,4,5,1,1,0,0,15968,7.4,19112,223,48,-668,462,22.3,1596.8
4516367790,1,46,3,0,5,7,2,0,0,0,0,14871,6.8,16941,180,47,-1682,-563,18.0,1487.1,20,1,1,7,5,9,1,1,0,0,16553,6.8,17504,191,36,1682,563,19.1,1655.3
4460492996,0,14,2,1,14,6,19,0,0,0,0,19599,7.4,19082,211,44,4085,2139,21.1,1959.9,12,0,0,6,14,6,1,1,0,0,15514,6.8,16943,188,40,-4085,-2139,18.8,1551.4
4520671984,1,16,6,1,12,6,25,1,1,0,0,19321,7.0,18437,226,42,2574,359,22.6,1932.1,15,2,0,6,12,9,0,0,0,0,16747,7.0,18078,228,56,-2574,-359,22.8,1674.7
4508032491,0,16,2,0,5,8,7,0,0,0,0,15885,6.4,16350,216,40,-1615,-1393,21.6,1588.5,16,1,1,8,5,10,2,1,1,0,17500,6.8,17743,221,52,1615,1393,22.1,1750.0
4524495637,0,35,3,0,9,5,14,0,0,0,0,16563,6.8,17202,182,56,-1292,-1426,18.2,1656.3,13,1,1,5,9,3,2,1,1,1,17855,7.0,18628,237,57,1292,1426,23.7,1785.5
4527693683,1,12,1,0,3,5,3,1,0,1,0,15341,6.8,18065,215,59,-85,1665,21.5,1534.1,16,3,1,5,3,9,1,1,0,0,15426,6.6,16400,202,40,85,-1665,20.2,1542.6
4502043539,1,19,6,0,5,5,7,1,1,0,0,16501,6.8,18178,234,50,366,84,23.4,1650.1,19,3,1,5,5,4,0,0,0,0,16135,6.8,18094,231,62,-366,-84,23.1,1613.5
4526004756,1,16,5,0,8,6,7,0,0,0,0,16684,6.6,17360,205,40,277,252,20.5,1668.4,20,6,1,6,8,9,1,1,0,0,16407,6.8,17108,202,52,-277,-252,20.2,1640.7
4499383739,1,15,16,0,7,5,11,1,0,1,0,17297,6.8,17523,196,46,1134,157,19.6,1729.7,47,4,1,5,7,4,1,1,0,0,16163,6.6,17366,238,52,-1134,-157,23.8,1616.3
4513422670,0,35,3,0,6,9,8,1,1,0,0,16978,7.2,19145,205,55,-1712,-394,20.5,1697.8,20,2,1,9,6,16,0,0,0,0,18690,7.4,19539,208,56,1712,394,20.8,1869.0
4499735549,1,30,4,0,7,3,10,1,1,0,0,16065,6.8,17018,200,53,1322,148,20.0,1606.5,40,5,1,3,7,2,0,0,0,0,14743,6.6,16870,213,35,-1322,-148,21.3,1474.3
4521347328,1,124,1,1,10,4,12,0,0,0,0,18509,7.6,20432,223,72,2974,1421,22.3,1850.9,15,1,0,4,10,5,1,1,0,0,15535,7.4,19011,213,64,-2974,-1421,21.3,1553.5
4478385556,0,13,3,1,9,11,4,0,0,0,0,17643,7.2,18331,221,55,24,483,22.1,1764.3,37,1,0,11,9,17,1,1,0,0,17619,7.0,17848,153,36,-24,-483,15.3,1761.9
4472839071,0,17,4,1,4,7,4,0,0,0,0,15025,6.6,16369,212,32,-1517,-1487,21.2,1502.5,30,7,0,7,4,5,0,0,0,0,16542,7.0,17856,221,29,1517,1487,22.1,1654.2
4522190753,0,15,3,1,11,2,11,1,1,0,0,17384,7.0,18198,202,35,3390,2090,20.2,1738.4,36,0,0,2,11,4,0,0,0,0,13994,6.6,16108,201,48,-3390,-2090,20.1,1399.4
4452362820,0,11,3,0,0,8,0,0,0,0,0,13364,6.6,16851,203,63,-5088,-3911,20.3,1336.4,17,2,1,8,0,8,2,1,1,0,18452,7.6,20762,259,60,5088,3911,25.9,1845.2
4513390810,1,51,3,0,5,4,7,2,1,1,0,16680,7.2,19095,247,62,899,969,24.7,1668.0,15,2,1,4,5,4,0,0,0,0,15781,6.8,18126,209,56,-899,-969,20.9,1578.1
4445718276,0,14,6,0,10,9,8,0,0,0,0,17145,6.8,18179,180,43,-1281,-525,18.0,1714.5,35,1,1,9,10,9,0,0,0,0,18426,7.0,18704,212,62,1281,525,21.2,1842.6
4523641483,1,15,5,0,9,8,9,0,0,0,0,17631,7.0,18106,214,41,1564,86,21.4,1763.1,16,2,1,8,9,7,0,0,0,0,16067,7.0,18020,193,47,-1564,-86,19.3,1606.7
4515266360,1,36,2,0,2,8,2,0,0,0,0,14079,7.0,17003,207,43,-3388,-1882,20.7,1407.9,16,1,1,8,2,6,1,1,0,0,17467,7.2,18885,239,44,3388,1882,23.9,1746.7
4505627084,0,19,3,1,9,8,12,1,1,0,0,17394,6.6,16652,175,56,182,-159,17.5,1739.4,16,6,0,8,9,7,0,0,0,0,17212,6.4,16811,192,48,-182,159,19.2,1721.2
4468730592,0,17,3,0,2,6,2,0,0,0,0,14868,6.8,18004,230,58,-2681,-1941,23.0,1486.8,14,1,1,6,2,6,1,1,0,0,17549,7.2,19945,269,60,2681,1941,26.9,1754.9
4520027392,1,33,4,1,3,5,2,0,0,0,0,15073,7.2,17942,198,56,-556,-442,19.8,1507.3,24,1,0,5,3,3,1,1,0,0,15629,7.2,18384,226,48,556,442,22.6,1562.9
4522858842,0,11,0,0,2,7,0,0,0,0,0,13371,6.4,15621,224,0,-3170,-2591,22.4,1337.1,12,1,1,7,2,6,1,1,0,0,16541,6.8,18212,226,40,3170,2591,22.6,1654.1
4471508213,1,15,5,1,9,0,10,1,1,0,0,18258,7.4,19948,237,67,4535,3490,23.7,1825.8,15,3,0,0,9,0,0,0,0,0,13723,6.6,16458,237,50,-4535,-3490,23.7,1372.3
4462890794,1,11,1,1,5,5,2,2,1,1,0,15443,7.0,18156,220,47,-997,-226,22.0,1544.3,11,2,0,5,5,7,0,0,0,0,16440,7.0,18382,207,52,997,226,20.7,1644.0
4520601496,1,16,1,0,8,6,10,0,0,0,0,18029,7.2,18791,199,53,2323,1699,19.9,1802.9,15,2,1,6,8,5,0,0,0,0,15706,6.8,17092,192,38,-2323,-1699,19.2,1570.6
4524019093,1,16,4,1,8,0,12,1,1,0,0,17759,7.4,19034,249,55,4250,2686,24.9,1775.9,15,0,0,0,8,0,0,0,0,0,13509,6.4,16348,223,49,-4250,-2686,22.3,1350.9
4505792941,0,14,1,0,3,6,3,0,0,0,0,14508,6.8,17217,200,48,-3968,-2461,20.0,1450.8,15,1,1,6,3,7,2,1,1,1,18476,7.2,19678,243,76,3968,2461,24.3,1847.6
4524225995,1,26,1,1,9,5,12,1,1,0,0,17501,7.0,17203,195,45,3195,1056,19.5,1750.1,14,6,0,5,9,4,0,0,0,0,14306,6.4,16147,166,36,-3195,-1056,16.6,1430.6
4518938829,1,15,5,0,4,3,6,1,1,0,0,16647,7.4,19826,227,72,744,878,22.7,1664.7,16,2,1,3,4,2,0,0,0,0,15903,7.0,18948,242,56,-744,-878,24.2,1590.3
4465356930,0,19,2,0,11,9,14,1,0,1,1,19801,6.6,17196,195,55,3315,904,19.5,1980.1,17,1,1,9,11,12,1,1,0,0,16486,6.4,16292,147,45,-3315,-904,14.7,1648.6
4493140120,1,17,7,1,4,2,2,0,0,0,0,16452,7.2,19307,273,60,1068,618,27.3,1645.2,16,4,0,2,4,4,0,0,0,0,15384,7.2,18689,253,68,-1068,-618,25.3,1538.4
4514389880,1,15,7,1,7,3,5,2,1,1,0,16742,7.4,19145,215,67,1468,932,21.5,1674.2,85,1,0,3,7,2,0,0,0,0,15274,7.2,18213,247,60,-1468,-932,24.7,1527.4
4525780580,1,108,2,1,10,5,6,1,1,0,0,18327,7.2,18553,219,62,2980,1865,21.9,1832.7,10,3,0,5,10,3,0,0,0,0,15347,6.8,16688,233,43,-2980,-1865,23.3,1534.7
4523400286,1,24,2,0,3,3,4,0,0,0,0,14940,6.6,16977,238,44,-1131,-1921,23.8,1494.0,40,12,1,3,3,2,0,0,0,0,16071,7.0,18898,247,68,1131,1921,24.7,1607.1
4459959828,1,36,1,1,3,4,2,0,0,0,0,15883,6.8,18069,229,60,-277,-123,22.9,1588.3,12,2,0,4,3,5,0,0,0,0,16160,7.0,18192,242,52,277,123,24.2,1616.0
4519837274,1,14,2,1,7,6,9,1,1,0,0,16147,6.6,17632,201,45,-666,-290,20.1,1614.7,14,3,0,6,7,7,0,0,0,0,16813,7.2,17922,217,55,666,290,21.7,1681.3
4512326355,1,12,2,1,12,5,11,2,1,1,0,18882,6.6,18137,202,57,3807,1849,20.2,1888.2,14,1,0,5,12,9,0,0,0,0,15075,6.8,16288,187,52,-3807,-1849,18.7,1507.5
4523853295,0,18,20,0,7,5,8,1,1,0,0,17711,7.0,18722,238,52,1127,628,23.8,1771.1,41,6,1,5,7,8,0,0,0,0,16584,7.0,18094,246,54,-1127,-628,24.6,1658.4
4458352494,0,17,3,0,3,11,3,0,0,0,0,14893,6.4,16350,217,48,-3410,-3134,21.7,1489.3,15,5,1,11,3,13,1,1,0,0,18303,7.4,19484,240,32,3410,3134,24.0,1830.3
4512531903,1,17,2,1,6,2,4,0,0,0,0,16412,7.0,17900,235,47,1211,751,23.5,1641.2,14,6,0,2,6,2,1,1,0,0,15201,6.6,17149,249,52,-1211,-751,24.9,1520.1
4511255731,0,12,4,0,1,8,1,1,1,0,0,13591,6.6,16284,201,56,-3754,-2371,20.1,1359.1,13,4,1,8,1,6,0,0,0,0,17345,7.2,18655,256,56,3754,2371,25.6,1734.5
4508772592,0,12,1,0,2,11,3,0,0,0,0,14384,7.0,17020,237,40,-6124,-4043,23.7,1438.4,13,2,1,11,2,8,1,1,0,0,20508,7.6,21063,252,64,6124,4043,25.2,2050.8
4522390017,1,17,4,1,4,3,4,0,0,0,0,15202,6.8,17438,215,53,145,-729,21.5,1520.2,49,2,0,3,4,2,1,0,1,0,15057,6.8,18167,247,60,-145,729,24.7,1505.7
4510701334,0,17,2,0,2,8,1,1,0,1,0,14154,6.8,17350,206,60,-3597,-2757,20.6,1415.4,16,4,1,8,2,5,1,1,0,0,17751,7.2,20107,243,56,3597,2757,24.3,1775.1
4519894439,0,39,3,1,5,5,5,1,1,0,0,17613,7.2,19706,251,76,914,1227,25.1,1761.3,15,5,0,5,5,7,0,0,0,0,16699,7.0,18479,224,50,-914,-1227,22.4,1669.9
4500567604,1,16,5,1,5,4,4,0,0,0,0,15832,7.0,17807,225,40,-386,-775,22.5,1583.2,17,2,0,4,5,4,0,0,0,0,16218,7.0,18582,244,66,386,775,24.4,1621.8
4500426573,0,17,3,0,3,8,3,0,0,0,0,15015,6.8,17386,216,60,-2327,-2301,21.6,1501.5,75,3,1,8,3,8,1,0,1,0,17342,7.2,19687,230,52,2327,2301,23.0,1734.2
4519920024,0,14,3,0,2,5,4,0,0,0,0,13886,6.6,17234,203,45,-2820,-2751,20.3,1388.6,17,3,1,5,2,1,1,1,0,0,16706,7.4,19985,255,72,2820,2751,25.5,1670.6
4496314087,1,17,3,1,9,4,9,1,1,0,0,17284,7.0,18315,238,44,2670,1589,23.8,1728.4,15,3,0,4,9,3,0,0,0,0,14614,6.6,16726,208,42,-2670,-1589,20.8,1461.4
4518960621,1,15,2,0,6,8,9,0,0,0,0,17279,6.8,17886,233,36,220,-740,23.3,1727.9,14,1,1,8,6,10,1,1,0,0,17059,7.2,18626,211,56,-220,740,21.1,1705.9
4524189570,1,17,4,1,5,2,6,2,1,1,0,16053,6.8,17406,218,51,1703,1696,21.8,1605.3,15,2,0,2,5,2,0,0,0,0,14350,6.4,15710,206,48,-1703,-1696,20.6,1435.0
4519232603,1,15,4,1,11,6,21,1,1,0,0,17597,6.8,17045,190,50,2534,2539,19.0,1759.7,12,1,0,6,11,5,0,0,0,0,15063,6.2,14506,188,32,-2534,-2539,18.8,1506.3
4527461215,0,11,3,1,8,7,10,0,0,0,0,17122,7.0,17535,204,51,312,-1396,20.4,1712.2,47,2,0,7,8,7,1,1,0,0,16810,7.0,18931,211,51,-312,1396,21.1,1681.0
4426718140,1,24,3,1,5,8,7,1,0,1,0,16137,6.6,17271,219,51,-80,-155,21.9,1613.7,16,6,0,8,5,9,1,1,0,0,16217,7.0,17426,205,40,80,155,20.5,1621.7
4514035476,1,20,3,1,9,0,9,1,1,0,0,17835,7.2,18812,231,52,4277,3340,23.1,1783.5,80,6,0,0,9,0,1,0,1,0,13558,6.2,15472,207,47,-4277,-3340,20.7,1355.8
4519793588,1,16,1,1,6,6,9,0,0,0,0,16651,6.6,16985,218,48,1167,-461,21.8,1665.1,16,4,0,6,6,4,1,1,0,0,15484,6.8,17446,207,48,-1167,461,20.7,1548.4
4507071282,0,14,19,0,2,11,2,0,0,0,0,13671,6.8,16878,202,47,-5751,-4242,20.2,1367.1,62,4,1,11,2,12,1,1,0,0,19422,7.6,21120,259,48,5751,4242,25.9,1942.2
4490055696,0,48,4,0,5,10,8,1,1,0,0,14974,6.2,15389,201,24,-4646,-3186,20.1,1497.4,14,3,1,10,5,17,0,0,0,1,19620,7.2,18575,201,64,4646,3186,20.1,1962.0
4470054451,1,12,4,1,10,4,14,1,1,0,0,18374,7.6,20120,229,51,3823,3324,22.9,1837.4,15,2,0,4,10,4,0,0,0,0,14551,6.6,16796,176,52,-3823,-3324,17.6,1455.1
4500173548,1,18,3,1,7,8,9,1,0,1,0,16276,7.0,17562,195,40,-1216,-629,19.5,1627.6,16,3,0,8,7,10,0,0,0,0,17492,7.0,18191,210,76,1216,629,21.0,1749.2
4507610115,1,16,2,1,6,0,7,0,0,0,0,16144,7.0,18236,199,49,1594,477,19.9,1614.4,37,2,0,0,6,0,1,1,0,0,14550,7.0,17759,257,60,-1594,-477,25.7,1455.0
4446002931,0,15,3,1,3,5,6,0,0,0,0,14538,6.8,16871,218,39,-2335,-2787,21.8,1453.8,19,3,0,5,3,6,1,1,0,0,16873,7.4,19658,236,80,2335,2787,23.6,1687.3
4519414547,1,19,0,0,13,4,11,1,1,0,0,20127,7.0,19575,234,48,6202,5368,23.4,2012.7,16,1,1,4,13,5,0,0,0,0,13925,6.0,14207,175,28,-6202,-5368,17.5,1392.5
4459009838,1,56,2,0,6,6,7,0,0,0,0,16339,7.0,17799,205,54,297,1283,20.5,1633.9,32,2,1,6,6,7,0,0,0,0,16042,6.4,16516,225,47,-297,-1283,22.5,1604.2
4504983497,1,15,3,0,7,8,9,0,0,0,0,16304,6.4,16307,169,44,-2336,-1468,16.9,1630.4,13,0,1,8,7,9,1,0,1,2,18640,7.0,17775,211,42,2336,1468,21.1,1864.0
4526360313,1,12,4,1,10,4,6,0,0,0,0,17890,7.2,18682,226,45,2961,2627,22.6,1789.0,34,1,0,4,10,6,0,0,0,0,14929,6.6,16055,207,26,-2961,-2627,20.7,1492.9
4521912721,0,14,7,0,1,2,2,0,0,0,0,15231,7.0,18127,262,52,-13,-378,26.2,1523.1,15,1,1,2,1,3,1,1,0,0,15244,7.0,18505,232,67,13,378,23.2,1524.4
4499426958,0,16,2,1,5,7,4,0,0,0,0,15538,6.8,16787,207,46,-707,-1088,20.7,1553.8,41,2,0,7,5,11,0,0,0,0,16245,6.8,17875,208,41,707,1088,20.8,1624.5
4518579110,0,19,3,1,9,7,8,0,0,0,0,19087,7.2,19779,250,60,2350,1981,25.0,1908.7,17,5,0,7,9,7,1,1,0,0,16737,7.0,17798,216,42,-2350,-1981,21.6,1673.7
4469976070,1,14,2,1,7,6,8,1,1,0,0,15632,6.2,15789,196,32,-1339,-2802,19.6,1563.2,17,2,0,6,7,8,1,0,1,0,16971,7.0,18591,216,67,1339,2802,21.6,1697.1
4459406549,1,14,4,0,4,3,3,0,0,0,0,16101,7.4,19176,266,56,884,1028,26.6,1610.1,15,2,1,3,4,3,1,1,0,0,15217,7.0,18148,236,36,-884,-1028,23.6,1521.7
4521534899,1,16,5,1,3,7,5,0,0,0,0,15142,7.0,17554,235,40,-1851,-1813,23.5,1514.2,21,3,0,7,3,9,2,1,1,0,16993,7.2,19367,242,59,1851,1813,24.2,1699.3
4525352232,1,46,4,1,9,5,11,2,1,1,0,17498,7.0,18424,209,52,1885,1636,20.9,1749.8,17,3,0,5,9,3,0,0,0,0,15613,6.6,16788,200,60,-1885,-1636,20.0,1561.3
4502663674,0,14,4,1,6,4,7,0,0,0,0,16624,6.8,18473,208,52,115,-256,20.8,1662.4,15,4,0,4,6,6,2,1,1,0,16509,7.0,18729,239,68,-115,256,23.9,1650.9
4462200900,0,37,5,1,9,6,13,0,0,0,0,17187,7.0,18709,199,47,619,1021,19.9,1718.7,19,3,0,6,9,6,1,1,0,0,16568,6.8,17688,214,67,-619,-1021,21.4,1656.8
4515557026,1,14,6,0,5,6,2,1,0,1,0,15558,6.6,17405,221,47,-209,800,22.1,1555.8,19,5,1,6,5,8,1,1,0,0,15767,6.8,16605,185,44,209,-800,18.5,1576.7
4521245361,0,16,3,1,2,10,1,0,0,0,0,13544,6.2,15367,206,18,-5820,-4066,20.6,1354.4,15,2,0,10,2,8,0,0,0,0,19364,7.2,19433,255,77,5820,4066,25.5,1936.4
4527675281,0,17,3,0,3,2,6,2,1,1,0,15097,7.0,17461,226,40,-971,-1447,22.6,1509.7,38,2,1,2,3,2,0,0,0,0,16068,7.2,18908,253,57,971,1447,25.3,1606.8
4468238235,1,20,15,1,10,7,16,1,1,0,0,17953,7.0,18823,190,60,1058,1196,19.0,1795.3,48,1,0,7,10,9,0,0,0,0,16895,6.6,17627,206,47,-1058,-1196,20.6,1689.5
4471380498,1,38,4,1,9,3,6,0,0,0,1,19574,7.6,20323,237,59,4279,3408,23.7,1957.4,20,5,0,3,9,6,0,0,0,0,15295,6.8,16915,234,58,-4279,-3408,23.4,1529.5
4471320311,0,23,5,1,10,6,12,0,0,0,0,17374,6.8,17514,214,39,562,243,21.4,1737.4,17,2,0,6,10,9,1,1,0,0,16812,6.8,17271,204,47,-562,-243,20.4,1681.2
4525345831,1,17,0,1,7,6,4,0,0,0,0,16466,6.8,16798,185,52,59,-305,18.5,1646.6,12,4,0,6,7,10,2,1,1,0,16407,7.0,17103,210,53,-59,305,21.0,1640.7
4489653837,1,17,1,1,8,4,9,1,1,0,0,17773,7.0,19376,235,56,2898,1941,23.5,1777.3,36,1,0,4,8,4,0,0,0,0,14875,7.0,17435,181,57,-2898,-1941,18.1,1487.5
4457538787,0,19,1,0,2,1,3,1,1,0,0,14494,6.8,18008,244,47,-618,-413,24.4,1449.4,38,4,1,1,2,2,0,0,0,0,15112,6.8,18421,247,60,618,413,24.7,1511.2
4523517991,0,12,2,0,2,14,0,0,0,0,0,13229,6.4,15040,177,46,-6460,-5383,17.7,1322.9,14,4,1,14,2,11,0,0,0,0,19689,7.4,20423,233,44,6460,5383,23.3,1968.9
4482205629,0,18,2,0,6,5,10,0,0,0,0,16111,6.4,16723,219,44,1039,-79,21.9,1611.1,14,3,1,5,6,3,1,1,0,0,15072,6.8,16802,213,48,-1039,79,21.3,1507.2
4521641532,1,12,4,1,6,6,3,0,0,0,0,16701,6.8,17820,237,40,882,450,23.7,1670.1,18,2,0,6,6,5,0,0,0,0,15819,6.8,17370,192,56,-882,-450,19.2,1581.9
4492525886,0,13,1,0,3,6,1,0,0,0,0,14423,6.6,16966,219,48,-2602,-1426,21.9,1442.3,15,4,1,6,3,6,0,0,0,0,17025,7.2,18392,249,54,2602,1426,24.9,1702.5
4471437748,1,18,6,0,6,4,5,1,1,0,0,17002,7.2,18755,218,71,2536,3339,21.8,1700.2,14,3,1,4,6,0,1,0,1,0,14466,6.4,15416,210,35,-2536,-3339,21.0,1446.6
4525208394,0,17,3,0,5,3,5,1,0,1,0,16176,7.2,18728,221,60,543,1065,22.1,1617.6,10,4,1,3,5,4,0,0,0,0,15633,6.8,17663,257,51,-543,-1065,25.7,1563.3
4494997427,0,50,2,1,4,4,4,0,0,0,0,15514,6.6,16759,223,40,249,182,22.3,1551.4,17,3,0,4,4,5,1,1,0,0,15265,6.6,16577,204,45,-249,-182,20.4,1526.5
4515840054,1,39,3,1,7,4,7,0,0,0,0,17771,7.8,20856,217,81,1958,3140,21.7,1777.1,17,7,0,4,7,6,1,1,0,0,15813,6.8,17716,239,49,-1958,-3140,23.9,1581.3
4516488092,1,35,2,1,5,4,6,0,0,0,0,15411,7.0,17827,215,39,-43,-152,21.5,1541.1,11,4,0,4,5,3,0,0,0,0,15454,7.0,17979,224,54,43,152,22.4,1545.4
4513245442,0,17,0,1,4,3,3,1,0,1,0,15645,7.2,18594,227,56,929,1095,22.7,1564.5,13,5,0,3,4,2,1,1,0,0,14716,6.6,17499,205,67,-929,-1095,20.5,1471.6
4493178724,1,13,0,1,9,12,8,1,0,1,0,17778,7.0,18403,204,48,-628,-864,20.4,1777.8,18,3,0,12,9,12,1,1,0,0,18406,7.2,19267,197,54,628,864,19.7,1840.6
4516790351,0,39,1,0,3,12,3,0,0,0,0,14277,7.0,17550,201,53,-5802,-3559,20.1,1427.7,12,4,1,12,3,9,1,1,0,0,20079,7.6,21109,240,58,5802,3559,24.0,2007.9
4507851254,1,52,2,0,6,5,12,0,0,0,1,17107,6.8,17665,215,43,-1661,-1259,21.5,1710.7,19,3,1,5,6,4,2,1,1,2,18768,7.0,18924,239,71,1661,1259,23.9,1876.8
4521050859,1,21,2,0,3,4,1,0,0,0,0,14202,6.8,16773,212,37,-2263,-1397,21.2,1420.2,14,6,1,4,3,4,1,1,0,0,16465,6.8,18170,240,60,2263,1397,24.0,1646.5
4475955014,1,18,1,0,8,5,8,1,1,0,0,16469,7.0,18105,192,46,248,582,19.2,1646.9,15,2,1,5,8,10,0,0,0,0,16221,6.6,17523,225,52,-248,-582,22.5,1622.1
4517237029,0,19,5,1,6,9,5,0,0,0,0,16534,7.0,17934,231,52,-1256,-844,23.1,1653.4,17,3,0,9,6,9,1,0,1,0,17790,7.2,18778,235,32,1256,844,23.5,1779.0
4499715260,0,5,0,0,2,15,2,0,0,0,0,13462,5.4,12212,130,42,-9152,-8290,13.0,1346.2,17,1,1,15,2,12,0,0,0,1,22614,7.4,20502,247,80,9152,8290,24.7,2261.4
4490257266,0,13,0,1,6,9,5,1,1,0,0,15550,6.8,17134,191,44,-1467,-1916,19.1,1555.0,15,2,0,9,6,5,0,0,0,0,17017,7.2,19050,213,40,1467,1916,21.3,1701.7
4479922786,0,16,2,0,7,8,7,0,0,0,0,16093,6.4,16567,175,40,-1805,-2047,17.5,1609.3,32,6,1,8,7,9,1,1,0,0,17898,6.8,18614,238,48,1805,2047,23.8,1789.8
4489533788,1,16,2,0,5,4,6,0,0,0,0,16721,7.0,18046,237,53,1788,2424,23.7,1672.1,15,2,1,4,5,6,0,0,0,0,14933,6.4,15622,210,42,-1788,-2424,21.0,1493.3
4517908565,1,14,2,1,12,3,13,1,1,0,0,19626,7.6,20682,228,68,4400,3092,22.8,1962.6,13,3,0,3,12,2,0,0,0,0,15226,6.6,17590,223,48,-4400,-3092,22.3,1522.6
4462515361,1,16,1,0,7,5,7,1,1,0,0,16346,6.8,17401,227,52,-90,102,22.7,1634.6,14,2,1,5,7,5,0,0,0,0,16436,7.0,17299,234,40,90,-102,23.4,1643.6
4510784617,0,13,19,1,5,8,2,0,0,0,0,16003,7.0,18252,221,50,5,185,22.1,1600.3,45,2,0,8,5,7,1,1,0,0,15998,6.8,18067,189,45,-5,-185,18.9,1599.8
4468568554,0,13,2,0,7,7,8,0,0,0,0,17148,7.0,17427,226,52,1084,658,22.6,1714.8,15,3,1,7,7,8,2,1,1,0,16064,6.4,16769,207,40,-1084,-658,20.7,1606.4
4522118133,0,9,2,1,6,5,3,0,0,0,0,16961,7.2,18707,240,58,1155,868,24.0,1696.1,15,2,0,5,6,6,1,1,0,0,15806,6.8,17839,201,53,-1155,-868,20.1,1580.6
4477447417,1,48,12,0,6,9,7,0,0,0,0,15993,6.8,18112,226,48,-1607,-215,22.6,1599.3,30,8,1,9,6,13,1,1,0,0,17600,7.0,18327,217,56,1607,215,21.7,1760.0
4526560137,0,17,8,0,2,6,2,0,0,0,0,14667,6.6,16353,230,44,-2939,-2323,23.0,1466.7,19,5,1,6,2,7,0,0,0,0,17606,7.2,18676,246,72,2939,2323,24.6,1760.6
4481184386,0,50,1,0,6,8,9,0,0,0,0,16145,6.8,17448,215,44,-1962,-684,21.5,1614.5,16,4,1,8,6,12,0,0,0,0,18107,7.0,18132,223,54,1962,684,22.3,1810.7
4506010856,0,16,2,1,3,7,2,0,0,0,0,16025,7.0,17956,214,56,-44,-357,21.4,1602.5,105,4,0,7,3,5,1,1,0,0,16069,7.0,18313,220,44,44,357,22.0,1606.9
4521679491,1,18,0,1,11,1,12,1,0,1,0,18137,7.0,18617,207,51,4177,2615,20.7,1813.7,35,2,0,1,11,0,0,0,0,0,13960,6.4,16002,205,54,-4177,-2615,20.5,1396.0
4458303184,1,10,2,1,7,4,8,2,1,1,0,16849,6.6,16993,205,38,1651,402,20.5,1684.9,18,2,0,4,7,7,0,0,0,0,15198,6.6,16591,207,42,-1651,-402,20.7,1519.8
4470997235,1,17,2,1,8,5,9,0,0,0,0,17234,7.2,18799,228,52,1474,1001,22.8,1723.4,16,0,0,5,8,5,0,0,0,0,15760,6.8,17798,201,60,-1474,-1001,20.1,1576.0
4484160987,1,16,2,0,3,6,6,1,1,0,0,15335,6.6,17217,219,49,-839,-82,21.9,1533.5,14,2,1,6,3,5,0,0,0,0,16174,7.0,17299,225,36,839,82,22.5,1617.4
4527339142,0,48,1,1,5,4,5,1,1,0,0,15527,6.4,16705,185,44,625,-873,18.5,1552.7,15,1,0,4,5,2,0,0,0,0,14902,7.0,17578,226,44,-625,873,22.6,1490.2
4519902539,0,40,4,0,6,6,4,0,0,0,0,15823,7.0,18209,214,52,-1482,256,21.4,1582.3,17,3,1,6,6,8,1,1,0,0,17305,6.8,17953,247,62,1482,-256,24.7,1730.5
4520945917,1,14,1,1,12,6,17,1,1,0,0,18901,7.0,17651,210,40,2699,1015,21.0,1890.1,13,1,0,6,12,8,0,0,0,0,16202,6.6,16636,203,48,-2699,-1015,20.3,1620.2
4477337521,1,21,4,0,8,6,12,1,1,0,0,18352,7.2,18953,242,42,1909,1099,24.2,1835.2,14,5,1,6,8,5,0,0,0,0,16443,7.0,17854,225,40,-1909,-1099,22.5,1644.3
4473438026,1,17,4,1,8,4,11,1,1,0,0,17117,7.0,18326,204,52,1810,1012,20.4,1711.7,19,4,0,4,8,6,0,0,0,0,15307,6.6,17314,211,44,-1810,-1012,21.1,1530.7
4502985762,1,15,1,1,4,1,4,0,0,0,0,16008,7.2,19253,247,45,344,1298,24.7,1600.8,15,3,0,1,4,2,0,0,0,0,15664,7.0,17955,264,52,-344,-1298,26.4,1566.4
4459895934,1,33,3,1,8,7,7,1,1,0,0,17722,7.2,18555,224,43,1137,-609,22.4,1772.2,53,4,0,7,8,6,1,0,1,0,16585,7.2,19164,225,47,-1137,609,22.5,1658.5
4473660797,0,15,0,0,10,9,13,2,1,1,0,17145,7.0,17904,192,45,-1464,-454,19.2,1714.5,15,3,1,9,10,5,0,0,0,0,18609,7.2,18358,226,46,1464,454,22.6,1860.9
4473787682,0,16,4,1,8,7,8,0,0,0,0,17415,6.8,18304,239,48,1158,-618,23.9,1741.5,17,3,0,7,8,4,1,1,0,0,16257,7.2,18922,184,84,-1158,618,18.4,1625.7
4520956712,0,13,1,0,7,5,8,0,0,0,0,17160,7.0,18450,221,42,2613,1450,22.1,1716.0,13,3,1,5,7,3,1,1,0,0,14547,6.4,17000,213,36,-2613,-1450,21.3,1454.7
4523109527,0,91,2,1,3,5,3,0,0,0,0,15001,7.0,17799,218,48,-685,-1871,21.8,1500.1,16,3,0,5,3,2,1,0,1,0,15686,7.2,19670,214,64,685,1871,21.4,1568.6
4508364030,1,17,0,1,8,10,7,0,0,0,0,16427,6.8,17468,191,43,-3441,-1876,19.1,1642.7,10,4,0,10,8,15,0,0,0,0,19868,7.2,19344,259,40,3441,1876,25.9,1986.8
4519147034,0,17,2,0,7,13,11,0,0,0,0,15541,6.2,15120,180,45,-3711,-2987,18.0,1554.1,13,3,1,13,7,16,0,0,0,0,19252,7.0,18107,207,45,3711,2987,20.7,1925.2
4463024546,1,63,4,0,2,4,2,0,0,0,0,15264,7.0,17806,217,64,-286,606,21.7,1526.4,16,1,1,4,2,6,2,1,1,0,15550,6.8,17200,235,47,286,-606,23.5,1555.0
4524995647,1,18,4,1,9,4,6,2,1,1,0,18200,7.2,19696,247,44,2756,2028,24.7,1820.0,16,3,0,4,9,5,0,0,0,0,15444,7.0,17668,208,51,-2756,-2028,20.8,1544.4
4475739252,1,18,6,1,1,0,1,1,0,1,0,14755,6.8,18264,223,59,1371,2146,22.3,1475.5,22,5,0,0,1,0,0,0,0,0,13384,6.2,16118,230,41,-1371,-2146,23.0,1338.4
4511977578,0,17,1,0,2,10,0,1,0,1,0,14311,6.8,17028,217,56,-5821,-3230,21.7,1431.1,43,5,1,10,2,11,1,1,0,1,20132,7.2,20258,251,68,5821,3230,25.1,2013.2
4520535249,0,14,4,0,3,7,3,2,1,1,0,14249,6.6,16596,220,38,-3144,-3235,22.0,1424.9,21,5,1,7,3,4,0,0,0,0,17393,7.2,19831,255,80,3144,3235,25.5,1739.3
4472795984,1,18,1,1,10,8,7,0,0,0,0,18380,7.2,18318,220,42,1938,1013,22.0,1838.0,12,2,0,8,10,9,0,0,0,0,16442,6.8,17305,189,48,-1938,-1013,18.9,1644.2
4458570430,1,18,2,1,4,5,5,1,1,0,0,16086,6.8,17616,222,56,842,-663,22.2,1608.6,17,0,0,5,4,5,0,0,0,0,15244,7.0,18279,201,44,-842,663,20.1,1524.4
4483840254,1,18,5,0,9,6,8,2,1,1,0,18060,7.4,19784,241,52,1982,2243,24.1,1806.0,14,6,1,6,9,5,0,0,0,0,16078,6.6,17541,206,48,-1982,-2243,20.6,1607.8
4504166210,1,250,4,1,12,10,12,1,0,1,0,19704,7.0,18253,209,44,3067,503,20.9,1970.4,16,1,0,10,12,6,1,1,0,0,16637,6.8,17750,174,56,-3067,-503,17.4,1663.7
4522505411,0,14,16,0,3,9,2,0,0,0,0,14539,6.4,16806,213,40,-3900,-3550,21.3,1453.9,42,2,1,9,3,8,1,1,0,0,18439,7.6,20356,255,51,3900,3550,25.5,1843.9
4524882878,1,18,2,1,7,5,5,1,1,0,0,16496,7.0,18201,202,55,1744,1187,20.2,1649.6,15,5,0,5,7,5,0,0,0,0,14752,6.6,17014,209,36,-1744,-1187,20.9,1475.2
4447414095,0,17,2,0,6,8,6,0,0,0,0,15983,7.2,19337,233,42,-1231,496,23.3,1598.3,13,2,1,8,6,11,0,0,0,0,17214,7.4,18841,201,52,1231,-496,20.1,1721.4
4518235291,0,14,3,0,6,6,7,1,1,0,0,15814,6.8,17161,205,49,-1530,-922,20.5,1581.4,20,2,1,6,6,6,1,0,1,0,17344,7.0,18083,252,48,1530,922,25.2,1734.4
4465992813,1,17,1,1,7,4,9,0,0,0,0,17180,7.0,17511,219,46,1618,934,21.9,1718.0,16,3,0,4,7,5,1,1,0,0,15562,6.8,16577,195,60,-1618,-934,19.5,1556.2
4479522740,0,14,4,1,5,7,6,0,0,0,0,15742,6.8,17327,228,36,-1964,-3104,22.8,1574.2,19,2,0,7,5,6,1,1,0,0,17706,7.6,20431,241,76,1964,3104,24.1,1770.6
4520341861,1,17,4,0,1,8,0,1,1,0,0,13493,6.6,16560,218,44,-3700,-2221,21.8,1349.3,16,5,1,8,1,8,0,0,0,0,17193,7.0,18781,229,39,3700,2221,22.9,1719.3
4522111616,0,14,4,0,5,10,4,0,0,0,0,15102,6.4,16437,196,36,-3397,-2282,19.6,1510.2,22,2,1,10,5,12,1,0,1,0,18499,7.0,18719,225,49,3397,2282,22.5,1849.9
4509570260,0,19,4,0,1,6,1,0,0,0,0,15459,7.0,18187,243,71,-2483,-1894,24.3,1545.9,18,5,1,6,1,7,2,1,1,0,17942,7.4,20081,254,72,2483,1894,25.4,1794.2
4465014054,0,25,3,1,3,3,3,0,0,0,0,15365,6.8,17502,250,49,-528,-1130,25.0,1536.5,19,6,0,3,3,4,1,1,0,0,15893,7.0,18632,259,55,528,1130,25.9,1589.3
4526459511,1,18,7,1,5,2,5,1,0,1,0,15360,7.2,18594,207,47,818,1913,20.7,1536.0,15,6,0,2,5,3,1,1,0,0,14542,6.6,16681,224,57,-818,-1913,22.4,1454.2
4525788631,0,16,5,1,6,12,8,1,1,0,0,16039,6.6,16635,198,36,-2088,-2153,19.8,1603.9,27,6,0,12,6,15,0,0,0,0,18127,7.0,18788,201,48,2088,2153,20.1,1812.7
4500380908,0,14,1,1,5,7,2,1,0,1,1,17469,6.6,17964,229,53,1432,-889,22.9,1746.9,13,3,0,7,5,6,1,1,0,0,16037,7.2,18853,203,64,-1432,889,20.3,1603.7
4520794525,0,44,4,0,6,8,7,0,0,0,0,16295,6.8,17588,222,47,-1271,-364,22.2,1629.5,11,4,1,8,6,10,1,1,0,0,17566,6.8,17952,219,47,1271,364,21.9,1756.6
4514495149,1,14,1,1,7,10,5,2,1,1,1,17637,6.8,17342,196,56,-430,-1028,19.6,1763.7,14,2,0,10,7,16,0,0,0,0,18067,7.2,18370,210,37,430,1028,21.0,1806.7
4518841183,0,13,3,1,4,4,2,0,0,0,0,16003,6.8,17739,226,56,353,-160,22.6,1600.3,15,1,0,4,4,5,1,1,0,0,15650,6.8,17899,209,59,-353,160,20.9,1565.0
4526382734,0,11,2,0,4,8,4,0,0,0,0,15700,7.2,17892,190,59,-2943,-1203,19.0,1570.0,14,1,1,8,4,6,2,1,1,1,18643,7.2,19095,225,45,2943,1203,22.5,1864.3
4520942690,0,14,4,0,6,6,6,0,0,0,0,16158,7.0,17652,240,32,197,1241,24.0,1615.8,20,4,1,6,6,10,0,0,0,0,15961,6.6,16411,205,52,-197,-1241,20.5,1596.1
4513514053,0,14,3,0,4,6,3,1,1,0,0,14826,6.8,17334,206,59,-2286,-926,20.6,1482.6,15,1,1,6,4,6,0,0,0,0,17112,6.8,18260,232,50,2286,926,23.2,1711.2
4523613345,0,39,4,1,7,5,9,1,1,0,0,17456,7.0,17732,261,47,1480,721,26.1,1745.6,18,2,0,5,7,7,0,0,0,0,15976,6.6,17011,209,52,-1480,-721,20.9,1597.6
4486569835,0,17,3,0,2,6,1,0,0,0,0,14207,6.6,16373,211,48,-2723,-1062,21.1,1420.7,20,1,1,6,2,7,1,1,0,0,16930,6.8,17435,208,57,2723,1062,20.8,1693.0
4523634047,0,14,0,0,3,5,4,1,0,1,1,16250,6.6,16288,215,48,154,-979,21.5,1625.0,13,1,1,5,3,11,1,1,0,0,16096,6.8,17267,230,51,-154,979,23.0,1609.6
4520039932,1,23,4,0,5,5,4,1,1,0,0,15787,6.8,17255,209,63,833,383,20.9,1578.7,43,2,1,5,5,10,0,0,0,0,14954,6.6,16872,179,36,-833,-383,17.9,1495.4
4520572542,1,18,3,0,5,5,10,1,1,0,0,16138,6.6,16397,208,54,-732,-813,20.8,1613.8,17,0,1,5,5,4,1,0,1,1,16870,6.8,17210,218,40,732,813,21.8,1687.0
4503927654,0,77,4,0,2,7,2,0,0,0,0,13598,6.2,15349,189,45,-3892,-2725,18.9,1359.8,18,1,1,7,2,7,1,1,0,0,17490,7.0,18074,223,52,3892,2725,22.3,1749.0
4489477111,1,20,1,0,5,3,4,1,1,0,0,16513,7.0,18334,249,52,897,806,24.9,1651.3,12,4,1,3,5,5,0,0,0,0,15616,6.8,17528,201,76,-897,-806,20.1,1561.6
4523717374,1,16,3,1,9,3,9,0,0,0,0,17503,7.2,18043,204,59,2471,827,20.4,1750.3,40,2,0,3,9,4,1,1,0,0,15032,6.8,17216,212,51,-2471,-827,21.2,1503.2
4516355012,0,14,1,1,8,12,5,1,0,1,0,16093,7.0,16927,154,53,-3195,-953,15.4,1609.3,12,2,0,12,8,13,0,0,0,0,19288,6.8,17880,213,46,3195,953,21.3,1928.8
4525368268,1,18,4,1,6,4,6,0,0,0,0,16765,7.0,19056,201,46,1711,1464,20.1,1676.5,14,3,0,4,6,2,1,1,0,0,15054,6.6,17592,240,49,-1711,-1464,24.0,1505.4
4459271455,1,14,4,0,13,6,19,1,0,1,0,20617,7.4,19936,240,56,3183,1321,24.0,2061.7,19,1,1,6,13,7,1,1,0,0,17434,7.0,18615,235,72,-3183,-1321,23.5,1743.4
4499396422,1,40,6,1,4,4,8,0,0,0,0,15947,6.8,17352,231,41,247,-1191,23.1,1594.7,17,2,0,4,4,5,1,1,0,0,15700,6.8,18543,219,75,-247,1191,21.9,1570.0
4412895789,0,24,0,0,8,11,9,0,0,0,0,16655,7.0,17831,222,44,-1806,-588,22.2,1665.5,13,3,1,11,8,13,2,1,1,0,18461,7.0,18419,215,55,1806,588,21.5,1846.1
4517786816,1,16,4,0,6,5,5,0,0,0,0,17065,7.4,19124,257,47,1525,873,25.7,1706.5,14,3,1,5,6,5,2,1,1,0,15540,7.0,18251,189,51,-1525,-873,18.9,1554.0
4507088738,0,40,1,0,4,6,3,1,0,1,0,15505,6.8,18109,215,40,-875,-363,21.5,1550.5,12,4,1,6,4,4,1,1,0,0,16380,7.2,18472,232,48,875,363,23.2,1638.0
4521085954,0,12,1,0,6,7,8,0,0,0,0,16260,6.8,17081,197,37,-2025,-1774,19.7,1626.0,50,1,1,7,6,11,1,0,1,1,18285,7.0,18855,193,59,2025,1774,19.3,1828.5
4516572931,1,13,1,1,9,3,9,2,1,1,0,19027,7.2,19029,247,41,4616,2050,24.7,1902.7,12,2,0,3,9,1,0,0,0,0,14411,6.6,16979,187,54,-4616,-2050,18.7,1441.1
4517750009,1,12,2,1,6,7,9,1,1,0,0,16815,7.2,17824,235,48,683,-208,23.5,1681.5,15,0,0,7,6,12,1,0,1,0,16132,6.8,18032,179,48,-683,208,17.9,1613.2
4519347640,0,17,1,1,6,9,2,0,0,0,0,15498,6.6,16711,201,47,-1384,-853,20.1,1549.8,16,2,0,9,6,9,1,1,0,0,16882,6.6,17564,190,64,1384,853,19.0,1688.2
4514158215,0,34,1,1,9,5,10,1,1,0,0,16915,7.0,17888,198,55,649,-103,19.8,1691.5,12,2,0,5,9,5,0,0,0,0,16266,6.8,17991,197,60,-649,103,19.7,1626.6
4441621695,1,13,1,0,6,7,7,1,1,0,0,16564,7.0,17725,222,48,-850,-256,22.2,1656.4,18,2,1,7,6,7,1,0,1,0,17414,7.0,17981,201,56,850,256,20.1,1741.4
4486673822,0,15,3,0,4,7,5,0,0,0,0,15535,6.8,18068,214,56,-1608,-572,21.4,1553.5,16,1,1,7,4,9,2,1,1,0,17143,7.0,18640,220,59,1608,572,22.0,1714.3
4500662035,0,14,4,1,7,2,6,0,0,0,0,16315,7.0,18067,201,60,1167,510,20.1,1631.5,17,2,0,2,7,2,0,0,0,0,15148,6.8,17557,240,59,-1167,-510,24.0,1514.8
4518075539,1,20,3,0,7,8,5,1,0,1,0,16294,6.8,17489,182,58,-1318,-627,18.2,1629.4,17,3,1,8,7,7,0,0,0,0,17612,6.8,18116,237,44,1318,627,23.7,1761.2
4458849950,0,16,4,1,6,5,5,0,0,0,0,16489,6.6,17669,237,59,1212,1107,23.7,1648.9,14,4,0,5,6,6,1,1,0,0,15277,6.6,16562,196,60,-1212,-1107,19.6,1527.7
4513537604,0,17,3,0,10,12,10,0,0,0,0,17517,7.4,19291,179,56,-1567,505,17.9,1751.7,15,3,1,12,10,13,0,0,0,0,19084,7.0,18786,219,32,1567,-505,21.9,1908.4
4494430397,0,32,3,1,5,9,3,0,0,0,0,15761,6.8,16587,200,36,-1632,-1461,20.0,1576.1,13,7,0,9,5,7,0,0,0,0,17393,7.0,18048,212,28,1632,1461,21.2,1739.3
4520599588,0,34,0,0,8,10,15,1,1,0,0,17134,6.8,17579,171,66,-840,949,17.1,1713.4,14,3,1,10,8,11,0,0,0,0,17974,6.8,16630,214,49,840,-949,21.4,1797.4
4524403652,1,12,2,1,7,6,5,1,1,0,0,17051,7.0,18864,246,44,1909,2436,24.6,1705.1,16,0,0,6,7,8,0,0,0,0,15142,6.4,16428,196,40,-1909,-2436,19.6,1514.2
4518920963,0,68,2,0,4,5,8,0,0,0,0,15594,7.0,17492,233,52,366,1230,23.3,1559.4,42,5,1,5,4,4,1,1,0,0,15228,6.8,16262,205,40,-366,-1230,20.5,1522.8
4499967324,1,17,3,1,6,4,7,0,0,0,0,17477,7.0,19006,232,64,1814,73,23.2,1747.7,14,0,0,4,6,4,1,1,0,0,15663,7.0,18933,210,72,-1814,-73,21.0,1566.3
4519730219,0,15,1,0,3,5,3,0,0,0,0,14384,6.8,16893,206,38,-1554,-704,20.6,1438.4,12,2,1,5,3,6,1,1,0,0,15938,7.0,17597,197,49,1554,704,19.7,1593.8
4502364167,1,16,1,0,5,7,9,0,0,0,0,16427,7.2,18653,248,44,-311,-544,24.8,1642.7,55,1,1,7,5,10,0,0,0,0,16738,7.2,19197,227,32,311,544,22.7,1673.8
4499332976,0,43,4,0,3,7,4,0,0,0,0,14631,6.8,17718,226,41,-2671,-719,22.6,1463.1,18,7,1,7,3,6,1,1,0,0,17302,7.0,18437,252,48,2671,719,25.2,1730.2
4514501540,0,15,7,0,7,4,10,1,0,1,0,16008,7.2,18460,210,49,178,1499,21.0,1600.8,18,4,1,4,7,5,0,0,0,0,15830,6.6,16961,227,44,-178,-1499,22.7,1583.0
4517695714,0,18,8,0,6,6,4,0,0,0,0,15911,6.6,17205,224,36,-194,-1106,22.4,1591.1,17,4,1,6,6,7,0,0,0,0,16105,7.2,18311,193,48,194,1106,19.3,1610.5
4526123124,1,16,20,1,4,4,4,0,0,0,0,16156,6.8,17794,260,46,152,-722,26.0,1615.6,49,5,0,4,4,3,0,0,0,0,16004,7.0,18516,249,55,-152,722,24.9,1600.4
4477246818,1,43,3,1,10,3,6,2,1,1,1,19994,7.6,20865,248,56,5475,3713,24.8,1999.4,19,2,0,3,10,2,0,0,0,0,14519,7.0,17152,217,48,-5475,-3713,21.7,1451.9
4463008615,0,24,2,1,3,2,3,0,0,0,0,14804,7.0,17782,223,52,258,-298,22.3,1480.4,82,1,0,2,3,3,1,1,0,0,14546,7.0,18080,200,60,-258,298,20.0,1454.6
4527742166,0,20,5,1,4,4,5,1,1,0,0,15903,7.0,17640,239,48,428,400,23.9,1590.3,17,3,0,4,4,6,0,0,0,0,15475,6.8,17240,217,57,-428,-400,21.7,1547.5
4480995779,1,15,4,1,11,5,15,0,0,0,0,18106,7.0,17783,191,44,2695,1787,19.1,1810.6,20,1,0,5,11,6,1,1,0,0,15411,6.4,15996,187,52,-2695,-1787,18.7,1541.1
4522327087,0,18,3,0,5,8,5,0,0,0,0,16007,7.2,18083,207,56,-1534,-167,20.7,1600.7,70,3,1,8,5,9,2,1,1,0,17541,6.8,18250,196,64,1534,167,19.6,1754.1
4524316009,1,14,2,0,5,7,2,1,0,1,0,15493,6.8,17405,211,52,-860,-121,21.1,1549.3,17,0,1,7,5,10,1,1,0,0,16353,7.0,17526,202,46,860,121,20.2,1635.3
4525214447,1,16,2,1,11,3,13,0,0,0,0,19008,7.4,18920,206,52,4255,2387,20.6,1900.8,95,2,0,3,11,1,0,0,0,0,14753,6.6,16533,202,63,-4255,-2387,20.2,1475.3
4527391946,0,14,1,0,6,11,6,0,0,0,0,15801,6.6,17010,209,49,-1603,-809,20.9,1580.1,14,3,1,11,6,12,2,1,1,0,17404,7.0,17819,204,34,1603,809,20.4,1740.4
4458640668,0,19,0,0,5,10,2,0,0,0,0,16451,7.0,18416,220,59,-977,143,22.0,1645.1,15,1,1,10,5,8,0,0,0,0,17428,6.8,18273,189,53,977,-143,18.9,1742.8
4525852452,0,15,1,0,1,3,1,1,1,0,0,13253,6.4,16475,190,51,-2310,-2290,19.0,1325.3,16,0,1,3,1,1,0,0,0,0,15563,7.4,18765,248,60,2310,2290,24.8,1556.3
4479146684,0,14,4,0,4,11,3,0,0,0,0,14493,6.6,15935,210,39,-4130,-2849,21.0,1449.3,19,2,1,11,4,14,1,1,0,0,18623,7.0,18784,226,36,4130,2849,22.6,1862.3
4459612181,0,11,4,0,2,7,3,0,0,0,0,14313,6.4,16259,212,57,-2276,-2192,21.2,1431.3,15,0,1,7,2,7,1,1,0,0,16589,6.8,18451,217,47,2276,2192,21.7,1658.9
4477016588,1,13,0,1,12,5,7,1,1,0,0,18894,7.2,18656,195,67,2712,1181,19.5,1889.4,13,1,0,5,12,5,0,0,0,0,16182,6.6,17475,195,58,-2712,-1181,19.5,1618.2
4499619236,0,44,1,0,7,12,12,1,0,1,0,16548,6.8,17321,192,56,-2775,-2872,19.2,1654.8,28,1,1,12,7,10,1,1,0,0,19323,7.4,20193,220,45,2775,2872,22.0,1932.3
4501779329,0,16,4,1,6,5,7,1,0,1,0,16113,6.8,16994,180,41,-1063,-632,18.0,1611.3,18,4,0,5,6,5,0,0,0,1,17176,6.8,17626,240,41,1063,632,24.0,1717.6
4517856513,0,21,5,0,4,10,7,0,0,0,0,15032,6.6,16564,203,44,-4481,-1530,20.3,1503.2,22,8,1,10,4,19,1,1,0,1,19513,7.0,18094,245,45,4481,1530,24.5,1951.3
4508403926,0,13,3,0,5,5,3,1,0,1,0,15226,6.6,17298,213,55,-521,-1275,21.3,1522.6,11,2,1,5,5,3,1,1,0,0,15747,7.2,18573,236,48,521,1275,23.6,1574.7
4494485010,1,19,4,1,4,2,3,1,1,0,0,15966,6.8,17893,231,48,1361,1064,23.1,1596.6,17,3,0,2,4,1,0,0,0,0,14605,6.6,16829,208,64,-1361,-1064,20.8,1460.5
4510920769,1,13,1,1,13,4,13,2,1,1,0,19755,7.4,20163,207,60,5240,5663,20.7,1975.5,15,0,0,4,13,2,0,0,0,0,14515,6.0,14500,220,11,-5240,-5663,22.0,1451.5
4489837555,0,41,2,0,5,4,7,1,1,0,0,16412,7.2,18935,223,44,980,1536,22.3,1641.2,13,4,1,4,5,5,0,0,0,0,15432,6.8,17399,232,38,-980,-1536,23.2,1543.2
4524881998,1,32,2,1,7,5,7,2,1,1,0,17204,7.4,18986,240,60,316,10,24.0,1720.4,36,1,0,5,7,4,0,0,0,0,16888,7.0,18976,236,48,-316,-10,23.6,1688.8
4505037739,0,18,1,1,7,3,12,2,1,1,0,16247,6.6,17036,205,55,1768,939,20.5,1624.7,13,1,0,3,7,2,0,0,0,0,14479,6.6,16097,189,48,-1768,-939,18.9,1447.9
4518072555,0,16,5,0,8,5,10,1,1,0,0,17513,7.0,18498,234,44,834,861,23.4,1751.3,26,1,1,5,8,7,0,0,0,0,16679,6.8,17637,215,60,-834,-861,21.5,1667.9
4498851074,0,14,0,1,8,8,5,0,0,0,0,17232,6.8,17997,231,32,260,-108,23.1,1723.2,15,3,0,8,8,7,0,0,0,0,16972,7.0,18105,205,50,-260,108,20.5,1697.2
4513928992,0,15,4,0,5,7,10,1,0,1,0,15735,6.6,17073,225,47,-488,-237,22.5,1573.5,19,3,1,7,5,8,1,1,0,0,16223,6.8,17310,200,48,488,237,20.0,1622.3
4525941863,1,38,2,1,5,7,6,1,1,0,0,16571,7.0,18777,220,65,88,413,22.0,1657.1,20,3,0,7,5,7,0,0,0,0,16483,7.0,18364,202,46,-88,-413,20.2,1648.3
4459617456,0,41,5,1,8,4,9,0,0,0,0,18073,7.6,21032,239,44,2364,2384,23.9,1807.3,12,4,0,4,8,2,0,0,0,0,15709,7.0,18648,233,62,-2364,-2384,23.3,1570.9
4525224420,1,31,2,0,8,4,5,1,0,1,0,17553,7.4,19041,203,64,2034,2002,20.3,1755.3,16,0,1,4,8,4,1,1,0,0,15519,6.8,17039,211,52,-2034,-2002,21.1,1551.9
4518472442,0,17,3,0,8,4,8,1,1,0,0,17415,6.8,16774,232,48,2791,1911,23.2,1741.5,40,4,1,4,8,8,0,0,0,0,14624,6.2,14863,205,26,-2791,-1911,20.5,1462.4
4526872283,1,39,2,1,4,0,6,1,1,0,0,15388,6.8,17788,220,52,365,-719,22.0,1538.8,18,1,0,0,4,0,0,0,0,0,15023,6.8,18507,252,76,-365,719,25.2,1502.3
4524920237,0,24,3,1,5,11,6,0,0,0,0,16544,7.0,17851,222,53,-2929,-1731,22.2,1654.4,14,2,0,11,5,17,1,1,0,0,19473,7.2,19582,227,48,2929,1731,22.7,1947.3
4524740998,1,43,6,1,4,7,4,1,1,0,0,15176,6.4,16820,226,33,-1539,-1497,22.6,1517.6,23,9,0,7,4,12,0,0,0,0,16715,7.2,18317,205,52,1539,1497,20.5,1671.5
4520786443,0,13,1,1,7,4,7,1,0,1,0,16620,7.2,18824,211,48,273,255,21.1,1662.0,13,2,0,4,7,7,1,1,0,0,16347,7.0,18569,226,67,-273,-255,22.6,1634.7
4453299408,1,41,3,1,8,10,10,1,1,0,0,16526,7.0,18130,174,44,-2720,-2680,17.4,1652.6,19,5,0,10,8,7,0,0,0,0,19246,7.6,20810,239,79,2720,2680,23.9,1924.6
4468293476,1,25,1,1,3,3,4,0,0,0,0,15834,7.0,18253,248,52,324,-574,24.8,1583.4,9,2,0,3,3,3,2,1,1,0,15510,7.2,18827,220,68,-324,574,22.0,1551.0
4492351873,0,15,0,1,10,10,8,0,0,0,1,18544,6.4,17072,182,60,1060,7,18.2,1854.4,39,2,0,10,10,11,1,1,0,0,17484,6.8,17065,174,36,-1060,-7,17.4,1748.4
4523772935,1,18,0,1,6,6,5,0,0,0,0,16266,7.0,17321,207,44,927,-58,20.7,1626.6,9,2,0,6,6,4,1,1,0,0,15339,6.8,17379,201,46,-927,58,20.1,1533.9
4522594325,0,15,0,1,11,5,13,0,0,0,1,19979,7.2,18500,207,39,3763,874,20.7,1997.9,11,1,0,5,11,6,0,0,0,0,16216,7.0,17626,194,51,-3763,-874,19.4,1621.6
4521611632,1,10,1,1,7,6,11,2,1,1,0,17410,7.2,18496,239,62,1590,971,23.9,1741.0,12,0,0,6,7,8,0,0,0,0,15820,7.0,17525,216,46,-1590,-971,21.6,1582.0
4500021732,1,15,1,1,9,3,8,0,0,0,0,17940,7.4,19752,224,53,3828,2549,22.4,1794.0,13,3,0,3,9,3,1,1,0,0,14112,6.8,17203,200,37,-3828,-2549,20.0,1411.2
4506946392,1,14,0,0,5,8,4,0,0,0,0,14321,6.0,15077,167,43,-2695,-2572,16.7,1432.1,15,1,1,8,5,10,0,0,0,0,17016,7.0,17649,181,54,2695,2572,18.1,1701.6
4520816050,1,16,7,1,9,3,8,2,1,1,0,17577,7.4,20010,210,64,2812,2747,21.0,1757.7,16,3,0,3,9,4,0,0,0,0,14765,6.8,17263,205,56,-2812,-2747,20.5,1476.5
4505443622,1,45,6,0,10,8,22,0,0,0,0,19540,7.2,18969,247,60,1714,1487,24.7,1954.0,17,12,1,8,10,8,1,0,1,0,17826,7.0,17482,211,48,-1714,-1487,21.1,1782.6
4472012387,1,16,1,1,2,7,2,0,0,0,0,15198,7.0,18952,231,67,-1157,-84,23.1,1519.8,14,0,0,7,2,9,1,1,0,0,16355,7.4,19036,211,48,1157,84,21.1,1635.5
4515542024,1,12,4,0,1,4,2,1,0,1,0,14536,7.0,17837,214,63,-1476,-346,21.4,1453.6,19,5,1,4,1,4,1,1,0,0,16012,7.0,18183,253,48,1476,346,25.3,1601.2
4521242429,1,16,4,0,4,11,4,0,0,0,0,15120,6.4,16083,189,44,-3181,-2898,18.9,1512.0,56,3,1,11,4,14,0,0,0,0,18301,7.4,18981,214,48,3181,2898,21.4,1830.1
4520629363,1,16,2,0,4,4,3,2,1,1,0,15875,6.8,18309,234,65,455,1305,23.4,1587.5,15,4,1,4,4,6,0,0,0,0,15420,6.4,17004,233,42,-455,-1305,23.3,1542.0
4451773620,1,15,2,0,3,3,6,0,0,0,0,15570,6.8,17440,232,36,-339,-1529,23.2,1557.0,20,3,1,3,3,1,2,1,1,0,15909,7.2,18969,244,60,339,1529,24.4,1590.9
4438165073,0,17,3,1,5,9,5,1,1,0,0,15921,6.8,17353,210,68,-1490,-1624,21.0,1592.1,16,4,0,9,5,14,0,0,0,0,17411,7.2,18977,215,52,1490,1624,21.5,1741.1
4497864725,1,20,7,1,11,2,16,0,0,0,0,19770,7.2,19116,232,48,5120,3137,23.2,1977.0,16,3,0,2,11,2,2,1,1,0,14650,6.4,15979,191,64,-5120,-3137,19.1,1465.0
4506208717,0,83,3,1,10,7,12,0,0,0,0,18592,7.2,19027,212,47,1577,678,21.2,1859.2,15,2,0,7,10,4,2,1,1,0,17015,7.0,18349,233,44,-1577,-678,23.3,1701.5
4460718392,0,14,0,0,0,12,0,0,0,0,0,12002,6.0,13961,151,44,-8461,-7340,15.1,1200.2,58,3,1,12,0,9,0,0,0,1,20463,7.8,21301,238,52,8461,7340,23.8,2046.3
4522637955,1,16,1,1,7,5,14,1,0,1,0,17798,7.0,19047,222,64,1698,1171,22.2,1779.8,22,3,0,5,7,7,0,0,0,0,16100,6.8,17876,241,46,-1698,-1171,24.1,1610.0
4506573625,0,221,1,0,2,14,1,0,0,0,0,13121,6.0,14672,172,32,-6707,-5252,17.2,1312.1,31,1,1,14,2,13,2,1,1,0,19828,7.6,19924,203,55,6707,5252,20.3,1982.8
4477269261,1,19,3,1,13,7,13,1,1,0,0,19161,7.0,18599,232,40,2783,2368,23.2,1916.1,15,4,0,7,13,3,0,0,0,0,16378,6.8,16231,195,40,-2783,-2368,19.5,1637.8
4524640589,1,16,3,0,8,8,12,2,1,1,0,16367,6.6,16065,202,40,151,1281,20.2,1636.7,14,5,1,8,8,18,0,0,0,0,16216,6.2,14784,201,8,-151,-1281,20.1,1621.6
4458318348,0,39,0,0,3,6,3,0,0,0,0,15345,6.6,17067,226,44,-192,-287,22.6,1534.5,59,3,1,6,3,8,2,1,1,0,15537,6.8,17354,191,39,192,287,19.1,1553.7
4450357226,1,18,3,1,8,7,7,1,0,1,0,18698,7.4,20094,259,63,2078,2058,25.9,1869.8,16,2,0,7,8,7,1,1,0,0,16620,7.0,18036,207,52,-2078,-2058,20.7,1662.0
4502501343,1,15,0,1,8,7,10,1,1,0,0,17289,6.8,18113,201,62,69,-119,20.1,1728.9,18,1,0,7,8,5,1,0,1,0,17220,7.0,18232,237,49,-69,119,23.7,1722.0
4469945673,0,69,5,0,3,8,4,0,0,0,0,14108,6.4,16327,188,48,-4316,-2717,18.8,1410.8,18,6,1,8,3,7,2,1,1,0,18424,7.4,19044,262,64,4316,2717,26.2,1842.4
4525947675,1,16,2,1,3,7,4,1,1,0,0,15641,7.0,18490,261,56,-371,-444,26.1,1564.1,62,4,0,7,3,7,0,0,0,0,16012,7.0,18934,209,53,371,444,20.9,1601.2
4526637754,1,15,0,1,9,11,14,0,0,0,0,18306,6.8,17828,207,56,737,50,20.7,1830.6,41,1,0,11,9,12,1,1,0,0,17569,7.0,17778,183,43,-737,-50,18.3,1756.9
4525216549,0,13,2,0,5,3,8,1,1,0,0,16294,7.2,18718,218,60,613,323,21.8,1629.4,14,3,1,3,5,3,0,0,0,0,15681,7.2,18395,232,64,-613,-323,23.2,1568.1
4498216793,0,38,6,0,6,10,6,2,1,1,0,15573,6.8,18078,194,43,-4673,-1225,19.4,1557.3,19,2,1,10,6,10,0,0,0,1,20246,7.2,19303,246,50,4673,1225,24.6,2024.6
4511049704,0,14,4,0,4,5,4,0,0,0,0,16295,7.2,18278,261,36,41,-936,26.1,1629.5,56,2,1,5,4,5,1,1,0,0,16254,7.2,19214,234,64,-41,936,23.4,1625.4
4516988752,0,13,1,0,3,9,3,0,0,0,0,14232,6.8,17038,186,56,-3082,-646,18.6,1423.2,15,3,1,9,3,14,1,1,0,0,17314,6.8,17684,208,48,3082,646,20.8,1731.4
4489780807,1,13,4,0,4,11,5,0,0,0,0,14983,6.8,16993,208,47,-2653,-1372,20.8,1498.3,54,2,1,11,4,16,1,1,0,0,17636,7.0,18365,207,40,2653,1372,20.7,1763.6
4454214561,0,11,1,1,7,9,6,0,0,0,0,16248,7.0,18067,171,63,-2242,-1819,17.1,1624.8,33,2,0,9,7,12,1,1,0,0,18490,7.2,19886,229,45,2242,1819,22.9,1849.0
4523503421,0,12,1,0,4,8,3,1,0,1,0,15632,6.8,17715,230,56,-2293,-1323,23.0,1563.2,16,1,1,8,4,13,1,1,0,0,17925,7.2,19038,234,56,2293,1323,23.4,1792.5
4485492542,1,11,0,0,6,7,5,0,0,0,0,15736,7.0,17285,188,45,-915,3,18.8,1573.6,19,1,1,7,6,4,1,1,0,0,16651,7.0,17282,199,59,915,-3,19.9,1665.1
4519099479,0,16,2,0,7,6,8,0,0,0,0,16286,7.0,17910,223,40,369,561,22.3,1628.6,15,1,1,6,7,8,0,0,0,0,15917,7.0,17349,196,52,-369,-561,19.6,1591.7
4519909755,1,17,1,1,11,7,12,1,1,0,0,18276,6.8,17133,202,51,1281,-5,20.2,1827.6,14,2,0,7,11,10,0,0,0,0,16995,6.6,17138,214,36,-1281,5,21.4,1699.5
4499759194,1,16,1,0,6,6,6,1,1,0,0,15862,6.8,17707,227,46,-152,-430,22.7,1586.2,19,2,1,6,6,11,1,0,1,0,16014,6.8,18137,210,47,152,430,21.0,1601.4
4522379320,0,17,3,1,5,4,6,2,1,1,0,16635,7.0,18522,217,51,799,239,21.7,1663.5,61,0,0,4,5,9,0,0,0,0,15836,6.8,18283,240,52,-799,-239,24.0,1583.6
4509027219,1,23,2,1,3,1,3,0,0,0,0,16468,6.8,18574,249,54,3100,1653,24.9,1646.8,19,2,0,1,3,0,0,0,0,0,13368,6.6,16921,192,41,-3100,-1653,19.2,1336.8
4516824896,1,22,2,0,8,4,9,0,0,0,0,16539,7.0,17585,205,46,1947,1396,20.5,1653.9,38,2,1,4,8,3,0,0,0,0,14592,6.6,16189,196,43,-1947,-1396,19.6,1459.2
4512141904,1,16,2,1,5,8,3,0,0,0,0,15853,7.0,17174,192,52,-1448,-908,19.2,1585.3,14,3,0,8,5,11,2,1,1,0,17301,7.0,18082,197,52,1448,908,19.7,1730.1
4495106153,0,15,2,1,10,4,11,2,1,1,0,17816,6.8,18684,202,58,1953,1494,20.2,1781.6,16,5,0,4,10,6,0,0,0,0,15863,7.0,17190,224,41,-1953,-1494,22.4,1586.3
4461218405,1,16,2,1,11,4,9,1,1,0,0,19612,7.6,20290,259,50,4871,2019,25.9,1961.2,14,3,0,4,11,1,0,0,0,0,14741,7.0,18271,210,53,-4871,-2019,21.0,1474.1
4523251665,0,48,3,0,3,6,6,0,0,0,0,14986,6.8,17222,208,46,-1501,-1478,20.8,1498.6,18,3,1,6,3,4,0,0,0,0,16487,7.2,18700,220,49,1501,1478,22.0,1648.7
4464987653,1,69,3,0,10,5,19,1,1,0,0,18625,7.0,18540,231,39,3201,2000,23.1,1862.5,14,3,1,5,10,5,1,0,1,0,15424,6.8,16540,191,60,-3201,-2000,19.1,1542.4
4514106633,0,15,2,1,5,5,5,0,0,0,0,15734,7.0,17911,213,47,-837,-660,21.3,1573.4,21,3,0,5,5,7,2,1,1,0,16571,7.0,18571,249,47,837,660,24.9,1657.1
4448447768,0,10,1,0,10,15,8,0,0,0,0,17418,7.0,18495,202,38,-2298,-1255,20.2,1741.8,14,1,1,15,10,10,1,1,0,0,19716,7.2,19750,171,46,2298,1255,17.1,1971.6
4502001730,1,25,4,0,11,6,12,0,0,0,0,19537,7.0,18358,189,60,2718,1185,18.9,1953.7,20,1,1,6,11,8,1,1,0,0,16819,7.0,17173,211,48,-2718,-1185,21.1,1681.9
4524310116,0,17,3,0,4,8,4,0,0,0,0,14722,6.6,17262,190,48,-2208,-2862,19.0,1472.2,15,1,1,8,4,4,2,1,1,0,16930,7.6,20124,210,72,2208,2862,21.0,1693.0
4508812859,1,19,3,1,4,2,6,2,1,1,1,17230,6.6,17823,244,56,1449,-530,24.4,1723.0,39,3,0,2,4,5,0,0,0,0,15781,7.0,18353,229,77,-1449,530,22.9,1578.1
4479650121,0,17,2,1,5,4,4,1,1,0,1,17457,7.0,18205,225,52,1495,-413,22.5,1745.7,15,1,0,4,5,3,0,0,0,0,15962,6.8,18618,248,53,-1495,413,24.8,1596.2
4521229573,0,38,0,1,8,7,9,0,0,0,0,16404,6.8,17425,197,54,283,608,19.7,1640.4,106,2,0,7,8,8,1,1,0,0,16121,6.6,16817,216,36,-283,-608,21.6,1612.1
4511683364,1,19,5,0,4,3,3,0,0,0,0,15832,7.2,18431,257,52,755,436,25.7,1583.2,17,4,1,3,4,4,2,1,1,0,15077,7.0,17995,217,60,-755,-436,21.7,1507.7
4498463657,0,18,0,0,6,12,6,1,1,0,0,15740,6.0,14844,178,36,-5057,-3921,17.8,1574.0,17,2,1,12,6,16,0,0,0,1,20797,7.2,18765,238,47,5057,3921,23.8,2079.7
4509929305,0,15,5,0,7,8,6,1,1,0,0,17147,7.0,18525,205,52,-142,-1193,20.5,1714.7,15,5,1,8,7,2,1,0,1,0,17289,7.4,19718,242,59,142,1193,24.2,1728.9
4525362922,1,15,3,0,3,5,2,1,1,0,0,14986,6.8,17946,220,72,-2042,-436,22.0,1498.6,15,2,1,5,3,6,1,0,1,1,17028,7.0,18382,232,24,2042,436,23.2,1702.8
4523959308,0,18,4,1,10,7,7,1,1,0,0,18185,7.0,19320,213,56,1340,1318,21.3,1818.5,30,3,0,7,10,4,0,0,0,0,16845,6.8,18002,216,56,-1340,-1318,21.6,1684.5
4500463152,0,18,1,0,2,11,4,0,0,0,0,14023,6.4,15096,187,59,-4659,-3268,18.7,1402.3,15,9,1,11,2,18,1,1,0,0,18682,7.2,18364,225,44,4659,3268,22.5,1868.2
4497602150,1,16,6,0,5,4,10,1,1,0,0,15387,7.0,17708,174,66,337,1346,17.4,1538.7,22,5,1,4,5,4,0,0,0,0,15050,6.8,16362,213,48,-337,-1346,21.3,1505.0
4410060427,0,17,4,1,5,5,5,1,0,1,0,16574,7.2,19529,235,60,803,857,23.5,1657.4,18,4,0,5,5,6,1,1,0,0,15771,7.2,18672,204,64,-803,-857,20.4,1577.1
4505644986,0,15,1,1,6,4,8,1,1,0,0,17142,7.2,18300,227,56,576,-1839,22.7,1714.2,15,1,0,4,6,7,1,0,1,0,16566,7.4,20139,222,79,-576,1839,22.2,1656.6
4514140656,1,21,1,1,12,6,15,1,1,0,0,18665,7.0,17762,213,37,2524,1040,21.3,1866.5,12,4,0,6,12,7,1,0,1,0,16141,6.6,16722,202,43,-2524,-1040,20.2,1614.1
4492423421,1,11,0,1,6,8,5,0,0,0,0,16370,6.8,17433,209,39,-633,-1089,20.9,1637.0,14,1,0,8,6,12,1,1,0,0,17003,7.2,18522,195,66,633,1089,19.5,1700.3
4512906607,0,16,2,1,7,2,8,0,0,0,0,17381,7.2,18931,258,42,2389,892,25.8,1738.1,18,2,0,2,7,2,1,1,0,0,14992,7.0,18039,216,56,-2389,-892,21.6,1499.2
4516034199,0,12,4,0,2,8,2,1,1,0,0,15421,7.2,19276,217,84,-2771,-1125,21.7,1542.1,14,2,1,8,2,5,0,0,0,0,18192,7.4,20401,234,64,2771,1125,23.4,1819.2
4453026887,0,27,3,0,5,5,6,0,0,0,0,15211,6.6,16678,179,55,-1310,-1595,17.9,1521.1,15,3,1,5,5,4,0,0,0,0,16521,6.8,18273,222,48,1310,1595,22.2,1652.1
4514107032,1,17,0,1,4,2,4,0,0,0,0,17186,7.0,19734,263,72,2478,1105,26.3,1718.6,16,6,0,2,4,3,2,1,1,0,14708,7.0,18629,209,60,-2478,-1105,20.9,1470.8
4466996593,0,17,4,0,8,5,9,1,1,0,0,17027,7.4,19345,217,56,302,1420,21.7,1702.7,18,5,1,5,8,7,1,0,1,0,16725,7.0,17925,237,44,-302,-1420,23.7,1672.5
4477500359,0,21,5,0,9,7,7,1,1,0,0,17686,7.0,19734,236,48,1178,2223,23.6,1768.6,41,5,1,7,9,5,1,0,1,0,16508,6.8,17511,187,44,-1178,-2223,18.7,1650.8
4495519418,0,13,2,1,10,3,12,0,0,0,0,17862,7.4,19955,242,44,2417,2101,24.2,1786.2,15,1,0,3,10,3,1,1,0,0,15445,7.0,17854,203,64,-2417,-2101,20.3,1544.5
4525841873,0,16,4,1,10,3,9,1,1,0,0,17631,6.8,18612,201,44,3436,1760,20.1,1763.1,13,4,0,3,10,1,1,0,1,0,14195,6.6,16852,206,48,-3436,-1760,20.6,1419.5
4462194525,0,18,1,0,6,7,10,1,0,1,0,16557,6.8,17632,230,47,-1491,-799,23.0,1655.7,38,5,1,7,6,11,1,1,0,0,18048,7.0,18431,222,53,1491,799,22.2,1804.8
4519181243,0,14,4,0,5,6,5,0,0,0,0,16449,6.8,17858,207,56,973,825,20.7,1644.9,12,2,1,6,5,8,0,0,0,0,15476,6.8,17033,192,52,-973,-825,19.2,1547.6
4523348285,1,18,0,1,6,2,6,1,1,0,0,16508,7.0,18539,228,44,646,407,22.8,1650.8,16,1,0,2,6,2,0,0,0,0,15862,6.8,18132,238,57,-646,-407,23.8,1586.2
4518856826,0,49,4,0,10,13,9,2,1,1,0,17743,7.0,17923,194,50,-1223,-1046,19.4,1774.3,17,0,1,13,10,10,0,0,0,0,18966,7.2,18969,198,61,1223,1046,19.8,1896.6
4454039126,0,18,4,0,7,10,9,0,0,0,0,16923,6.8,17782,224,36,-673,568,22.4,1692.3,44,6,1,10,7,13,1,1,0,0,17596,7.0,17214,199,42,673,-568,19.9,1759.6
4519607930,0,13,1,0,1,3,1,1,1,0,0,13942,7.0,17704,219,52,-1231,-908,21.9,1394.2,14,3,1,3,1,1,0,0,0,0,15173,7.0,18612,248,56,1231,908,24.8,1517.3
4517953840,0,23,5,0,5,9,7,0,0,0,0,15239,6.6,16561,194,50,-3130,-2448,19.4,1523.9,19,3,1,9,5,13,1,1,0,0,18369,7.2,19009,236,44,3130,2448,23.6,1836.9
4512994331,1,14,3,0,5,8,7,1,0,1,0,16270,6.8,17716,230,53,-143,708,23.0,1627.0,15,2,1,8,5,8,1,1,0,0,16413,6.6,17008,206,42,143,-708,20.6,1641.3
4476265926,1,39,5,1,10,4,11,0,0,0,0,18228,7.2,19423,250,36,3419,4709,25.0,1822.8,14,2,0,4,10,2,1,1,0,0,14809,6.2,14714,193,41,-3419,-4709,19.3,1480.9
4506726377,0,54,2,1,6,0,6,2,1,1,0,16557,7.2,18637,261,50,1878,703,26.1,1655.7,17,2,0,0,6,0,0,0,0,0,14679,7.0,17934,233,56,-1878,-703,23.3,1467.9
4519649032,1,11,6,1,8,4,8,2,1,1,0,18133,7.4,20427,259,52,2580,2954,25.9,1813.3,16,2,0,4,8,4,0,0,0,0,15553,6.8,17473,214,52,-2580,-2954,21.4,1555.3
4417424903,0,10,0,1,8,6,5,0,0,0,0,16293,7.2,18611,218,44,-176,351,21.8,1629.3,14,3,0,6,8,5,0,0,0,0,16469,7.0,18260,203,56,176,-351,20.3,1646.9
4516602474,0,17,2,0,7,5,8,0,0,0,0,16906,6.8,18034,218,52,760,521,21.8,1690.6,15,3,1,5,7,4,0,0,0,0,16146,6.8,17513,244,48,-760,-521,24.4,1614.6
4472897611,1,15,3,1,1,1,0,0,0,0,0,14163,6.8,17413,246,42,450,924,24.6,1416.3,18,1,0,1,1,2,1,1,0,0,13713,6.6,16489,211,52,-450,-924,21.1,1371.3
4524714438,1,26,2,1,6,5,9,0,0,0,0,15890,6.6,16918,170,48,-902,-1082,17.0,1589.0,11,4,0,5,6,5,0,0,0,0,16792,7.0,18000,227,58,902,1082,22.7,1679.2
4523373945,0,13,1,0,8,6,9,0,0,0,0,15716,6.4,16324,190,36,258,762,19.0,1571.6,17,2,1,6,8,8,1,1,0,0,15458,6.2,15562,183,40,-258,-762,18.3,1545.8
4467412400,0,17,1,1,1,3,1,0,0,0,0,15573,7.0,18440,246,70,66,319,24.6,1557.3,130,4,0,3,1,6,2,1,1,0,15507,7.0,18121,233,57,-66,-319,23.3,1550.7
4517860054,1,14,4,1,3,2,3,0,0,0,0,15148,6.6,16687,215,48,-44,-1601,21.5,1514.8,19,5,0,2,3,1,0,0,0,0,15192,7.0,18288,246,51,44,1601,24.6,1519.2
4521560352,0,16,1,0,1,8,2,0,0,0,0,13880,6.2,15178,191,54,-3063,-2326,19.1,1388.0,47,1,1,8,1,9,1,1,0,0,16943,6.8,17504,187,40,3063,2326,18.7,1694.3
4501039898,0,18,5,1,5,6,10,1,1,0,0,15758,6.4,16364,190,72,-882,-1760,19.0,1575.8,19,3,0,6,5,5,0,0,0,0,16640,7.0,18124,253,40,882,1760,25.3,1664.0
4513692486,1,15,3,1,10,4,13,0,0,0,0,18504,7.0,19016,206,55,3446,1559,20.6,1850.4,17,5,0,4,10,2,1,1,0,0,15058,6.8,17457,221,50,-3446,-1559,22.1,1505.8
4521643886,1,13,2,1,7,5,5,0,0,0,0,15984,7.0,18367,205,49,763,1019,20.5,1598.4,77,2,0,5,7,6,1,1,0,0,15221,6.8,17348,175,54,-763,-1019,17.5,1522.1
4448713389,0,21,4,1,10,5,9,1,1,0,0,18889,7.4,19825,257,56,3136,2512,25.7,1888.9,16,2,0,5,10,6,0,0,0,0,15753,6.8,17313,175,59,-3136,-2512,17.5,1575.3
4518772653,0,14,4,0,3,7,5,1,1,0,0,15070,6.8,18012,217,50,-2692,-1151,21.7,1507.0,15,3,1,7,3,14,0,0,0,0,17762,7.6,19163,225,52,2692,1151,22.5,1776.2
4527366707,1,18,2,0,7,2,10,0,0,0,0,16879,7.2,18526,211,52,2053,1126,21.1,1687.9,15,3,1,2,7,3,1,1,0,0,14826,6.8,17400,232,64,-2053,-1126,23.2,1482.6
4427804202,1,13,4,0,7,6,14,1,1,0,0,16304,6.2,15338,182,45,-61,-1738,18.2,1630.4,18,1,1,6,7,8,0,0,0,0,16365,6.4,17076,219,44,61,1738,21.9,1636.5
4521669931,0,11,1,1,4,5,4,2,1,1,0,15711,6.6,17255,208,59,-101,-1320,20.8,1571.1,11,1,0,5,4,6,0,0,0,0,15812,7.2,18575,210,65,101,1320,21.0,1581.2
4526934596,1,17,5,1,6,3,6,0,0,0,0,17854,7.6,20729,260,80,3215,3092,26.0,1785.4,16,2,0,3,6,3,0,0,0,0,14639,6.6,17637,194,55,-3215,-3092,19.4,1463.9
4516995373,0,38,4,1,2,3,5,1,0,1,0,14992,6.8,18110,226,56,-415,1224,22.6,1499.2,20,2,0,3,2,5,1,1,0,0,15407,6.6,16886,222,55,415,-1224,22.2,1540.7
4523788727,1,13,1,1,12,9,18,0,0,0,0,18748,6.8,17354,195,45,1212,77,19.5,1874.8,13,1,0,9,12,8,1,1,0,0,17536,7.0,17277,193,52,-1212,-77,19.3,1753.6
4515526880,0,32,4,0,3,10,3,0,0,0,0,15067,6.6,15937,186,39,-2968,-3336,18.6,1506.7,21,1,1,10,3,11,1,1,0,0,18035,7.4,19273,214,57,2968,3336,21.4,1803.5
4504089407,1,9,1,1,6,6,7,0,0,0,0,17500,7.2,18692,226,56,2077,266,22.6,1750.0,16,2,0,6,6,4,1,1,0,0,15423,6.8,18426,212,47,-2077,-266,21.2,1542.3
4521050901,0,12,2,0,2,9,4,0,0,0,0,13795,6.6,16505,203,42,-4631,-3612,20.3,1379.5,36,2,1,9,2,11,1,1,0,0,18426,7.4,20117,229,66,4631,3612,22.9,1842.6
4523492555,1,13,3,1,4,1,5,1,1,0,0,16942,7.6,20255,261,72,2875,3035,26.1,1694.2,15,2,0,1,4,1,0,0,0,0,14067,6.8,17220,222,56,-2875,-3035,22.2,1406.7
4473365528,0,16,3,0,3,3,4,0,0,0,0,15073,6.8,17578,227,54,-334,-292,22.7,1507.3,12,3,1,3,3,3,0,0,0,0,15407,6.8,17870,251,46,334,292,25.1,1540.7
4523775056,1,29,10,0,2,5,5,0,0,0,0,15696,7.2,18895,243,68,-1163,-19,24.3,1569.6,42,2,1,5,2,7,1,0,1,0,16859,7.2,18914,246,51,1163,19,24.6,1685.9
4497665020,0,13,7,0,4,6,1,1,0,1,0,14898,7.0,17842,192,48,-1367,-197,19.2,1489.8,15,0,1,6,4,10,0,0,0,0,16265,6.8,18039,219,43,1367,197,21.9,1626.5
4526851533,1,66,2,1,8,1,8,1,1,0,0,16853,7.0,18255,226,44,2751,1464,22.6,1685.3,12,2,0,1,8,0,0,0,0,0,14102,6.8,16791,199,57,-2751,-1464,19.9,1410.2
4521223652,1,15,1,0,4,3,4,1,1,0,0,15237,7.0,17965,205,60,724,2025,20.5,1523.7,49,3,1,3,4,4,1,0,1,0,14513,6.2,15940,206,32,-724,-2025,20.6,1451.3
4521965103,0,16,5,0,1,2,1,1,0,1,0,13840,6.8,17099,225,44,-2131,-2173,22.5,1384.0,20,3,1,2,1,1,1,1,0,0,15971,7.2,19272,264,64,2131,2173,26.4,1597.1
4477182015,0,15,3,1,4,10,5,1,1,0,0,15403,6.6,17392,242,48,-2613,-1974,24.2,1540.3,40,3,0,10,4,15,1,0,1,0,18016,7.0,19366,230,48,2613,1974,23.0,1801.6
4520335099,1,19,2,0,3,3,2,2,1,1,0,15000,7.0,17972,229,52,198,726,22.9,1500.0,17,4,1,3,3,3,0,0,0,0,14802,6.8,17246,220,40,-198,-726,22.0,1480.2
4510530243,0,16,3,0,6,5,9,1,1,0,0,16110,7.0,17501,206,36,72,-81,20.6,1611.0,12,5,1,5,6,5,0,0,0,0,16038,6.8,17582,217,59,-72,81,21.7,1603.8
4482075284,1,12,3,1,8,2,8,0,0,0,0,18269,7.6,20290,258,49,3389,3465,25.8,1826.9,15,3,0,2,8,1,0,0,0,0,14880,6.4,16825,239,50,-3389,-3465,23.9,1488.0
4517653649,1,93,2,0,16,8,27,0,0,0,0,21663,7.4,19484,226,48,3825,2747,22.6,2166.3,14,5,1,8,16,15,0,0,0,0,17838,6.4,16737,216,55,-3825,-2747,21.6,1783.8
4526575643,0,18,4,0,4,6,6,0,0,0,0,14827,6.6,16610,187,43,-2322,-1522,18.7,1482.7,13,5,1,6,4,5,1,1,0,0,17149,7.0,18132,222,68,2322,1522,22.2,1714.9
4506847154,0,11,0,1,6,7,8,1,1,0,0,15684,6.6,17219,202,39,-3240,-2396,20.2,1568.4,16,1,0,7,6,8,1,0,1,1,18924,7.0,19615,257,60,3240,2396,25.7,1892.4
4492860454,0,15,2,0,9,3,12,0,0,0,0,17892,7.2,18969,215,56,1873,883,21.5,1789.2,16,1,1,3,9,2,1,1,0,0,16019,7.0,18086,249,56,-1873,-883,24.9,1601.9
4489785292,0,19,4,0,6,11,8,0,0,0,0,15887,6.4,16048,191,48,-2596,-2891,19.1,1588.7,15,5,1,11,6,13,0,0,0,0,18483,7.2,18939,220,51,2596,2891,22.0,1848.3
4480114135,0,39,4,0,3,6,6,1,1,0,0,14844,6.8,17179,218,48,-2343,-2188,21.8,1484.4,17,2,1,6,3,3,0,0,0,0,17187,7.2,19367,256,76,2343,2188,25.6,1718.7
4471752713,1,57,0,1,5,1,7,1,1,0,0,17079,7.6,20271,238,80,2508,1742,23.8,1707.9,12,1,0,1,5,2,0,0,0,0,14571,7.2,18529,249,55,-2508,-1742,24.9,1457.1
4527306086,1,11,2,1,15,10,19,1,1,0,0,19407,7.4,19360,217,42,1259,550,21.7,1940.7,11,2,0,10,15,11,0,0,0,0,18148,7.0,18810,193,54,-1259,-550,19.3,1814.8
4526802557,1,15,4,1,8,9,9,0,0,0,0,17310,7.0,18101,202,45,390,-300,20.2,1731.0,25,0,0,9,8,8,1,1,0,0,16920,7.0,18401,193,46,-390,300,19.3,1692.0
4513254369,1,16,2,1,2,3,2,2,1,1,0,15130,7.2,18930,234,50,-27,281,23.4,1513.0,14,0,0,3,2,3,0,0,0,0,15157,7.4,18649,250,53,27,-281,25.0,1515.7
4494200479,1,16,1,0,5,5,6,0,0,0,0,16503,7.2,18765,231,59,690,365,23.1,1650.3,13,1,1,5,5,3,1,1,0,0,15813,7.2,18400,232,52,-690,-365,23.2,1581.3
4524772917,0,18,5,0,1,6,1,0,0,0,0,14979,7.0,18306,232,66,-2607,59,23.2,1497.9,17,4,1,6,1,5,2,1,1,1,17586,6.8,18247,238,54,2607,-59,23.8,1758.6
4509546760,1,87,3,1,11,6,13,1,1,0,1,20111,7.0,18316,231,46,4588,930,23.1,2011.1,11,1,0,6,11,6,0,0,0,0,15523,7.0,17386,153,54,-4588,-930,15.3,1552.3
4514342696,1,19,1,0,9,7,11,1,1,0,0,17762,7.0,18599,233,32,849,794,23.3,1776.2,39,2,1,7,9,8,0,0,0,0,16913,6.8,17805,200,56,-849,-794,20.0,1691.3
4511647215,0,13,3,0,5,7,8,1,0,1,0,15457,6.6,17048,191,58,-1647,-3035,19.1,1545.7,13,4,1,7,5,7,1,1,0,0,17104,7.4,20083,251,54,1647,3035,25.1,1710.4
4432336301,0,18,3,1,2,7,1,0,0,0,0,14639,6.6,16690,222,40,-2862,-3209,22.2,1463.9,16,4,0,7,2,12,1,1,0,0,17501,7.6,19899,237,62,2862,3209,23.7,1750.1
4472984936,0,24,1,1,8,5,5,0,0,0,0,17785,7.2,19422,238,55,2597,2731,23.8,1778.5,37,2,0,5,8,4,1,1,0,0,15188,6.6,16691,199,47,-2597,-2731,19.9,1518.8
4486503067,1,17,2,1,6,5,9,0,0,0,0,17812,7.2,19411,263,69,2303,2950,26.3,1781.2,16,2,0,5,6,9,1,1,0,0,15509,6.6,16461,191,46,-2303,-2950,19.1,1550.9
4494451002,1,16,4,1,8,3,7,1,1,0,0,16225,6.8,17748,179,44,195,428,17.9,1622.5,17,0,0,3,8,4,0,0,0,0,16030,6.6,17320,239,39,-195,-428,23.9,1603.0
4517922682,0,35,4,0,7,5,10,0,0,0,0,16526,7.2,19072,217,56,-64,239,21.7,1652.6,66,2,1,5,7,4,0,0,0,0,16590,7.0,18833,214,60,64,-239,21.4,1659.0
4505729756,0,15,1,0,7,9,6,0,0,0,0,17550,7.2,18791,237,52,175,989,23.7,1755.0,12,3,1,9,7,9,1,1,0,0,17375,6.8,17802,221,48,-175,-989,22.1,1737.5
4524785732,0,11,2,0,1,9,1,0,0,0,0,14672,6.6,16566,234,58,-2998,-3331,23.4,1467.2,56,1,1,9,1,10,0,0,0,0,17670,7.2,19897,251,50,2998,3331,25.1,1767.0
4526805817,1,14,1,1,10,3,13,1,1,0,1,19716,7.6,20456,219,64,5656,3415,21.9,1971.6,14,0,0,3,10,1,0,0,0,0,14060,6.6,17041,222,50,-5656,-3415,22.2,1406.0
4522484081,0,34,2,0,4,5,5,1,1,0,0,14695,7.2,18082,200,45,-1766,-639,20.0,1469.5,13,2,1,5,4,3,0,0,0,0,16461,7.0,18721,259,56,1766,639,25.9,1646.1
4518324139,0,21,3,0,2,3,2,1,1,0,0,14746,7.0,17859,237,56,-1222,-815,23.7,1474.6,18,2,1,3,2,2,0,0,0,0,15968,7.2,18674,246,44,1222,815,24.6,1596.8
4525563784,0,14,4,1,5,6,6,1,1,0,0,15820,6.8,17954,200,59,40,1340,20.0,1582.0,31,3,0,6,5,8,0,0,0,0,15780,6.6,16614,212,48,-40,-1340,21.2,1578.0
4521393956,0,22,2,0,8,6,9,0,0,0,0,17100,7.2,18774,213,55,825,318,21.3,1710.0,15,2,1,6,8,10,1,1,0,0,16275,7.2,18456,196,56,-825,-318,19.6,1627.5
4523495162,0,12,2,0,9,11,6,0,0,0,0,17389,6.8,17933,226,36,-1428,-656,22.6,1738.9,15,1,1,11,9,12,1,1,0,0,18817,7.0,18589,237,43,1428,656,23.7,1881.7
4450284117,0,14,4,0,6,5,5,0,0,0,0,17160,7.4,18631,240,60,750,1304,24.0,1716.0,28,1,1,5,6,9,0,0,0,0,16410,6.8,17327,230,56,-750,-1304,23.0,1641.0
4471961909,0,14,1,0,6,5,3,1,0,1,0,17039,7.2,18571,228,68,1008,372,22.8,1703.9,38,1,1,5,6,3,0,0,0,0,16031,6.8,18199,218,48,-1008,-372,21.8,1603.1
4522150515,1,24,2,1,5,3,7,0,0,0,0,16344,7.2,19039,238,52,1108,19,23.8,1634.4,38,2,0,3,5,1,2,1,1,0,15236,7.0,19020,244,54,-1108,-19,24.4,1523.6
4523296034,0,41,4,0,4,12,4,0,0,0,0,14957,6.8,17705,173,63,-3881,-447,17.3,1495.7,17,3,1,12,4,12,0,0,0,0,18838,7.0,18152,223,44,3881,447,22.3,1883.8
4519198030,1,17,8,0,8,8,11,0,0,0,0,17178,7.0,18476,216,44,-597,-1198,21.6,1717.8,21,3,1,8,8,6,0,0,0,0,17775,7.4,19674,253,52,597,1198,25.3,1777.5
4498589837,1,16,2,1,5,4,5,2,1,1,0,16548,6.8,18505,226,64,780,523,22.6,1654.8,32,2,0,4,5,5,0,0,0,0,15768,7.0,17982,226,52,-780,-523,22.6,1576.8
4479812747,0,16,5,0,5,8,7,0,0,0,0,16365,6.8,17954,225,51,-1754,-149,22.5,1636.5,16,4,1,8,5,13,1,1,0,0,18119,7.0,18103,243,48,1754,149,24.3,1811.9
4527028313,1,17,3,1,7,5,9,0,0,0,0,17960,7.0,17948,226,71,2873,1850,22.6,1796.0,55,4,0,5,7,9,1,1,0,0,15087,6.4,16098,193,51,-2873,-1850,19.3,1508.7
4522889281,0,12,2,0,3,7,5,0,0,0,0,14690,6.2,15769,191,44,-1753,-3324,19.1,1469.0,26,2,1,7,3,4,0,0,0,0,16443,7.0,19093,210,63,1753,3324,21.0,1644.3
4499897772,1,14,0,1,7,8,10,1,0,1,1,18133,7.0,17764,215,46,1025,-1153,21.5,1813.3,14,0,0,8,7,5,1,1,0,0,17108,6.8,18917,218,54,-1025,1153,21.8,1710.8
4516192998,1,41,4,0,3,5,4,1,1,0,0,15539,6.8,17962,241,55,-244,1250,24.1,1553.9,37,6,1,5,3,3,0,0,0,0,15783,6.8,16712,185,43,244,-1250,18.5,1578.3
4513970902,1,22,3,1,8,6,7,0,0,0,0,18273,7.0,18951,211,49,2879,2522,21.1,1827.3,13,5,0,6,8,7,0,0,0,0,15394,6.4,16429,195,32,-2879,-2522,19.5,1539.4
4511313757,0,13,0,0,4,13,4,0,0,0,0,14979,6.6,16961,194,46,-4686,-2937,19.4,1497.9,14,1,1,13,4,13,1,1,0,0,19665,7.4,19898,208,47,4686,2937,20.8,1966.5
4465091109,0,13,0,0,3,8,1,0,0,0,0,14440,7.0,17275,194,60,-3132,-1630,19.4,1444.0,17,2,1,8,3,6,1,1,0,0,17572,7.0,18905,220,50,3132,1630,22.0,1757.2
4511251323,0,97,7,1,4,4,2,0,0,0,0,15612,6.8,17757,228,41,608,362,22.8,1561.2,42,4,0,4,4,2,1,1,0,0,15004,7.0,17395,208,60,-608,-362,20.8,1500.4
4476204295,0,44,5,1,4,2,7,1,1,0,0,15444,7.0,18334,215,52,-352,176,21.5,1544.4,18,4,0,2,4,3,0,0,0,0,15796,6.8,18158,257,55,352,-176,25.7,1579.6
4522642562,0,16,3,1,10,7,5,1,1,0,0,17454,6.8,18029,204,58,617,128,20.4,1745.4,12,1,0,7,10,5,0,0,0,0,16837,6.8,17901,178,60,-617,-128,17.8,1683.7
4526264918,0,39,1,0,0,4,0,0,0,0,0,13546,6.6,16240,198,63,-2831,-1725,19.8,1354.6,19,5,1,4,0,5,0,0,0,0,16377,7.0,17965,219,51,2831,1725,21.9,1637.7
4515181704,1,17,3,1,7,4,3,0,0,0,0,17116,7.2,18779,245,52,951,-101,24.5,1711.6,16,1,0,4,7,3,1,0,1,0,16165,7.2,18880,252,53,-951,101,25.2,1616.5
4495178301,0,19,3,1,4,3,7,0,0,0,0,15989,6.8,17682,254,48,-77,-1515,25.4,1598.9,15,4,0,3,4,3,2,1,1,0,16066,7.0,19197,250,74,77,1515,25.0,1606.6
4500756552,1,41,2,1,8,4,10,0,0,0,0,16929,7.0,18100,200,48,1134,1146,20.0,1692.9,19,3,0,4,8,3,1,1,0,0,15795,6.6,16954,239,52,-1134,-1146,23.9,1579.5
4525108877,1,48,4,1,4,5,5,1,1,0,0,16579,7.2,19488,249,65,-27,-649,24.9,1657.9,23,10,0,5,4,5,0,0,0,0,16606,7.4,20137,246,72,27,649,24.6,1660.6
4471422338,0,13,5,1,3,9,2,0,0,0,0,14521,6.6,16234,201,42,-2846,-2325,20.1,1452.1,17,1,0,9,3,11,2,1,1,0,17367,7.2,18559,229,48,2846,2325,22.9,1736.7
4462027689,1,16,5,1,6,4,8,1,1,0,1,18395,7.0,19241,236,52,3354,2318,23.6,1839.5,37,3,0,4,6,6,0,0,0,0,15041,6.8,16923,185,52,-3354,-2318,18.5,1504.1
4457611767,1,21,1,1,4,6,4,0,0,0,0,15338,7.0,17842,217,56,-849,-1172,21.7,1533.8,15,2,0,6,4,5,0,0,0,0,16187,7.0,19014,234,46,849,1172,23.4,1618.7
4523735052,0,15,2,0,3,8,2,0,0,0,0,14478,6.6,16879,205,44,-2153,-2381,20.5,1447.8,88,0,1,8,3,8,2,1,1,0,16631,7.2,19260,215,52,2153,2381,21.5,1663.1
4527513157,0,14,5,1,6,3,6,1,1,0,0,15909,6.8,17578,208,43,257,-1125,20.8,1590.9,14,2,0,3,6,0,0,0,0,0,15652,6.8,18703,233,80,-257,1125,23.3,1565.2
4498508859,1,15,0,1,9,6,15,0,0,0,0,18847,7.0,19097,218,68,2197,233,21.8,1884.7,15,2,0,6,9,8,1,1,0,0,16650,7.4,18864,236,44,-2197,-233,23.6,1665.0
4525051102,1,10,3,1,3,4,3,0,0,0,0,15482,6.8,17584,243,47,36,-928,24.3,1548.2,19,2,0,4,3,1,2,1,1,0,15446,7.2,18512,226,67,-36,928,22.6,1544.6
4522306510,1,40,0,0,5,4,7,1,1,0,0,15950,7.2,17916,220,56,-30,-200,22.0,1595.0,13,12,1,4,5,3,1,0,1,0,15980,7.0,18116,238,52,30,200,23.8,1598.0
4523063509,1,14,0,1,5,3,8,1,1,0,0,16395,7.0,17740,214,52,1315,-99,21.4,1639.5,36,1,0,3,5,3,0,0,0,0,15080,7.0,17839,209,54,-1315,99,20.9,1508.0
4480020751,0,17,2,1,5,7,3,0,0,0,0,15286,6.6,16864,181,49,-1936,-646,18.1,1528.6,19,5,0,7,5,7,1,1,0,0,17222,7.0,17510,230,42,1936,646,23.0,1722.2
4524456630,0,14,0,0,7,9,7,1,1,0,0,17308,6.8,17903,198,59,-575,-1680,19.8,1730.8,10,1,1,9,7,6,0,0,0,0,17883,7.0,19583,227,40,575,1680,22.7,1788.3
4458991310,0,18,1,1,6,6,5,1,1,0,0,16196,7.2,18801,214,52,-25,954,21.4,1619.6,14,1,0,6,6,8,0,0,0,0,16221,6.8,17847,217,32,25,-954,21.7,1622.1
4503353744,0,13,1,0,2,9,3,1,0,1,0,15325,6.8,17258,238,53,-2368,-250,23.8,1532.5,16,2,1,9,2,14,1,1,0,0,17693,7.0,17508,201,48,2368,250,20.1,1769.3
4492671924,1,20,2,1,6,4,5,1,1,0,0,16229,7.2,18988,200,62,164,486,20.0,1622.9,15,3,0,4,6,4,0,0,0,0,16065,7.2,18502,230,54,-164,-486,23.0,1606.5
4523085074,0,16,3,1,6,10,12,1,1,0,0,17795,7.0,18362,228,63,426,917,22.8,1779.5,18,2,0,10,6,15,1,0,1,0,17369,6.8,17445,194,40,-426,-917,19.4,1736.9
4378541993,1,16,1,1,5,4,2,0,0,0,0,15215,6.6,16664,212,41,0,-368,21.2,1521.5,37,1,0,4,5,5,1,1,0,0,15215,6.8,17032,197,55,0,368,19.7,1521.5
4521551989,0,14,7,0,1,6,0,0,0,0,0,13167,6.0,15884,213,31,-3400,-3115,21.3,1316.7,38,2,1,6,1,7,2,1,1,0,16567,7.0,18999,229,56,3400,3115,22.9,1656.7
4471429482,1,13,3,1,9,3,13,1,1,0,0,17939,7.2,18687,220,48,3246,409,22.0,1793.9,15,0,0,3,9,0,0,0,0,0,14693,7.0,18278,235,52,-3246,-409,23.5,1469.3
4505476862,1,33,3,1,9,3,9,0,0,0,0,18205,7.4,19871,225,48,4061,3186,22.5,1820.5,12,0,0,3,9,2,1,0,1,0,14144,6.6,16685,187,39,-4061,-3186,18.7,1414.4
4526660217,0,12,4,1,6,5,10,0,0,0,0,16532,6.6,16932,213,58,1920,1140,21.3,1653.2,17,1,0,5,6,9,1,1,0,0,14612,6.4,15792,155,52,-1920,-1140,15.5,1461.2
4478442838,0,16,5,0,10,11,14,0,0,0,0,17056,6.6,17190,167,39,-1603,-1406,16.7,1705.6,19,2,1,11,10,11,2,1,1,0,18659,7.0,18596,229,49,1603,1406,22.9,1865.9
4518609876,0,16,2,0,4,3,2,1,1,0,0,15654,7.2,18324,233,46,-360,-61,23.3,1565.4,10,1,1,3,4,2,1,0,1,0,16014,7.0,18385,254,64,360,61,25.4,1601.4
4515654011,1,16,2,1,4,8,3,1,1,0,0,15672,7.2,17821,238,47,-1599,-1870,23.8,1567.2,21,1,0,8,4,9,1,0,1,0,17271,7.4,19691,236,48,1599,1870,23.6,1727.1
4520952475,0,18,2,0,2,7,1,1,0,1,0,13508,6.2,15002,160,56,-3580,-2967,16.0,1350.8,15,4,1,7,2,6,1,1,0,0,17088,6.6,17969,193,75,3580,2967,19.3,1708.8
4525827145,1,37,4,0,6,6,10,0,0,0,0,17281,7.2,18317,228,53,-65,-433,22.8,1728.1,13,6,1,6,6,6,1,1,0,0,17346,7.2,18750,246,55,65,433,24.6,1734.6
4526242202,1,10,17,1,8,7,6,1,0,1,1,18766,6.8,17630,216,50,2343,-1514,21.6,1876.6,41,1,0,7,8,13,1,1,0,0,16423,7.2,19144,202,55,-2343,1514,20.2,1642.3
4523041821,1,17,4,0,5,5,3,2,1,1,0,16344,7.2,19071,227,64,1168,2292,22.7,1634.4,17,2,1,5,5,3,0,0,0,0,15176,6.8,16779,206,38,-1168,-2292,20.6,1517.6
4437689100,0,17,3,1,8,2,11,0,0,0,0,17666,7.4,19438,241,49,2537,1833,24.1,1766.6,17,1,0,2,8,2,1,1,0,0,15129,7.0,17605,234,54,-2537,-1833,23.4,1512.9
4465556505,1,44,4,0,8,4,9,1,1,0,0,16923,6.8,18443,195,60,2504,2824,19.5,1692.3,17,2,1,4,8,3,0,0,0,0,14419,6.4,15619,199,29,-2504,-2824,19.9,1441.9
4524963317,1,73,0,1,10,3,8,0,0,0,0,18130,7.0,18640,216,41,3905,1506,21.6,1813.0,23,1,0,3,10,3,1,1,0,0,14225,6.8,17134,173,56,-3905,-1506,17.3,1422.5
4467040856,1,14,4,1,6,2,4,0,0,0,0,16636,7.2,18741,225,40,1833,899,22.5,1663.6,16,0,0,2,6,3,1,1,0,0,14803,6.8,17842,201,63,-1833,-899,20.1,1480.3
4472696992,1,19,2,0,5,5,5,0,0,0,0,16853,7.2,18782,233,48,213,-583,23.3,1685.3,33,2,1,5,5,2,0,0,0,0,16640,7.0,19365,249,57,-213,583,24.9,1664.0
4480343563,0,22,0,0,2,5,2,0,0,0,0,14428,6.6,16758,210,67,-1552,-1506,21.0,1442.8,13,0,1,5,2,10,0,0,0,0,15980,6.8,18264,223,57,1552,1506,22.3,1598.0
4521442807,1,46,4,0,6,7,4,0,0,0,0,16526,7.0,18436,215,60,434,740,21.5,1652.6,15,2,1,7,6,3,0,0,0,0,16092,7.0,17696,226,37,-434,-740,22.6,1609.2
4474824262,0,29,0,1,5,4,4,0,0,0,0,15730,6.6,16849,223,49,-384,-1408,22.3,1573.0,10,1,0,4,5,3,1,1,0,0,16114,7.0,18257,220,61,384,1408,22.0,1611.4
4469572120,1,12,1,1,6,7,5,2,1,1,0,16683,7.0,18169,213,58,-73,333,21.3,1668.3,13,1,0,7,6,11,0,0,0,0,16756,6.8,17836,213,47,73,-333,21.3,1675.6
4518106435,0,16,1,0,0,4,0,0,0,0,0,14052,6.6,16542,229,48,-2502,-3183,22.9,1405.2,38,4,1,4,0,4,0,0,0,0,16554,7.0,19725,249,60,2502,3183,24.9,1655.4
4492780458,0,16,6,0,4,8,5,1,0,1,0,15768,6.8,17528,233,48,-1657,-1200,23.3,1576.8,14,4,1,8,4,7,0,0,0,0,17425,7.0,18728,253,44,1657,1200,25.3,1742.5
4523092782,1,19,8,1,6,4,7,0,0,0,0,16852,6.8,18660,239,44,1588,1331,23.9,1685.2,16,3,0,4,6,7,0,0,0,0,15264,6.8,17329,213,54,-1588,-1331,21.3,1526.4
4478250976,0,16,4,0,9,8,8,0,0,0,0,16956,6.8,17632,219,39,-540,238,21.9,1695.6,15,1,1,8,9,8,0,0,0,0,17496,6.8,17394,205,44,540,-238,20.5,1749.6
4487965744,0,37,4,0,3,4,4,1,1,0,0,15306,6.8,16874,220,52,-961,-1427,22.0,1530.6,18,0,1,4,3,1,0,0,0,0,16267,7.2,18301,256,62,961,1427,25.6,1626.7
4526528415,0,15,6,1,3,1,3,0,0,0,0,15392,7.0,17891,232,51,1232,114,23.2,1539.2,23,3,0,1,3,2,1,1,0,0,14160,6.8,17777,223,52,-1232,-114,22.3,1416.0
4458300431,0,18,1,0,3,7,4,0,0,0,0,15298,6.8,17815,223,42,-960,-1574,22.3,1529.8,12,3,1,7,3,4,1,1,0,0,16258,7.2,19389,240,52,960,1574,24.0,1625.8
4517707806,1,18,5,0,4,2,3,1,0,1,0,16697,7.4,19455,235,60,2799,2965,23.5,1669.7,89,5,1,2,4,3,1,1,0,0,13898,6.8,16490,200,44,-2799,-2965,20.0,1389.8
4508452416,1,18,5,0,8,2,4,2,1,1,1,18597,7.2,19612,243,52,4428,3489,24.3,1859.7,19,3,1,2,8,2,0,0,0,0,14169,6.6,16123,221,46,-4428,-3489,22.1,1416.9
4518772710,1,14,4,1,8,5,2,2,1,1,0,18320,7.0,19311,268,55,3413,2303,26.8,1832.0,15,2,0,5,8,7,0,0,0,0,14907,6.6,17008,151,44,-3413,-2303,15.1,1490.7
4519998999,0,14,2,0,0,4,0,1,0,1,0,13805,6.8,17253,221,52,-2009,-2396,22.1,1380.5,59,1,1,4,0,5,1,1,0,0,15814,7.2,19649,243,59,2009,2396,24.3,1581.4
4524703724,1,21,4,1,5,4,4,0,0,0,0,16005,7.0,17430,228,38,1561,621,22.8,1600.5,20,2,0,4,5,6,1,1,0,0,14444,6.6,16809,187,47,-1561,-621,18.7,1444.4
4438263187,1,18,1,1,12,4,15,0,0,0,0,19358,7.2,19257,206,60,3841,2484,20.6,1935.8,14,2,0,4,12,3,0,0,0,0,15517,6.8,16773,216,56,-3841,-2484,21.6,1551.7
4511419534,0,15,4,1,7,7,9,0,0,0,0,16276,6.6,17546,215,40,273,-1195,21.5,1627.6,16,3,0,7,7,2,1,0,1,0,16003,7.2,18741,196,48,-273,1195,19.6,1600.3
4517907839,1,12,3,1,15,5,18,1,1,0,1,20844,7.2,18777,250,39,6672,3761,25.0,2084.4,22,1,0,5,15,4,1,0,1,0,14172,6.0,15016,171,44,-6672,-3761,17.1,1417.2
4507364977,1,18,1,0,6,6,7,1,1,0,0,16621,7.0,19387,206,64,-258,569,20.6,1662.1,14,2,1,6,6,10,0,0,0,0,16879,7.2,18818,225,68,258,-569,22.5,1687.9
4518459736,1,12,1,1,9,4,8,1,0,1,1,19978,7.4,19500,251,54,5201,1656,25.1,1997.8,36,2,0,4,9,2,1,1,0,0,14777,7.0,17844,179,52,-5201,-1656,17.9,1477.7
4515454034,0,16,3,0,4,14,4,0,0,0,0,15001,6.6,16275,205,37,-5120,-4011,20.5,1500.1,46,3,1,14,4,16,1,0,1,0,20121,7.4,20286,233,64,5120,4011,23.3,2012.1
4511953640,1,35,4,1,5,0,5,2,1,1,1,18261,7.4,19979,248,67,4062,2618,24.8,1826.1,37,20,0,0,5,0,0,0,0,0,14199,6.8,17361,228,60,-4062,-2618,22.8,1419.9
4519284907,1,16,3,1,7,2,12,1,1,0,0,16671,6.8,17285,216,48,2644,1400,21.6,1667.1,14,5,0,2,7,1,1,0,1,0,14027,6.4,15885,228,52,-2644,-1400,22.8,1402.7
4496570005,0,16,3,1,8,10,7,1,0,1,0,16901,6.4,16288,176,52,-763,-450,17.6,1690.1,20,2,0,10,8,14,0,0,0,0,17664,6.6,16738,204,27,763,450,20.4,1766.4
4494166965,0,18,2,0,10,11,9,1,1,0,0,18445,7.0,18076,199,50,552,-193,19.9,1844.5,13,3,1,11,10,10,0,0,0,0,17893,7.0,18269,207,36,-552,193,20.7,1789.3
4501131347,1,44,5,1,14,12,14,1,1,0,0,19418,6.8,18520,204,49,1698,2237,20.4,1941.8,21,5,0,12,14,11,1,0,1,0,17720,6.6,16283,167,51,-1698,-2237,16.7,1772.0
4525573622,0,11,1,0,5,10,6,0,0,0,0,15148,6.6,16861,219,40,-4085,-3256,21.9,1514.8,15,0,1,10,5,14,2,1,1,0,19233,7.4,20117,220,60,4085,3256,22.0,1923.3
4510548126,0,16,3,1,4,11,4,0,0,0,0,16314,6.8,16894,250,48,-2665,-900,25.0,1631.4,17,5,0,11,4,14,2,1,1,1,18979,7.0,17794,200,58,2665,900,20.0,1897.9
4524539386,1,14,12,1,6,4,12,1,1,0,0,17733,7.2,19290,221,59,1995,2344,22.1,1773.3,42,3,0,4,6,6,0,0,0,0,15738,6.8,16946,225,44,-1995,-2344,22.5,1573.8
4454501300,0,15,1,1,9,6,5,0,0,0,0,16852,6.6,17417,210,38,348,-1004,21.0,1685.2,15,5,0,6,9,6,1,1,0,0,16504,7.0,18421,216,60,-348,1004,21.6,1650.4
4526583162,1,16,4,1,9,3,13,1,1,0,0,19186,7.2,19737,261,52,4331,3427,26.1,1918.6,14,2,0,3,9,4,0,0,0,0,14855,6.4,16310,199,48,-4331,-3427,19.9,1485.5
4468743739,0,30,2,1,8,8,3,1,0,1,0,17570,7.2,19555,230,60,124,659,23.0,1757.0,16,0,0,8,8,10,1,1,0,0,17446,7.0,18896,215,59,-124,-659,21.5,1744.6
4524511499,0,19,6,1,11,8,9,0,0,0,0,18475,7.4,19732,196,47,1761,1895,19.6,1847.5,19,3,0,8,11,9,1,1,0,0,16714,6.8,17837,196,52,-1761,-1895,19.6,1671.4
4524625875,1,43,2,1,2,6,2,0,0,0,0,14959,7.0,17503,229,48,-2128,-1289,22.9,1495.9,84,5,0,6,2,7,1,1,0,0,17087,7.2,18792,219,51,2128,1289,21.9,1708.7
4523656538,1,141,1,0,4,7,3,1,0,1,0,15964,7.0,18056,199,55,-406,-1050,19.9,1596.4,24,1,1,7,4,5,1,1,0,0,16370,7.2,19106,190,54,406,1050,19.0,1637.0
4516576822,0,18,2,0,5,5,5,0,0,0,0,15364,6.8,17090,198,48,-799,-588,19.8,1536.4,14,3,1,5,5,6,0,0,0,0,16163,6.8,17678,242,44,799,588,24.2,1616.3
4526313173,1,11,3,1,9,4,10,1,1,0,0,17555,6.8,17779,223,56,2875,1386,22.3,1755.5,14,3,0,4,9,4,0,0,0,0,14680,6.4,16393,196,44,-2875,-1386,19.6,1468.0
4515728718,0,11,0,0,5,8,1,0,0,0,0,14589,6.0,15373,195,48,-3750,-4961,19.5,1458.9,66,2,1,8,5,14,1,1,0,0,18339,7.4,20334,229,59,3750,4961,22.9,1833.9
4489945010,0,14,5,0,1,5,2,0,0,0,0,13736,6.6,15897,180,68,-2301,-2659,18.0,1373.6,15,2,1,5,1,3,2,1,1,0,16037,7.2,18556,226,60,2301,2659,22.6,1603.7
4527888798,1,12,3,0,8,4,7,1,0,1,0,16882,7.2,18657,221,35,1632,1767,22.1,1688.2,12,2,1,4,8,4,0,0,0,0,15250,6.6,16890,179,44,-1632,-1767,17.9,1525.0
4451399633,0,16,4,1,10,7,8,0,0,0,0,18410,7.2,19835,241,54,1720,1364,24.1,1841.0,19,3,0,7,10,6,0,0,0,0,16690,7.4,18471,212,46,-1720,-1364,21.2,1669.0
4522408229,1,26,3,1,5,2,4,2,1,1,0,16515,7.2,18870,257,54,1967,1068,25.7,1651.5,17,2,0,2,5,3,0,0,0,0,14548,7.0,17802,233,48,-1967,-1068,23.3,1454.8
4523054835,1,16,6,1,5,4,4,1,1,0,0,15481,6.8,17409,191,65,-253,111,19.1,1548.1,18,2,0,4,5,2,0,0,0,0,15734,6.6,17298,234,55,253,-111,23.4,1573.4
4492947311,0,39,2,1,6,8,8,1,0,1,0,16138,6.8,17626,178,52,-1208,-1365,17.8,1613.8,18,5,0,8,6,7,1,1,0,0,17346,7.2,18991,215,60,1208,1365,21.5,1734.6
4458968842,1,13,3,0,7,10,6,1,0,1,0,16861,6.8,17932,184,35,-1255,-254,18.4,1686.1,85,1,1,10,7,10,0,0,0,0,18116,7.2,18186,195,48,1255,254,19.5,1811.6
4486327611,0,73,3,0,5,16,2,0,0,0,0,14603,6.4,15446,181,39,-6185,-2328,18.1,1460.3,19,7,1,16,5,20,1,1,0,1,20788,7.0,17774,195,29,6185,2328,19.5,2078.8
4524682251,1,16,5,1,10,3,8,1,1,0,0,17953,7.2,18275,213,35,2915,2085,21.3,1795.3,19,2,0,3,10,6,0,0,0,0,15038,6.4,16190,200,48,-2915,-2085,20.0,1503.8
4451877968,1,16,1,1,5,3,4,1,0,1,0,16415,6.8,17432,213,38,1419,82,21.3,1641.5,22,5,0,3,5,2,1,1,0,0,14996,6.8,17350,223,52,-1419,-82,22.3,1499.6
4464530205,0,16,5,0,5,8,5,0,0,0,0,15649,7.0,17079,201,51,-934,-732,20.1,1564.9,17,4,1,8,5,11,1,1,0,0,16583,6.8,17811,216,48,934,732,21.6,1658.3
4462423061,0,14,1,1,7,12,5,0,0,0,0,16125,6.8,17377,196,40,-3290,-2697,19.6,1612.5,17,1,0,12,7,14,0,0,0,0,19415,7.2,20074,231,47,3290,2697,23.1,1941.5
4507582515,1,48,7,1,3,4,3,0,0,0,0,14482,6.8,17114,198,34,-3335,-2502,19.8,1448.2,18,6,0,4,3,4,2,1,1,1,17817,7.2,19616,248,52,3335,2502,24.8,1781.7
4468771669,0,19,3,1,4,9,4,1,0,1,0,15628,6.8,16659,233,42,-2316,-2043,23.3,1562.8,18,4,0,9,4,10,0,0,0,0,17944,7.0,18702,243,40,2316,2043,24.3,1794.4
4524185792,0,14,2,0,13,8,12,1,1,0,0,18043,6.8,17743,186,48,468,302,18.6,1804.3,15,1,1,8,13,9,0,0,0,0,17575,6.8,17441,219,60,-468,-302,21.9,1757.5
4477446374,1,38,4,0,3,1,0,1,1,0,0,15594,7.4,20342,241,72,1402,2404,24.1,1559.4,14,2,1,1,3,1,0,0,0,0,14192,6.8,17938,215,59,-1402,-2404,21.5,1419.2
4523593666,0,16,1,0,5,13,3,1,1,0,0,15151,6.6,16565,204,56,-4570,-3352,20.4,1515.1,33,0,1,13,5,18,1,0,1,0,19721,7.4,19917,207,68,4570,3352,20.7,1972.1
4447744489,1,21,1,1,9,5,10,0,0,0,0,18280,7.0,18115,229,35,4051,1394,22.9,1828.0,19,5,0,5,9,3,1,1,0,0,14229,6.6,16721,211,36,-4051,-1394,21.1,1422.9
4523335344,0,8,3,0,5,11,6,0,0,0,0,14784,6.4,15775,173,40,-3584,-3674,17.3,1478.4,21,0,1,11,5,8,0,0,0,0,18368,7.2,19449,211,60,3584,3674,21.1,1836.8
4465219172,0,57,1,0,4,5,3,1,1,0,0,15288,7.0,18195,242,56,-1538,-320,24.2,1528.8,18,4,1,5,4,9,0,0,0,0,16826,7.0,18515,226,60,1538,320,22.6,1682.6
4519652445,1,10,2,0,2,6,1,0,0,0,0,14542,6.8,17517,234,48,-1751,-1585,23.4,1454.2,15,1,1,6,2,4,1,1,0,0,16293,7.0,19102,229,56,1751,1585,22.9,1629.3
4524921739,0,16,2,1,6,8,11,0,0,0,0,16270,6.8,17661,200,54,-82,117,20.0,1627.0,15,3,0,8,6,4,1,1,0,0,16352,6.8,17544,221,37,82,-117,22.1,1635.2
4499693409,0,58,0,1,8,11,9,0,0,0,0,16708,7.0,17428,193,38,-775,-412,19.3,1670.8,14,5,0,11,8,8,0,0,0,0,17483,7.0,17840,178,44,775,412,17.8,1748.3
4526741895,0,13,4,1,6,8,7,0,0,0,0,17190,6.8,17552,226,44,777,576,22.6,1719.0,17,1,0,8,6,9,0,0,0,0,16413,6.6,16976,190,30,-777,-576,19.0,1641.3
4475707542,1,19,3,1,4,3,5,0,0,0,0,16352,6.8,17852,220,56,1705,177,22.0,1635.2,17,1,0,3,4,2,1,1,0,0,14647,7.0,17675,202,64,-1705,-177,20.2,1464.7
4487946743,0,15,2,0,7,5,8,1,1,0,0,17049,7.4,20151,223,68,-105,1881,22.3,1704.9,14,3,1,5,7,7,0,0,0,0,17154,7.2,18270,231,41,105,-1881,23.1,1715.4
4477479713,1,17,1,1,10,3,8,1,1,0,0,18463,7.4,19599,248,40,3002,2125,24.8,1846.3,10,2,0,3,10,3,1,0,1,0,15461,6.8,17474,218,58,-3002,-2125,21.8,1546.1
4527438398,0,16,5,0,2,5,0,0,0,0,0,14659,6.6,16878,233,46,-492,89,23.3,1465.9,17,1,1,5,2,3,0,0,0,0,15151,6.8,16789,175,48,492,-89,17.5,1515.1
4454836834,0,13,3,0,3,13,2,0,0,0,0,14066,6.4,16007,178,46,-6966,-4723,17.8,1406.6,24,3,1,13,3,12,1,0,1,1,21032,7.6,20730,246,44,6966,4723,24.6,2103.2
4522454983,1,18,2,1,6,6,5,2,1,1,0,16604,7.0,17994,240,56,867,420,24.0,1660.4,16,4,0,6,6,3,0,0,0,0,15737,6.8,17574,205,40,-867,-420,20.5,1573.7
4526297055,1,19,2,0,11,4,10,1,1,0,0,18534,7.2,19784,208,56,2361,2489,20.8,1853.4,16,2,1,4,11,6,0,0,0,0,16173,6.8,17295,233,48,-2361,-2489,23.3,1617.3
4506260681,1,17,8,1,10,9,12,2,1,1,0,17869,6.8,17341,193,46,664,515,19.3,1786.9,22,3,0,9,10,9,0,0,0,0,17205,6.6,16826,202,37,-664,-515,20.2,1720.5
4527366202,1,39,1,0,1,10,1,1,0,1,0,14529,6.6,17127,218,56,-2930,-1894,21.8,1452.9,74,13,1,10,1,17,0,0,0,0,17459,7.2,19021,207,44,2930,1894,20.7,1745.9
4494412133,1,16,0,1,10,4,10,1,0,1,1,19598,7.0,18704,242,44,4864,1938,24.2,1959.8,15,4,0,4,10,5,0,0,0,0,14734,6.8,16766,204,44,-4864,-1938,20.4,1473.4
4523672469,0,13,1,1,8,4,4,1,0,1,0,16959,7.0,19261,215,49,1522,1737,21.5,1695.9,13,3,0,4,8,4,1,1,0,0,15437,6.8,17524,218,42,-1522,-1737,21.8,1543.7
4524307745,1,12,8,0,3,4,2,1,0,1,0,15156,7.0,18116,217,51,-324,1651,21.7,1515.6,21,5,1,4,3,5,1,1,0,0,15480,6.6,16465,220,44,324,-1651,22.0,1548.0
4524262225,0,15,3,0,5,7,3,0,0,0,0,16148,6.8,18119,237,46,-404,-1058,23.7,1614.8,15,2,1,7,5,6,2,1,1,0,16552,7.0,19177,215,53,404,1058,21.5,1655.2
4444365266,0,17,1,0,3,9,3,0,0,0,0,14323,6.4,15853,206,40,-3016,-3479,20.6,1432.3,16,6,1,9,3,4,1,1,0,0,17339,7.0,19332,235,56,3016,3479,23.5,1733.9
4524214871,1,19,1,1,3,8,4,1,0,1,0,15314,7.0,17245,207,61,-1891,-1211,20.7,1531.4,11,5,0,8,3,6,0,0,0,0,17205,7.2,18456,226,44,1891,1211,22.6,1720.5
4494846139,1,14,1,1,9,4,10,0,0,0,0,18689,7.2,19882,235,51,3634,2422,23.5,1868.9,20,4,0,4,9,1,0,0,0,0,15055,6.6,17460,223,47,-3634,-2422,22.3,1505.5
4467862482,1,20,3,0,10,6,11,1,1,0,0,18079,7.2,18997,215,48,1120,10,21.5,1807.9,15,1,1,6,10,3,0,0,0,0,16959,7.0,18987,226,64,-1120,-10,22.6,1695.9
4503836922,1,41,3,0,3,5,3,1,1,0,0,15118,7.2,18628,222,63,-769,891,22.2,1511.8,13,3,1,5,3,9,1,0,1,0,15887,7.0,17737,208,56,769,-891,20.8,1588.7
4449282228,1,12,4,0,5,4,7,1,1,0,0,16488,7.2,18632,220,60,1603,1827,22.0,1648.8,18,3,1,4,5,4,1,0,1,0,14885,6.6,16805,197,44,-1603,-1827,19.7,1488.5
4494894166,1,15,2,1,11,5,8,2,1,1,0,18960,7.4,20136,225,63,3878,2862,22.5,1896.0,15,3,0,5,11,3,0,0,0,0,15082,6.8,17274,204,43,-3878,-2862,20.4,1508.2
4447721358,0,13,0,1,4,3,6,0,0,0,0,15500,7.0,18238,216,44,-403,-26,21.6,1550.0,57,5,0,3,4,3,1,1,0,0,15903,7.0,18264,242,54,403,26,24.2,1590.3
4527487393,0,39,2,1,5,9,6,0,0,0,0,15863,7.0,17499,228,46,-1117,-764,22.8,1586.3,20,2,0,9,5,13,1,1,0,0,16980,7.0,18263,213,42,1117,764,21.3,1698.0
4379931850,0,18,2,0,3,6,3,1,0,1,0,15032,6.6,16832,213,48,-1683,-1363,21.3,1503.2,36,3,1,6,3,6,1,1,0,0,16715,7.0,18195,236,44,1683,1363,23.6,1671.5
4456555871,0,17,3,1,6,5,8,0,0,0,0,17457,7.0,18210,251,64,2783,1603,25.1,1745.7,123,1,0,5,6,8,2,1,1,0,14674,6.6,16607,190,52,-2783,-1603,19.0,1467.4
4487544750,1,26,5,0,8,5,8,1,1,0,0,17346,7.0,18654,208,52,1482,1629,20.8,1734.6,19,0,1,5,8,6,0,0,0,0,15864,6.8,17025,211,47,-1482,-1629,21.1,1586.4
4449290727,0,15,2,0,5,4,6,0,0,0,0,16485,7.2,18714,247,48,577,1501,24.7,1648.5,15,1,1,4,5,5,1,1,0,0,15908,6.8,17213,236,56,-577,-1501,23.6,1590.8
4481186047,1,19,2,0,7,10,9,1,1,0,0,16070,6.6,16577,173,36,-1156,-667,17.3,1607.0,16,4,1,10,7,6,0,0,0,0,17226,6.6,17244,211,42,1156,667,21.1,1722.6
4457608127,0,13,2,0,9,11,13,0,0,0,0,17498,7.2,18569,228,43,-958,264,22.8,1749.8,12,1,1,11,9,18,1,1,0,0,18456,7.2,18305,200,45,958,-264,20.0,1845.6
4455737926,1,19,5,1,10,5,13,1,0,1,0,18560,7.2,19924,244,38,3373,2383,24.4,1856.0,15,3,0,5,10,3,0,0,0,0,15187,6.8,17541,210,44,-3373,-2383,21.0,1518.7
4518030452,0,11,2,1,7,11,11,0,0,0,0,17444,6.4,16497,213,42,-1642,-4442,21.3,1744.4,11,1,0,11,7,16,1,1,0,0,19086,7.6,20939,223,71,1642,4442,22.3,1908.6
4509591728,1,15,3,0,3,9,3,0,0,0,0,15477,7.0,17532,223,56,-1579,-655,22.3,1547.7,61,1,1,9,3,12,1,0,1,0,17056,7.0,18187,192,52,1579,655,19.2,1705.6
4513193579,0,19,4,0,8,14,7,1,0,1,0,16948,6.6,17462,181,44,-5335,-1002,18.1,1694.8,18,3,1,14,8,13,1,1,0,2,22283,7.0,18464,253,34,5335,1002,25.3,2228.3
4451654412,0,14,4,0,1,12,1,0,0,0,0,13453,6.4,15565,215,40,-5403,-4604,21.5,1345.3,25,0,1,12,1,17,1,1,0,0,18856,7.4,20169,232,50,5403,4604,23.2,1885.6
4505242259,1,63,2,0,4,2,4,0,0,0,0,15514,7.2,18840,235,64,-81,882,23.5,1551.4,13,0,1,2,4,1,0,0,0,0,15595,7.0,17958,261,55,81,-882,26.1,1559.5
4519844846,0,15,5,0,5,5,3,1,0,1,0,15882,6.8,16956,241,48,474,393,24.1,1588.2,15,2,1,5,5,6,1,1,0,0,15408,6.4,16563,207,36,-474,-393,20.7,1540.8
4513138341,1,15,1,0,4,6,5,0,0,0,0,15970,7.0,17837,217,55,-703,-653,21.7,1597.0,22,3,1,6,4,6,1,1,0,0,16673,7.2,18490,221,52,703,653,22.1,1667.3
4521309700,0,13,4,0,2,5,3,0,0,0,0,14899,6.8,17481,238,40,-1081,-631,23.8,1489.9,23,2,1,5,2,6,1,1,0,0,15980,6.8,18112,209,60,1081,631,20.9,1598.0
4475476612,1,159,4,0,8,7,5,0,0,0,0,17321,7.6,19677,238,48,703,477,23.8,1732.1,15,1,1,7,8,6,1,1,0,0,16618,7.2,19200,212,68,-703,-477,21.2,1661.8
4515228681,0,17,3,0,1,5,1,0,0,0,0,14758,6.8,17522,245,49,-1277,-1357,24.5,1475.8,20,3,1,5,1,9,2,1,1,0,16035,7.2,18879,223,60,1277,1357,22.3,1603.5
4524916446,0,17,3,0,3,9,5,1,1,0,0,16233,6.4,17101,216,52,-3559,-3823,21.6,1623.3,13,3,1,9,3,6,1,0,1,1,19792,7.6,20924,236,56,3559,3823,23.6,1979.2
4524160140,1,14,1,0,6,7,6,0,0,0,0,15936,6.8,17755,192,46,-1477,-1018,19.2,1593.6,15,3,1,7,6,10,1,1,0,0,17413,7.0,18773,245,53,1477,1018,24.5,1741.3
4491791821,0,13,1,1,4,11,5,0,0,0,0,15144,6.4,16164,197,48,-4293,-3731,19.7,1514.4,15,2,0,11,4,18,0,0,0,0,19437,7.4,19895,241,60,4293,3731,24.1,1943.7
4515217487,1,18,0,1,11,5,11,0,0,0,0,19267,7.2,19780,257,50,2669,2743,25.7,1926.7,10,0,0,5,11,4,2,1,1,0,16598,6.6,17037,205,41,-2669,-2743,20.5,1659.8
4518951602,1,111,4,1,13,10,18,2,1,1,0,19099,6.8,17642,207,30,650,511,20.7,1909.9,27,5,0,10,13,8,0,0,0,0,18449,6.6,17131,204,52,-650,-511,20.4,1844.9
4506376932,0,23,3,0,4,2,5,0,0,0,0,15707,6.8,17968,243,55,428,687,24.3,1570.7,17,5,1,2,4,4,1,1,0,0,15279,6.8,17281,247,42,-428,-687,24.7,1527.9
4458486067,0,14,3,1,6,7,6,0,0,0,0,16643,7.0,18042,232,47,-265,-872,23.2,1664.3,15,1,0,7,6,9,1,1,0,0,16908,7.2,18914,222,60,265,872,22.2,1690.8
4522317391,0,12,17,0,3,8,4,0,0,0,0,15286,6.8,17397,225,47,-2811,-2702,22.5,1528.6,43,2,1,8,3,11,2,1,1,0,18097,7.6,20099,247,68,2811,2702,24.7,1809.7
4510513496,0,15,2,1,8,3,7,0,0,0,0,18103,7.4,19519,247,56,2683,1740,24.7,1810.3,58,3,0,3,8,3,1,1,0,0,15420,7.0,17779,241,52,-2683,-1740,24.1,1542.0
4471057382,0,18,1,0,3,9,3,0,0,0,0,13705,6.4,16018,184,40,-4651,-3870,18.4,1370.5,14,3,1,9,3,8,1,1,0,0,18356,7.2,19888,223,71,4651,3870,22.3,1835.6
4449098612,1,13,2,1,10,6,12,1,1,0,0,18516,7.0,19255,240,58,2019,674,24.0,1851.6,105,1,0,6,10,8,0,0,0,0,16497,7.2,18581,214,49,-2019,-674,21.4,1649.7
4510431880,1,18,12,0,6,3,8,0,0,0,0,16277,6.8,17277,210,36,1434,1040,21.0,1627.7,40,0,1,3,6,4,0,0,0,0,14843,6.6,16237,215,35,-1434,-1040,21.5,1484.3
4457158751,0,17,5,1,7,4,6,1,0,1,0,16460,7.0,18260,241,51,1561,-87,24.1,1646.0,17,4,0,4,7,0,1,1,0,0,14899,7.2,18347,197,77,-1561,87,19.7,1489.9
4525192635,1,14,3,0,6,6,7,2,1,1,0,17074,7.2,17874,214,56,949,591,21.4,1707.4,50,3,1,6,6,6,0,0,0,0,16125,6.8,17283,225,48,-949,-591,22.5,1612.5
4519809162,0,22,4,1,2,11,5,0,0,0,0,14516,6.6,17011,218,52,-3678,-3234,21.8,1451.6,22,3,0,11,2,12,1,1,0,0,18194,7.6,20245,246,52,3678,3234,24.6,1819.4
4524921520,1,25,1,0,5,5,4,0,0,0,0,17003,7.2,18752,252,59,570,368,25.2,1700.3,75,2,1,5,5,4,0,0,0,0,16433,7.2,18384,235,52,-570,-368,23.5,1643.3
4524530241,0,49,0,1,4,4,4,0,0,0,0,15046,6.6,16504,178,48,-557,-832,17.8,1504.6,13,5,0,4,4,6,0,0,0,0,15603,6.6,17336,217,52,557,832,21.7,1560.3
4516732122,0,13,2,0,5,9,3,0,0,0,0,14470,6.6,15760,175,36,-4259,-4262,17.5,1447.0,23,2,1,9,5,9,1,1,0,0,18729,7.4,20022,246,60,4259,4262,24.6,1872.9
4523526937,1,82,4,1,9,5,10,2,1,1,0,17704,7.2,19789,200,52,1241,2416,20.0,1770.4,18,2,0,5,9,6,0,0,0,0,16463,6.8,17373,230,52,-1241,-2416,23.0,1646.3
4504045676,1,16,8,0,6,3,4,1,0,1,0,16443,7.4,19348,261,51,1030,914,26.1,1644.3,42,5,1,3,6,5,1,1,0,0,15413,7.0,18434,235,47,-1030,-914,23.5,1541.3
4526335845,1,17,3,0,5,7,7,0,0,0,0,16281,6.8,17598,216,46,127,-941,21.6,1628.1,16,6,1,7,5,10,2,1,1,0,16154,7.0,18539,194,48,-127,941,19.4,1615.4
4518754842,1,38,4,1,8,3,6,2,1,1,0,17848,7.4,19823,253,56,2450,2233,25.3,1784.8,12,3,0,3,8,3,0,0,0,0,15398,7.0,17590,227,52,-2450,-2233,22.7,1539.8
4467311315,1,91,2,1,8,6,9,1,1,0,0,17001,6.8,17576,187,47,91,-339,18.7,1700.1,16,6,0,6,8,6,0,0,0,0,16910,7.0,17915,237,44,-91,339,23.7,1691.0
4506598189,0,39,3,0,3,7,2,0,0,0,0,13964,6.6,16677,196,37,-4178,-3371,19.6,1396.4,42,16,1,7,3,7,1,1,0,0,18142,7.4,20048,231,66,4178,3371,23.1,1814.2
4516166112,1,13,6,1,10,7,10,0,0,0,0,18431,7.2,19562,207,44,1683,1433,20.7,1843.1,14,3,0,7,10,5,1,1,0,0,16748,7.0,18129,231,56,-1683,-1433,23.1,1674.8
4526164537,0,17,2,0,4,8,4,0,0,0,0,14434,6.6,15829,183,40,-4603,-2667,18.3,1443.4,17,4,1,8,4,11,2,1,1,1,19037,7.0,18496,212,48,4603,2667,21.2,1903.7
4524489570,1,15,1,1,8,5,8,0,0,0,0,17603,7.0,18424,224,60,1835,1172,22.4,1760.3,19,1,0,5,8,7,2,1,1,0,15768,6.8,17252,186,60,-1835,-1172,18.6,1576.8
4472660506,0,11,1,0,2,5,2,0,0,0,0,14258,7.0,17644,216,56,-2760,-1872,21.6,1425.8,17,1,1,5,2,6,2,1,1,0,17018,7.2,19516,248,57,2760,1872,24.8,1701.8
4441403793,0,18,2,1,6,2,7,0,0,0,0,17083,7.2,19485,241,60,2263,1666,24.1,1708.3,24,5,0,2,6,1,1,1,0,0,14820,7.0,17819,250,48,-2263,-1666,25.0,1482.0
4502410789,1,16,3,0,4,4,4,1,1,0,0,16452,7.4,19169,266,60,772,702,26.6,1645.2,39,5,1,4,4,2,0,0,0,0,15680,7.0,18467,215,60,-772,-702,21.5,1568.0
4523635289,1,8,2,1,7,2,6,1,1,0,0,15471,7.4,19583,206,56,708,1840,20.6,1547.1,14,1,0,2,7,2,0,0,0,0,14763,7.0,17743,228,67,-708,-1840,22.8,1476.3
4515305761,0,14,1,1,7,6,7,0,0,0,0,17513,7.2,18336,228,51,1941,846,22.8,1751.3,121,3,0,6,7,5,1,0,1,0,15572,6.6,17490,188,48,-1941,-846,18.8,1557.2
4469425272,1,34,1,1,3,2,6,1,1,0,0,16426,7.0,18180,236,64,2063,708,23.6,1642.6,14,2,0,2,3,6,0,0,0,0,14363,6.6,17472,210,40,-2063,-708,21.0,1436.3
4466040137,1,57,3,0,11,9,13,0,0,0,0,18333,7.0,18622,225,56,736,266,22.5,1833.3,15,2,1,9,11,9,1,1,0,0,17597,7.2,18356,205,44,-736,-266,20.5,1759.7
4520769690,1,43,2,1,6,4,10,1,0,1,0,18369,7.4,20686,276,68,2334,1835,27.6,1836.9,13,17,0,4,6,2,1,1,0,0,16035,7.2,18851,249,68,-2334,-1835,24.9,1603.5
4483768812,1,42,4,0,4,8,7,1,1,0,0,16220,6.8,17447,227,60,-444,-184,22.7,1622.0,58,8,1,8,4,12,0,0,0,0,16664,7.0,17631,212,46,444,184,21.2,1666.4
4468160343,0,20,3,0,2,6,2,1,0,1,0,14869,6.8,17895,238,41,-1642,-703,23.8,1486.9,17,1,1,6,2,8,1,1,0,0,16511,7.2,18598,224,59,1642,703,22.4,1651.1
4447078997,0,17,2,1,8,4,5,0,0,0,0,17898,7.2,18482,247,57,3044,1775,24.7,1789.8,14,4,0,4,8,2,0,0,0,0,14854,6.8,16707,213,36,-3044,-1775,21.3,1485.4
4467720133,1,15,8,1,10,4,10,2,1,1,0,18818,7.4,19037,215,60,4107,1820,21.5,1881.8,18,3,0,4,10,2,0,0,0,0,14711,6.8,17217,209,49,-4107,-1820,20.9,1471.1
4462681802,0,13,2,1,5,12,9,0,0,0,0,15631,6.4,15075,199,36,-2084,-2025,19.9,1563.1,18,2,0,12,5,11,2,1,1,0,17715,7.0,17100,165,52,2084,2025,16.5,1771.5
4440743974,1,15,2,1,11,10,9,2,1,1,0,18504,7.4,19524,226,40,1011,480,22.6,1850.4,17,2,0,10,11,12,0,0,0,0,17493,7.2,19044,187,52,-1011,-480,18.7,1749.3
4523799496,0,11,3,0,7,9,5,1,0,1,0,17528,7.2,19609,234,68,-904,1377,23.4,1752.8,18,1,1,9,7,9,1,1,0,0,18432,7.0,18232,227,40,904,-1377,22.7,1843.2
4472131838,0,15,2,0,6,10,8,0,0,0,0,16231,6.6,16805,179,50,-1535,-838,17.9,1623.1,16,3,1,10,6,11,1,1,0,0,17766,6.8,17643,192,59,1535,838,19.2,1776.6
4503581851,1,20,2,1,7,4,6,0,0,0,0,16745,6.8,17283,210,35,2150,1104,21.0,1674.5,14,4,0,4,7,3,0,0,0,0,14595,6.6,16179,187,50,-2150,-1104,18.7,1459.5
4525228858,1,14,3,1,13,1,10,1,1,0,1,20295,7.2,19531,258,56,6907,4512,25.8,2029.5,15,2,0,1,13,1,0,0,0,0,13388,6.2,15019,178,54,-6907,-4512,17.8,1338.8
4515341076,0,15,5,0,5,8,6,1,1,0,0,15483,6.8,16690,174,54,-1429,-683,17.4,1548.3,25,3,1,8,5,10,0,0,0,0,16912,6.8,17373,225,40,1429,683,22.5,1691.2
4438236114,1,14,1,1,10,8,10,0,0,0,0,17949,7.0,19069,200,47,1052,340,20.0,1794.9,28,2,0,8,10,6,1,1,0,0,16897,7.0,18729,223,60,-1052,-340,22.3,1689.7
4517776491,1,17,4,1,5,3,5,0,0,0,0,17322,7.0,19067,229,63,3005,1938,22.9,1732.2,18,2,0,3,5,4,0,0,0,0,14317,6.4,17129,197,32,-3005,-1938,19.7,1431.7
4459790893,0,8,1,0,5,11,8,0,0,0,0,15127,6.4,16197,193,28,-4099,-4129,19.3,1512.7,10,0,1,11,5,11,0,0,0,0,19226,7.4,20326,225,52,4099,4129,22.5,1922.6
4495614146,1,16,5,1,11,6,19,1,1,0,0,18631,7.4,19229,229,53,3123,3364,22.9,1863.1,17,4,0,6,11,10,0,0,0,0,15508,6.6,15865,194,38,-3123,-3364,19.4,1550.8
4452428266,0,17,0,0,7,9,6,0,0,0,0,15463,6.8,17772,162,44,-2809,-1673,16.2,1546.3,34,2,1,9,7,7,1,1,0,0,18272,7.2,19445,219,68,2809,1673,21.9,1827.2
4479765492,0,17,2,0,6,9,3,0,0,0,0,16331,7.0,18513,229,47,-1081,-953,22.9,1633.1,16,1,1,9,6,9,1,1,0,0,17412,7.2,19466,235,56,1081,953,23.5,1741.2
4519809427,0,12,0,1,4,8,4,0,0,0,0,15337,6.8,17008,186,54,-2284,-3219,18.6,1533.7,17,3,0,8,4,4,1,1,0,0,17621,7.6,20227,230,66,2284,3219,23.0,1762.1
4495582337,1,10,2,0,9,1,13,1,0,1,0,17329,7.0,18182,189,56,2252,1086,18.9,1732.9,16,3,1,1,9,2,0,0,0,0,15077,7.0,17096,244,58,-2252,-1086,24.4,1507.7
4439541078,0,17,4,0,2,6,1,0,0,0,0,14193,7.0,17801,218,43,-3116,-1349,21.8,1419.3,14,4,1,6,2,7,0,0,0,0,17309,7.4,19150,247,71,3116,1349,24.7,1730.9
4496519223,0,15,3,0,1,5,2,0,0,0,0,13983,6.4,15892,214,53,-3832,-3324,21.4,1398.3,15,3,1,5,1,4,2,1,1,1,17815,7.0,19216,276,47,3832,3324,27.6,1781.5
4518980020,0,11,0,0,6,4,3,0,0,0,0,16796,7.4,19792,256,59,311,707,25.6,1679.6,15,3,1,4,6,4,1,1,0,0,16485,7.2,19085,241,66,-311,-707,24.1,1648.5
4515611996,1,17,4,0,2,2,4,1,1,0,0,14639,6.6,17316,237,44,-1767,-2080,23.7,1463.9,41,3,1,2,2,3,0,0,0,0,16406,7.0,19396,258,70,1767,2080,25.8,1640.6
4458615425,0,25,1,0,3,12,2,0,0,0,0,15197,6.8,17692,223,60,-3960,-1446,22.3,1519.7,93,4,1,12,3,15,2,1,1,0,19157,7.0,19138,216,52,3960,1446,21.6,1915.7
4527013199,1,19,3,1,3,2,1,1,1,0,0,14700,6.8,17577,234,40,203,411,23.4,1470.0,15,1,0,2,3,0,0,0,0,0,14497,6.8,17166,253,40,-203,-411,25.3,1449.7
4513819617,0,18,2,1,5,13,8,0,0,0,0,15465,6.0,14469,169,49,-4292,-4133,16.9,1546.5,30,2,0,13,5,13,0,0,0,0,19757,7.2,18602,230,50,4292,4133,23.0,1975.7
4525163715,0,36,6,0,2,12,2,0,0,0,0,13802,6.8,17008,202,52,-5571,-2139,20.2,1380.2,18,20,1,12,2,16,2,1,1,0,19373,7.2,19147,247,48,5571,2139,24.7,1937.3
4413539086,1,23,4,1,11,9,12,1,0,1,1,19858,7.4,19501,216,54,3335,2786,21.6,1985.8,17,3,0,9,11,12,1,1,0,0,16523,6.4,16715,168,46,-3335,-2786,16.8,1652.3
4518948833,1,25,5,1,6,5,9,1,1,0,0,15401,6.6,16508,195,32,-729,-889,19.5,1540.1,18,2,0,5,6,5,0,0,0,0,16130,6.6,17397,191,51,729,889,19.1,1613.0
4472164226,1,14,3,1,11,6,15,1,1,0,0,18606,7.2,19254,214,45,2526,1625,21.4,1860.6,12,2,0,6,11,4,0,0,0,0,16080,7.0,17629,225,48,-2526,-1625,22.5,1608.0
4384342751,1,15,4,0,13,6,15,1,1,0,0,19708,7.2,18711,201,47,5186,2739,20.1,1970.8,17,2,1,6,13,4,0,0,0,0,14522,6.4,15972,170,24,-5186,-2739,17.0,1452.2
4462748470,0,14,2,0,1,6,1,0,0,0,0,13775,6.8,17108,206,52,-2490,-1110,20.6,1377.5,55,3,1,6,1,4,1,1,0,0,16265,7.2,18218,237,52,2490,1110,23.7,1626.5
4523090796,1,18,3,1,13,3,13,2,1,1,1,19807,6.8,17943,220,36,5227,2051,22.0,1980.7,47,7,0,3,13,1,0,0,0,0,14580,6.6,15892,210,47,-5227,-2051,21.0,1458.0
4418034282,0,17,3,0,3,3,3,0,0,0,0,15603,6.8,18354,239,72,288,-339,23.9,1560.3,21,5,1,3,3,2,0,0,0,0,15315,7.0,18693,232,52,-288,339,23.2,1531.5
4515520189,1,38,5,0,11,8,10,0,0,0,0,17819,7.0,18112,232,34,811,376,23.2,1781.9,15,13,1,8,11,14,0,0,0,0,17008,7.0,17736,222,40,-811,-376,22.2,1700.8
4524856340,1,25,3,1,8,5,9,1,1,0,0,17265,6.8,17683,233,43,1726,1423,23.3,1726.5,16,3,0,5,8,11,0,0,0,0,15539,6.4,16260,192,48,-1726,-1423,19.2,1553.9
4506111258,0,43,1,1,4,7,3,0,0,0,0,15871,6.8,17457,234,31,-967,-1216,23.4,1587.1,14,6,0,7,4,8,1,1,0,0,16838,7.2,18673,214,32,967,1216,21.4,1683.8
4519264088,1,15,2,0,5,8,7,0,0,0,0,16519,7.2,19018,210,76,-180,2299,21.0,1651.9,17,1,1,8,5,7,2,1,1,0,16699,6.6,16719,192,48,180,-2299,19.2,1669.9
4494911672,0,17,4,0,4,5,3,1,1,0,0,16675,7.2,18462,240,72,93,1943,24.0,1667.5,18,4,1,5,4,7,0,0,0,0,16582,6.6,16519,209,46,-93,-1943,20.9,1658.2
4464777980,0,19,2,0,5,5,7,1,1,0,0,15051,6.6,16743,188,35,60,323,18.8,1505.1,11,2,1,5,5,4,0,0,0,0,14991,6.8,16420,206,44,-60,-323,20.6,1499.1
4410127520,1,17,15,0,9,3,9,0,0,0,0,18125,7.8,21102,236,48,2828,2738,23.6,1812.5,63,5,1,3,9,2,1,1,0,0,15297,7.2,18364,227,71,-2828,-2738,22.7,1529.7
4424048842,0,22,7,1,6,7,7,0,0,0,0,15952,6.8,17112,180,45,-2049,-2340,18.0,1595.2,46,6,0,7,6,9,0,0,0,0,18001,7.2,19452,243,46,2049,2340,24.3,1800.1
4513297103,0,14,2,0,4,14,4,1,0,1,0,14608,6.0,15029,188,44,-7480,-4460,18.8,1460.8,15,4,1,14,4,15,1,1,0,1,22088,7.4,19489,218,56,7480,4460,21.8,2208.8
4514428234,0,15,4,0,7,6,8,0,0,0,0,16977,6.6,16961,222,43,841,-678,22.2,1697.7,17,1,1,6,7,8,0,0,0,0,16136,6.8,17639,216,40,-841,678,21.6,1613.6
4517778477,1,13,2,1,7,6,12,1,1,0,0,16679,7.0,17760,193,47,273,87,19.3,1667.9,12,3,0,6,7,9,0,0,0,0,16406,6.8,17673,215,48,-273,-87,21.5,1640.6
4496715260,1,15,1,1,7,4,10,0,0,0,0,17527,7.0,18186,227,56,1863,464,22.7,1752.7,18,2,0,4,7,6,1,1,0,0,15664,7.0,17722,231,48,-1863,-464,23.1,1566.4
4524256472,1,23,6,1,7,6,5,1,1,0,0,16898,7.0,17534,226,53,599,267,22.6,1689.8,29,6,0,6,7,7,1,0,1,0,16299,6.8,17267,203,50,-599,-267,20.3,1629.9
4522346713,0,15,2,0,2,5,0,1,0,1,0,13418,6.4,16047,189,52,-2958,-1733,18.9,1341.8,9,3,1,5,2,5,1,1,0,0,16376,7.0,17780,220,63,2958,1733,22.0,1637.6
4477368808,1,14,3,0,5,4,9,2,1,1,0,16364,7.4,19838,245,60,409,1681,24.5,1636.4,13,4,1,4,5,3,0,0,0,0,15955,6.8,18157,229,60,-409,-1681,22.9,1595.5
4523605131,0,14,4,1,11,5,8,1,0,1,0,18060,7.2,18502,192,44,1635,416,19.2,1806.0,15,0,0,5,11,3,0,0,0,0,16425,6.6,18086,204,56,-1635,-416,20.4,1642.5
4477434539,1,34,2,0,7,3,4,1,0,1,0,17993,7.8,20973,253,69,2782,4425,25.3,1799.3,17,4,1,3,7,4,1,1,0,0,15211,6.4,16548,221,57,-2782,-4425,22.1,1521.1
4520017061,1,38,3,1,7,5,6,2,1,1,3,18246,6.8,17783,228,41,3826,3122,22.8,1824.6,15,9,0,5,7,8,0,0,0,0,14420,6.2,14661,156,44,-3826,-3122,15.6,1442.0
4489428547,0,17,2,1,2,3,1,0,0,0,0,15643,6.8,18376,233,72,-1045,169,23.3,1564.3,18,1,0,3,2,3,0,0,0,1,16688,7.2,18207,229,52,1045,-169,22.9,1668.8
4522799084,1,16,3,0,6,6,4,1,0,1,0,16576,7.0,18349,220,36,-316,63,22.0,1657.6,17,4,1,6,6,5,0,0,0,0,16892,7.0,18286,214,50,316,-63,21.4,1689.2
4478517508,1,19,5,1,7,3,13,1,1,0,0,16997,6.8,17603,227,44,2107,1105,22.7,1699.7,17,3,0,3,7,5,0,0,0,0,14890,6.6,16498,220,48,-2107,-1105,22.0,1489.0
4507609718,0,20,1,1,4,12,4,0,0,0,0,15263,6.6,15892,176,47,-2711,-282,17.6,1526.3,15,1,0,12,4,21,1,1,0,0,17974,6.6,16174,186,28,2711,282,18.6,1797.4
4526811185,1,14,3,0,7,5,7,0,0,0,0,16291,7.2,18127,227,39,473,1581,22.7,1629.1,16,1,1,5,7,7,0,0,0,0,15818,6.6,16546,220,32,-473,-1581,22.0,1581.8
4514431388,1,15,4,1,6,5,7,1,1,0,0,15906,7.0,17700,232,39,-39,464,23.2,1590.6,13,5,0,5,6,9,0,0,0,0,15945,6.6,17236,197,45,39,-464,19.7,1594.5
4482429113,0,17,3,1,6,2,5,1,1,0,0,16542,7.0,19007,227,56,1818,1992,22.7,1654.2,19,2,0,2,6,0,0,0,0,0,14724,6.6,17015,234,44,-1818,-1992,23.4,1472.4
4527589984,1,37,3,0,6,5,7,2,1,1,1,17486,7.2,17915,215,52,1389,490,21.5,1748.6,17,3,1,5,6,5,0,0,0,0,16097,6.8,17425,198,71,-1389,-490,19.8,1609.7
4479157446,1,16,2,1,9,5,9,1,1,0,0,18098,7.0,18905,225,60,2217,2183,22.5,1809.8,12,1,0,5,9,3,1,0,1,0,15881,6.6,16722,229,32,-2217,-2183,22.9,1588.1
4524343705,0,16,0,1,8,10,11,0,0,0,0,17524,6.8,16577,209,41,-293,-1855,20.9,1752.4,16,2,0,10,8,11,1,1,0,0,17817,7.2,18432,211,57,293,1855,21.1,1781.7
4524784453,1,18,3,1,5,3,10,1,1,0,0,15717,7.0,17819,211,59,385,-71,21.1,1571.7,21,1,0,3,5,3,0,0,0,0,15332,7.0,17890,231,61,-385,71,23.1,1533.2
4520650445,0,15,6,0,7,5,12,1,0,1,0,16605,6.6,16894,220,39,2046,584,22.0,1660.5,20,5,1,5,7,9,1,1,0,0,14559,6.6,16310,175,44,-2046,-584,17.5,1455.9
4467764577,1,16,3,0,5,4,4,1,1,0,0,15873,7.2,18580,236,44,-14,-19,23.6,1587.3,21,3,1,4,5,4,0,0,0,0,15887,7.2,18599,232,55,14,19,23.2,1588.7
4521755848,0,39,7,1,7,6,6,0,0,0,0,17227,7.0,18842,218,55,1687,2040,21.8,1722.7,17,4,0,6,7,7,1,1,0,0,15540,6.8,16802,205,32,-1687,-2040,20.5,1554.0
4505679661,1,16,1,1,9,3,9,0,0,0,0,17569,6.8,17425,191,61,2975,994,19.1,1756.9,37,1,0,3,9,4,0,0,0,0,14594,6.8,16431,180,53,-2975,-994,18.0,1459.4
4502876897,1,23,1,1,6,10,7,2,1,1,0,17520,7.4,19706,239,73,-1127,471,23.9,1752.0,14,3,0,10,6,10,0,0,0,0,18647,7.2,19235,239,55,1127,-471,23.9,1864.7
4480561507,0,17,4,0,0,5,0,0,0,0,0,14231,6.8,17522,230,64,-2681,-1877,23.0,1423.1,39,4,1,5,0,6,2,1,1,0,16912,7.2,19399,248,56,2681,1877,24.8,1691.2
4462298411,1,21,6,1,6,2,7,1,0,1,0,16836,7.2,19773,242,60,2569,2378,24.2,1683.6,41,4,0,2,6,1,1,1,0,0,14267,6.8,17395,228,45,-2569,-2378,22.8,1426.7
4515363790,0,12,3,0,4,6,1,0,0,0,0,13772,6.0,14954,178,28,-3147,-3323,17.8,1377.2,22,1,1,6,4,6,1,0,1,0,16919,7.0,18277,223,52,3147,3323,22.3,1691.9
4513104795,0,39,6,0,3,5,6,0,0,0,0,15365,6.8,18102,216,60,-1519,-1284,21.6,1536.5,24,2,1,5,3,5,0,0,0,0,16884,7.4,19386,245,59,1519,1284,24.5,1688.4
4505015625,1,16,3,0,7,8,6,0,0,0,0,15257,6.4,16021,191,25,-1860,-720,19.1,1525.7,14,4,1,8,7,9,1,1,0,0,17117,6.6,16741,211,32,1860,720,21.1,1711.7
4504441454,0,15,3,0,6,4,7,1,1,0,0,16080,7.0,17928,218,31,533,1187,21.8,1608.0,17,3,1,4,6,6,0,0,0,0,15547,6.6,16741,219,52,-533,-1187,21.9,1554.7
4500109652,0,13,3,0,6,9,3,0,0,0,0,15398,6.6,17682,184,40,-2115,-1147,18.4,1539.8,13,2,1,9,6,6,0,0,0,0,17513,7.0,18829,233,36,2115,1147,23.3,1751.3
4515532917,0,15,6,1,3,5,5,0,0,0,0,14378,6.4,16230,209,39,-3682,-3599,20.9,1437.8,14,3,0,5,3,2,2,1,1,1,18060,7.4,19829,245,66,3682,3599,24.5,1806.0
4505127174,1,18,2,1,6,2,5,1,1,0,0,16953,7.2,19642,248,52,2348,2678,24.8,1695.3,18,4,0,2,6,3,0,0,0,0,14605,6.6,16964,225,56,-2348,-2678,22.5,1460.5
4521167272,1,18,5,0,15,5,15,1,0,1,1,21056,7.2,19016,206,35,5433,3364,20.6,2105.6,31,4,1,5,15,3,0,0,0,0,15623,6.4,15652,193,53,-5433,-3364,19.3,1562.3
4474784540,0,48,3,1,3,10,1,0,0,0,0,14555,6.6,16626,200,52,-4431,-4570,20.0,1455.5,89,1,0,10,3,12,1,1,0,0,18986,7.6,21196,251,68,4431,4570,25.1,1898.6
4437310963,1,15,4,1,4,6,5,0,0,0,0,15585,6.8,17392,227,46,-797,-843,22.7,1558.5,17,1,0,6,4,7,0,0,0,0,16382,7.0,18235,241,40,797,843,24.1,1638.2
4491275026,0,17,2,0,2,3,2,1,0,1,0,14355,6.8,17580,217,51,59,1149,21.7,1435.5,17,3,1,3,2,6,1,1,0,0,14296,6.6,16431,205,39,-59,-1149,20.5,1429.6
4475394181,0,18,2,1,6,5,2,1,1,0,0,15531,7.0,17915,192,52,-537,176,19.2,1553.1,20,3,0,5,6,5,0,0,0,0,16068,6.8,17739,198,64,537,-176,19.8,1606.8
4522148176,1,35,1,0,7,3,6,2,1,1,0,17555,7.8,20887,248,63,2678,3150,24.8,1755.5,15,1,1,3,7,3,0,0,0,0,14877,7.0,17737,200,58,-2678,-3150,20.0,1487.7
4527378571,0,14,1,0,9,10,14,0,0,0,0,18742,7.0,18884,232,47,46,99,23.2,1874.2,13,2,1,10,9,16,0,0,0,0,18696,7.0,18785,236,49,-46,-99,23.6,1869.6
4516104622,0,17,3,1,3,5,2,0,0,0,0,14666,6.8,17730,215,38,-3315,-2013,21.5,1466.6,21,4,0,5,3,2,2,1,1,1,17981,7.2,19743,257,70,3315,2013,25.7,1798.1
4459701274,0,18,3,0,1,5,1,1,1,0,0,15364,7.0,18462,233,72,-673,-48,23.3,1536.4,12,3,1,5,1,6,0,0,0,0,16037,7.0,18510,206,48,673,48,20.6,1603.7
4486171002,1,11,5,0,4,12,3,0,0,0,0,15639,6.4,17326,227,55,-2608,-1326,22.7,1563.9,19,2,1,12,4,13,0,0,0,0,18247,7.0,18652,198,52,2608,1326,19.8,1824.7
4509353286,1,17,2,0,9,3,8,1,1,0,0,17562,7.0,18512,224,50,1948,764,22.4,1756.2,15,0,1,3,9,6,0,0,0,0,15614,7.0,17748,202,62,-1948,-764,20.2,1561.4
4493885121,1,16,2,0,7,2,7,0,0,0,0,16867,7.2,18880,226,47,2333,1998,22.6,1686.7,14,1,1,2,7,3,1,1,0,0,14534,6.6,16882,224,56,-2333,-1998,22.4,1453.4
4483393050,0,12,2,1,6,6,4,1,1,0,0,15969,7.0,17823,217,36,-1070,-893,21.7,1596.9,15,0,0,6,6,4,0,0,0,0,17039,7.0,18716,254,58,1070,893,25.4,1703.9
4513293548,1,23,1,1,13,7,15,1,1,0,0,18570,7.2,19063,206,51,2093,2151,20.6,1857.0,16,1,0,7,13,11,0,0,0,0,16477,6.6,16912,212,42,-2093,-2151,21.2,1647.7
4521092176,1,29,3,0,11,12,12,1,0,1,0,18983,6.8,17893,211,44,2457,255,21.1,1898.3,34,5,1,12,11,10,1,1,0,0,16526,7.0,17638,175,42,-2457,-255,17.5,1652.6
4526939278,0,15,3,0,8,8,8,0,0,0,0,16488,6.8,17583,217,47,-451,-1201,21.7,1648.8,13,3,1,8,8,4,0,0,0,0,16939,7.0,18784,196,69,451,1201,19.6,1693.9
4473252742,0,14,0,0,7,9,5,0,0,0,0,16474,6.6,17408,209,50,-1559,-407,20.9,1647.4,22,4,1,9,7,13,1,1,0,0,18033,6.8,17815,206,53,1559,407,20.6,1803.3
4496853150,1,14,0,1,5,7,5,1,0,1,0,15135,6.6,17507,176,68,-2497,-1376,17.6,1513.5,12,3,0,7,5,9,1,1,0,0,17632,7.2,18883,231,68,2497,1376,23.1,1763.2
4458223509,0,15,2,0,4,11,6,0,0,0,0,15826,6.8,17438,235,57,-2803,-1709,23.5,1582.6,15,3,1,11,4,12,1,1,0,0,18629,7.0,19147,238,38,2803,1709,23.8,1862.9
4521530556,1,17,1,0,10,5,11,1,1,0,0,17920,7.0,18730,224,51,2536,746,22.4,1792.0,37,4,1,5,10,5,0,0,0,0,15384,7.0,17984,220,48,-2536,-746,22.0,1538.4
4479878134,0,17,2,1,6,5,5,1,1,0,0,17170,7.0,18247,247,48,2453,1802,24.7,1717.0,17,3,0,5,6,4,0,0,0,0,14717,6.6,16445,178,40,-2453,-1802,17.8,1471.7
4526824134,1,13,1,0,5,8,2,1,1,0,0,15424,6.6,16777,218,48,-1668,-866,21.8,1542.4,14,2,1,8,5,10,0,0,0,0,17092,7.2,17643,191,52,1668,866,19.1,1709.2
4517995978,1,16,2,1,4,4,5,1,0,1,1,17073,6.8,17021,221,50,2002,388,22.1,1707.3,14,4,0,4,4,7,0,0,0,0,15071,6.4,16633,203,51,-2002,-388,20.3,1507.1
4519767610,1,17,5,0,6,5,8,0,0,0,0,16285,7.0,17681,230,44,160,-337,23.0,1628.5,16,2,1,5,6,8,0,0,0,0,16125,6.8,18018,204,64,-160,337,20.4,1612.5
4525562740,1,17,9,1,9,6,6,0,0,0,0,16749,6.6,17028,177,64,239,285,17.7,1674.9,19,6,0,6,9,5,0,0,0,0,16510,6.6,16743,219,59,-239,-285,21.9,1651.0
4516815119,1,37,1,0,4,9,5,0,0,0,0,15945,6.8,17648,248,35,-781,289,24.8,1594.5,9,2,1,9,4,10,1,1,0,0,16726,6.8,17359,195,48,781,-289,19.5,1672.6
4492247014,0,13,2,1,8,6,9,1,1,0,0,16138,6.6,16973,195,40,611,-139,19.5,1613.8,11,2,0,6,8,5,0,0,0,0,15527,6.8,17112,215,43,-611,139,21.5,1552.7
4515783776,1,33,4,0,1,3,0,0,0,0,0,14339,6.8,17922,234,60,-1327,-825,23.4,1433.9,18,1,1,3,1,5,1,1,0,0,15666,7.2,18747,241,50,1327,825,24.1,1566.6
4527887542,1,19,1,1,10,2,12,0,0,0,0,18274,6.8,19011,232,49,4693,2968,23.2,1827.4,16,1,0,2,10,1,0,0,0,0,13581,6.4,16043,179,45,-4693,-2968,17.9,1358.1
4503813130,1,15,0,1,7,8,3,0,0,0,0,16058,7.0,17194,200,49,-535,1397,20.0,1605.8,14,1,0,8,7,5,1,1,0,0,16593,6.6,15797,198,40,535,-1397,19.8,1659.3
4465354125,1,13,1,1,7,5,9,1,1,0,0,17627,7.0,19004,204,64,1794,927,20.4,1762.7,11,1,0,5,7,7,0,0,0,0,15833,7.0,18077,194,64,-1794,-927,19.4,1583.3
4476394657,1,21,1,1,12,5,10,0,0,0,0,18876,7.0,18737,218,63,3210,3591,21.8,1887.6,11,5,0,5,12,6,0,0,0,1,15666,6.0,15146,184,32,-3210,-3591,18.4,1566.6
4526491541,0,17,5,1,8,8,11,1,1,0,0,17399,7.0,17937,245,44,381,865,24.5,1739.9,18,2,0,8,8,9,0,0,0,0,17018,6.4,17072,237,36,-381,-865,23.7,1701.8
4441748703,1,26,1,1,10,6,9,1,1,0,0,17252,7.0,18227,212,40,1154,999,21.2,1725.2,15,1,0,6,10,5,0,0,0,0,16098,7.0,17228,220,42,-1154,-999,22.0,1609.8
4515709123,1,12,2,0,1,4,1,1,0,1,0,15710,6.8,18022,247,72,1151,1870,24.7,1571.0,37,1,1,4,1,3,0,0,0,0,14559,6.0,16152,170,60,-1151,-1870,17.0,1455.9
4525037711,0,18,4,1,3,4,2,1,0,1,0,15888,7.4,19090,252,60,16,433,25.2,1588.8,39,4,0,4,3,2,1,1,0,0,15872,7.0,18657,243,49,-16,-433,24.3,1587.2
4521615656,1,14,0,0,7,4,4,1,1,0,0,16775,7.0,18235,221,55,1753,2303,22.1,1677.5,19,3,1,4,7,7,0,0,0,0,15022,6.4,15932,213,45,-1753,-2303,21.3,1502.2
4524476983,0,15,0,1,5,11,6,0,0,0,0,15812,6.6,16319,209,56,-2150,-1215,20.9,1581.2,13,3,0,11,5,18,1,1,0,0,17962,6.8,17534,175,66,2150,1215,17.5,1796.2
4523865628,0,44,3,1,4,7,5,1,1,0,0,15920,6.6,17523,234,57,-1138,-1025,23.4,1592.0,37,19,0,7,4,8,0,0,0,0,17058,7.0,18548,237,41,1138,1025,23.7,1705.8
4452056525,0,15,0,1,3,4,2,1,1,0,0,14451,6.6,16951,213,42,-341,-1582,21.3,1445.1,14,1,0,4,3,3,0,0,0,0,14792,7.2,18533,231,38,341,1582,23.1,1479.2
4518945702,0,15,2,0,1,4,1,1,1,0,0,13934,6.8,17303,222,55,-1571,-693,22.2,1393.4,15,0,1,4,1,6,0,0,0,0,15505,7.0,17996,191,61,1571,693,19.1,1550.5
4470053265,0,15,2,0,0,3,0,0,0,0,0,14183,6.8,17942,243,64,-975,334,24.3,1418.3,15,2,1,3,0,5,1,1,0,0,15158,7.0,17608,206,48,975,-334,20.6,1515.8
4467058840,1,18,5,0,9,12,5,0,0,0,0,17484,7.2,18682,222,52,-978,-535,22.2,1748.4,16,5,1,12,9,13,1,1,0,0,18462,7.0,19217,213,49,978,535,21.3,1846.2
4462358723,0,15,4,1,5,7,2,0,0,0,0,15210,6.4,15974,172,40,-1656,-1832,17.2,1521.0,13,5,0,7,5,3,0,0,0,0,16866,6.8,17806,219,51,1656,1832,21.9,1686.6
4516360817,0,37,6,1,6,8,7,0,0,0,0,16595,7.2,18766,217,57,-829,289,21.7,1659.5,19,1,0,8,6,10,2,1,1,0,17424,7.2,18477,220,62,829,-289,22.0,1742.4
4494950726,0,69,2,1,5,11,5,1,1,0,0,15633,6.8,17179,193,54,-2947,-2189,19.3,1563.3,17,1,0,11,5,13,0,0,0,0,18580,7.2,19368,224,43,2947,2189,22.4,1858.0
4521220052,1,14,1,1,7,4,2,1,1,0,0,15924,7.0,17965,211,45,961,1114,21.1,1592.4,13,2,0,4,7,3,0,0,0,0,14963,6.6,16851,199,38,-961,-1114,19.9,1496.3
4511072676,0,19,6,0,5,4,6,1,1,0,0,16534,7.2,18294,260,44,131,-613,26.0,1653.4,31,3,1,4,5,5,0,0,0,0,16403,7.0,18907,233,64,-131,613,23.3,1640.3
4447490163,0,18,3,1,4,8,3,0,0,0,0,15043,6.6,16533,207,34,-2816,-2760,20.7,1504.3,16,5,0,8,4,10,1,1,0,0,17859,7.2,19293,232,57,2816,2760,23.2,1785.9
4455235066,1,15,1,1,13,5,10,0,0,0,0,19485,7.4,19900,196,58,3823,2563,19.6,1948.5,12,2,0,5,13,5,0,0,0,0,15662,6.6,17337,201,44,-3823,-2563,20.1,1566.2
4525093722,1,17,2,1,15,7,19,1,1,0,0,20833,7.6,20278,231,36,4882,2906,23.1,2083.3,14,3,0,7,15,5,0,0,0,0,15951,6.8,17372,202,44,-4882,-2906,20.2,1595.1
4524232031,1,36,2,1,6,10,6,1,1,0,0,15385,6.6,16039,210,48,-3134,-2772,21.0,1538.5,17,2,0,10,6,8,0,0,0,0,18519,7.0,18811,232,47,3134,2772,23.2,1851.9
4521616991,1,23,3,1,5,1,6,1,1,0,0,17196,7.2,19002,239,64,2973,1440,23.9,1719.6,17,7,0,1,5,2,0,0,0,0,14223,6.8,17562,239,48,-2973,-1440,23.9,1422.3
4520348374,1,24,3,1,6,6,12,0,0,0,1,17552,6.8,16611,201,45,1189,-821,20.1,1755.2,97,5,0,6,6,5,1,0,1,0,16363,6.8,17432,191,55,-1189,821,19.1,1636.3
4525639504,1,13,3,1,7,5,6,1,1,0,0,16319,7.4,19461,218,55,1110,1898,21.8,1631.9,16,3,0,5,7,4,0,0,0,0,15209,6.8,17563,198,44,-1110,-1898,19.8,1520.9
4513108171,0,14,1,1,8,7,8,1,0,1,0,17562,6.8,18086,203,49,1269,739,20.3,1756.2,14,2,0,7,8,9,1,1,0,0,16293,6.8,17347,199,48,-1269,-739,19.9,1629.3
4523611140,1,15,1,1,7,2,7,2,1,1,0,17325,7.6,20228,238,71,2905,2774,23.8,1732.5,15,0,0,2,7,3,0,0,0,0,14420,6.6,17454,222,52,-2905,-2774,22.2,1442.0
4500515300,0,16,7,0,4,9,5,1,0,1,0,15599,6.4,16288,219,45,-2231,-857,21.9,1559.9,20,6,1,9,4,16,1,1,0,0,17830,6.8,17145,214,44,2231,857,21.4,1783.0
4525849637,1,16,1,0,5,11,5,0,0,0,0,15871,6.6,16394,200,56,-3162,-23,20.0,1587.1,15,8,1,11,5,15,0,0,0,1,19033,6.4,16417,195,36,3162,23,19.5,1903.3
4523576298,1,14,4,1,8,3,7,1,1,0,0,16595,7.2,18940,210,55,859,2681,21.0,1659.5,21,1,0,3,8,7,0,0,0,0,15736,6.4,16259,203,39,-859,-2681,20.3,1573.6
4438793603,0,14,3,1,10,4,13,0,0,0,0,18978,7.6,21014,262,56,4185,3377,26.2,1897.8,52,4,0,4,10,3,0,0,0,0,14793,6.8,17637,205,52,-4185,-3377,20.5,1479.3
4459498926,0,15,4,1,9,8,9,0,0,0,0,17649,7.0,17906,207,40,1579,578,20.7,1764.9,10,3,0,8,9,8,0,0,0,0,16070,6.8,17328,209,36,-1579,-578,20.9,1607.0
4488648117,0,26,3,0,4,5,3,0,0,0,0,14925,7.0,18636,218,49,-1375,-850,21.8,1492.5,16,7,1,5,4,4,1,1,0,0,16300,7.6,19486,220,76,1375,850,22.0,1630.0
4520798666,0,16,3,1,5,2,5,0,0,0,0,15048,6.4,16614,182,48,384,872,18.2,1504.8,18,5,0,2,5,2,1,1,0,0,14664,6.6,15742,229,48,-384,-872,22.9,1466.4
4452824310,0,13,6,1,5,6,8,2,1,1,0,17035,7.0,18139,230,63,851,327,23.0,1703.5,21,3,0,6,5,6,0,0,0,0,16184,6.6,17812,219,52,-851,-327,21.9,1618.4
4505326762,0,18,4,0,10,6,14,0,0,0,0,18270,7.0,18940,234,50,1927,495,23.4,1827.0,15,2,1,6,10,7,2,1,1,0,16343,7.0,18445,224,49,-1927,-495,22.4,1634.3
4513426543,1,39,3,0,10,6,10,1,1,0,0,17831,7.2,19052,198,48,2233,3109,19.8,1783.1,14,2,1,6,10,9,0,0,0,0,15598,6.6,15943,204,40,-2233,-3109,20.4,1559.8
4510723615,0,15,2,0,3,6,4,1,1,0,0,15698,7.0,18184,226,61,-1556,-887,22.6,1569.8,36,3,1,6,3,7,0,0,0,0,17254,7.0,19071,237,57,1556,887,23.7,1725.4
4497647239,1,13,1,1,8,6,8,2,1,1,1,18239,7.0,17409,199,46,2258,-819,19.9,1823.9,42,0,0,6,8,5,0,0,0,0,15981,7.0,18228,211,50,-2258,819,21.1,1598.1
4502908431,0,58,2,0,10,9,19,1,1,0,0,17583,7.0,17639,201,48,-236,-1078,20.1,1758.3,23,2,1,9,10,13,0,0,0,0,17819,7.2,18717,225,60,236,1078,22.5,1781.9
4524687163,0,18,6,1,8,3,14,1,1,0,0,18022,7.0,18610,242,56,2958,983,24.2,1802.2,18,0,0,3,8,2,0,0,0,0,15064,7.0,17627,226,44,-2958,-983,22.6,1506.4
4496572605,0,20,6,1,6,4,11,0,0,0,0,16527,7.0,17257,225,44,1338,-385,22.5,1652.7,41,3,0,4,6,7,0,0,0,0,15189,7.0,17642,191,52,-1338,385,19.1,1518.9
4458587612,0,13,2,0,2,9,1,0,0,0,0,14442,6.6,16650,202,48,-4719,-2129,20.2,1444.2,18,1,1,9,2,10,1,1,0,1,19161,7.0,18779,225,48,4719,2129,22.5,1916.1
4489431595,0,16,2,0,6,5,6,0,0,0,0,16262,7.2,18196,207,68,591,192,20.7,1626.2,16,3,1,5,6,5,1,1,0,0,15671,7.0,18004,217,55,-591,-192,21.7,1567.1
4516768381,1,19,3,1,6,10,6,1,0,1,0,15826,7.0,17062,196,42,-2296,-1677,19.6,1582.6,16,5,0,10,6,9,1,1,0,0,18122,6.8,18739,243,45,2296,1677,24.3,1812.2
4521497074,0,30,1,0,7,10,7,1,1,0,0,17088,7.0,18568,201,60,-793,606,20.1,1708.8,16,1,1,10,7,9,0,0,0,0,17881,7.0,17962,221,48,793,-606,22.1,1788.1
4518125489,0,16,5,1,7,4,9,0,0,0,0,16667,7.0,18043,223,43,1465,201,22.3,1666.7,20,0,0,4,7,6,1,1,0,0,15202,7.0,17842,218,52,-1465,-201,21.8,1520.2
4468831873,1,14,2,0,4,9,4,1,1,0,0,16263,6.6,16904,220,44,-1190,-1443,22.0,1626.3,14,1,1,9,4,9,0,0,0,0,17453,7.0,18347,208,46,1190,1443,20.8,1745.3
4484877784,0,18,5,0,3,8,2,1,1,0,0,14905,6.8,17974,233,52,-3282,-1647,23.3,1490.5,18,3,1,8,3,12,0,0,0,0,18187,7.4,19621,225,52,3282,1647,22.5,1818.7
4524874155,1,16,4,0,4,6,3,1,1,0,0,14554,6.8,16715,198,44,-2814,-2772,19.8,1455.4,17,0,1,6,4,5,0,0,0,0,17368,7.4,19487,228,64,2814,2772,22.8,1736.8
4524850918,1,38,4,1,8,9,10,1,0,1,0,17558,6.8,17905,202,44,-483,-427,20.2,1755.8,56,4,0,9,8,9,1,1,0,0,18041,7.2,18332,205,48,483,427,20.5,1804.1
4518035441,1,17,0,0,4,7,4,2,1,1,0,15132,6.8,16489,190,64,-2022,-2023,19.0,1513.2,14,2,1,7,4,7,0,0,0,0,17154,7.2,18512,242,44,2022,2023,24.2,1715.4
4476350140,1,20,1,0,9,9,10,1,1,0,0,17569,6.8,17411,228,37,-116,-303,22.8,1756.9,18,4,1,9,9,11,1,0,1,0,17685,7.0,17714,207,45,116,303,20.7,1768.5
4497452633,1,17,4,0,9,5,7,0,0,0,0,17959,7.6,20494,239,56,1696,2266,23.9,1795.9,19,5,1,5,9,3,1,1,0,0,16263,6.8,18228,225,56,-1696,-2266,22.5,1626.3
4454242326,0,12,5,0,4,5,6,0,0,0,0,16580,7.6,20102,236,72,409,2037,23.6,1658.0,38,1,1,5,4,6,0,0,0,0,16171,7.0,18065,211,46,-409,-2037,21.1,1617.1
4500305709,0,15,2,0,6,10,8,1,1,0,0,15875,7.0,18029,191,60,-2901,-1904,19.1,1587.5,17,1,1,10,6,8,0,0,0,0,18776,7.2,19933,230,56,2901,1904,23.0,1877.6
4518127728,0,15,1,1,4,8,3,0,0,0,0,15525,6.6,16079,198,60,-1784,-2938,19.8,1552.5,35,2,0,8,4,7,0,0,0,0,17309,7.0,19017,227,48,1784,2938,22.7,1730.9
4517812260,1,42,5,1,10,6,9,2,1,1,0,18747,7.2,19584,225,53,3015,3067,22.5,1874.7,14,5,0,6,10,5,0,0,0,0,15732,6.8,16517,184,60,-3015,-3067,18.4,1573.2
4523282194,0,17,1,0,4,5,5,1,1,0,0,16391,7.2,18597,233,60,153,713,23.3,1639.1,14,3,1,5,4,8,0,0,0,0,16238,7.0,17884,236,45,-153,-713,23.6,1623.8
4516073213,1,10,1,1,8,7,5,1,1,0,0,17325,7.0,19648,246,55,744,1657,24.6,1732.5,15,0,0,7,8,6,1,0,1,0,16581,6.8,17991,216,36,-744,-1657,21.6,1658.1
4499861575,1,20,3,1,7,5,8,1,1,0,0,18042,7.0,19223,239,68,2006,346,23.9,1804.2,15,2,0,5,7,4,1,0,1,0,16036,7.2,18877,222,56,-2006,-346,22.2,1603.6
4501213837,1,19,4,0,2,5,2,0,0,0,0,13337,6.4,15472,197,43,-4427,-3299,19.7,1333.7,15,6,1,5,2,5,1,1,0,1,17764,7.2,18771,236,48,4427,3299,23.6,1776.4
4526906717,1,105,6,1,4,3,0,0,0,0,0,15960,7.4,18912,253,60,1479,2350,25.3,1596.0,15,3,0,3,4,3,0,0,0,0,14481,6.4,16562,228,40,-1479,-2350,22.8,1448.1
4502582060,1,17,4,0,4,3,7,1,1,0,0,15162,6.6,16973,195,49,-243,-465,19.5,1516.2,21,2,1,3,4,4,0,0,0,0,15405,6.6,17438,235,53,243,465,23.5,1540.5
4450233213,1,13,5,1,4,6,4,0,0,0,1,17814,7.0,18330,252,56,2154,25,25.2,1781.4,14,1,0,6,4,4,1,0,1,0,15660,7.0,18305,197,48,-2154,-25,19.7,1566.0
4513224745,1,16,2,1,10,9,12,0,0,0,0,18340,7.0,18533,201,54,1899,896,20.1,1834.0,16,2,0,9,10,9,0,0,0,0,16441,6.8,17637,198,40,-1899,-896,19.8,1644.1
4502464132,0,87,3,1,7,4,7,1,1,0,0,16723,6.8,17764,193,52,2568,3054,19.3,1672.3,18,1,0,4,7,6,0,0,0,0,14155,6.2,14710,183,28,-2568,-3054,18.3,1415.5
4522612481,0,14,1,1,7,5,7,1,1,0,0,16747,7.0,18330,202,48,482,-670,20.2,1674.7,12,0,0,5,7,2,0,0,0,0,16265,7.2,19000,225,60,-482,670,22.5,1626.5
4521424727,0,17,3,1,7,6,6,0,0,0,0,16778,7.0,17473,205,59,1153,282,20.5,1677.8,18,2,0,6,7,9,1,1,0,0,15625,6.6,17191,203,52,-1153,-282,20.3,1562.5
4524641094,1,37,3,0,8,5,13,0,0,0,0,17129,6.8,17579,227,32,1192,449,22.7,1712.9,15,3,1,5,8,7,0,0,0,0,15937,6.8,17130,225,48,-1192,-449,22.5,1593.7
4523304085,1,20,3,1,6,9,6,2,1,1,0,15874,6.4,16649,195,48,-1806,-2407,19.5,1587.4,21,4,0,9,6,11,0,0,0,0,17680,7.2,19056,228,58,1806,2407,22.8,1768.0
4495296529,1,15,2,1,3,3,2,0,0,0,0,15563,7.2,18747,252,42,446,429,25.2,1556.3,18,2,0,3,3,2,0,0,0,0,15117,6.8,18318,229,62,-446,-429,22.9,1511.7
4499276253,0,13,2,0,1,2,2,0,0,0,0,12884,6.4,15586,174,40,-2825,-3105,17.4,1288.4,16,2,1,2,1,4,1,1,0,0,15709,7.0,18691,239,63,2825,3105,23.9,1570.9
4523567216,1,18,5,1,6,5,3,0,0,0,0,16279,7.0,18977,234,49,190,-57,23.4,1627.9,18,6,0,5,6,6,2,1,1,0,16089,7.2,19034,218,68,-190,57,21.8,1608.9
4435716100,0,17,4,0,14,11,16,1,0,1,0,19868,7.0,19587,201,58,2782,4548,20.1,1986.8,92,1,1,11,14,18,1,1,0,0,17086,6.4,15039,157,36,-2782,-4548,15.7,1708.6
4523463399,0,16,3,1,3,9,4,0,0,0,0,14725,6.6,16460,200,38,-2959,-2726,20.0,1472.5,19,3,0,9,3,9,0,0,0,0,17684,7.0,19186,213,48,2959,2726,21.3,1768.4
4522814409,0,14,2,0,3,12,2,0,0,0,0,14769,6.4,16504,205,45,-4374,-2570,20.5,1476.9,14,3,1,12,3,13,0,0,0,0,19143,7.0,19074,209,53,4374,2570,20.9,1914.3
4522792360,0,30,6,1,5,5,7,1,0,1,0,16804,6.8,17544,217,67,769,480,21.7,1680.4,16,4,0,5,5,6,1,1,0,0,16035,6.4,17064,233,54,-769,-480,23.3,1603.5
4523297583,1,38,5,1,4,3,3,2,1,1,0,15211,7.0,18741,200,64,464,1520,20.0,1521.1,16,7,0,3,4,2,0,0,0,0,14747,6.8,17221,242,41,-464,-1520,24.2,1474.7
4505912615,1,19,2,1,6,0,9,0,0,0,0,18307,7.4,19628,235,69,5027,3394,23.5,1830.7,56,3,0,0,6,0,0,0,0,0,13280,6.4,16234,211,53,-5027,-3394,21.1,1328.0
4489197870,0,12,2,1,7,2,8,0,0,0,0,17490,7.6,19737,259,66,2880,3031,25.9,1749.0,15,1,0,2,7,2,0,0,0,0,14610,6.6,16706,215,50,-2880,-3031,21.5,1461.0
4523042890,1,15,3,1,5,6,4,0,0,0,0,17024,7.2,19195,254,63,901,1182,25.4,1702.4,12,2,0,6,5,7,0,0,0,0,16123,6.8,18013,214,48,-901,-1182,21.4,1612.3
4472346713,0,13,1,1,5,5,0,0,0,0,0,15850,7.0,18559,216,52,144,312,21.6,1585.0,16,1,0,5,5,4,1,1,0,0,15706,7.2,18247,238,56,-144,-312,23.8,1570.6
4477340034,0,20,2,0,3,6,3,1,0,1,0,14840,6.8,17620,226,56,-2579,-626,22.6,1484.0,15,5,1,6,3,9,0,0,0,0,17419,7.0,18246,245,56,2579,626,24.5,1741.9
4494978251,0,14,5,0,5,5,7,1,1,0,0,16291,6.8,17415,211,56,-699,-580,21.1,1629.1,39,1,1,5,5,3,1,0,1,1,16990,6.8,17995,218,44,699,580,21.8,1699.0
4525624857,0,19,4,1,4,11,3,0,0,0,0,15017,6.6,16114,203,52,-2936,-2856,20.3,1501.7,15,3,0,11,4,12,1,1,0,0,17953,7.2,18970,232,44,2936,2856,23.2,1795.3
4502893432,1,18,1,0,5,6,6,1,0,1,0,15987,7.0,17964,207,44,-155,-47,20.7,1598.7,12,4,1,6,5,6,0,0,0,0,16142,7.0,18011,231,39,155,47,23.1,1614.2
4519435886,0,14,4,1,3,3,3,0,0,0,0,15209,7.0,17965,201,48,-325,9,20.1,1520.9,16,2,0,3,3,6,0,0,0,0,15534,7.0,17956,246,47,325,-9,24.6,1553.4
4523455175,0,19,8,0,9,10,6,1,1,0,0,16898,7.0,17791,211,44,-540,1330,21.1,1689.8,22,3,1,10,9,14,0,0,0,0,17438,6.6,16461,190,36,540,-1330,19.0,1743.8
4490068433,0,18,3,1,4,6,6,1,1,0,0,16410,6.8,18121,236,60,75,644,23.6,1641.0,16,5,0,6,4,7,0,0,0,0,16335,7.0,17477,201,58,-75,-644,20.1,1633.5
4514274061,0,16,1,0,5,5,7,0,0,0,0,14486,6.6,15962,170,29,-3299,-2719,17.0,1448.6,18,4,1,5,5,4,2,1,1,0,17785,7.0,18681,256,68,3299,2719,25.6,1778.5
4493419240,0,13,3,0,3,8,4,0,0,0,0,14443,6.6,16433,198,40,-2166,-2885,19.8,1444.3,18,5,1,8,3,5,1,0,1,0,16609,7.0,19318,188,55,2166,2885,18.8,1660.9
4519814636,1,19,3,1,5,5,7,1,1,0,0,16345,7.0,17851,230,46,1284,-1614,23.0,1634.5,17,2,0,5,5,3,1,0,1,0,15061,7.2,19465,200,43,-1284,1614,20.0,1506.1
4524643923,1,18,3,1,5,6,2,0,0,0,0,16113,6.8,17058,231,39,-105,-896,23.1,1611.3,16,3,0,6,5,6,1,1,0,0,16218,7.0,17954,217,50,105,896,21.7,1621.8
4490937979,0,17,3,0,5,3,3,1,1,0,0,16494,7.0,19149,255,66,1932,2097,25.5,1649.4,16,1,1,3,5,3,0,0,0,0,14562,6.6,17052,182,52,-1932,-2097,18.2,1456.2
4524496142,0,14,2,0,1,2,1,1,1,0,0,14722,7.2,18209,254,64,-455,-1,25.4,1472.2,14,0,1,2,1,0,1,0,1,0,15177,7.2,18210,263,46,455,1,26.3,1517.7
4508266227,1,19,4,1,8,7,11,2,1,1,0,17937,7.0,18340,227,65,1063,553,22.7,1793.7,17,4,0,7,8,7,0,0,0,0,16874,7.2,17787,226,48,-1063,-553,22.6,1687.4
4516825936,1,11,2,1,5,5,4,1,0,1,0,16185,6.8,17330,212,52,-226,-262,21.2,1618.5,13,3,0,5,5,10,1,1,0,0,16411,6.8,17592,228,60,226,262,22.8,1641.1
4441700608,1,12,3,0,9,7,8,1,1,0,0,17684,7.4,19834,224,48,620,146,22.4,1768.4,30,2,1,7,9,5,1,0,1,0,17064,7.2,19688,197,68,-620,-146,19.7,1706.4
4524754524,0,15,2,0,3,8,2,0,0,0,0,13875,6.6,16394,209,36,-3866,-1987,20.9,1387.5,23,3,1,8,3,10,1,1,0,0,17741,7.2,18381,227,47,3866,1987,22.7,1774.1
4524313588,0,11,4,0,3,10,1,0,0,0,0,14863,6.8,17880,222,59,-3630,668,22.2,1486.3,20,2,1,10,3,15,2,1,1,0,18493,6.8,17212,216,50,3630,-668,21.6,1849.3
4476858063,1,23,4,0,7,4,8,0,0,0,0,16798,7.0,18520,225,45,916,780,22.5,1679.8,17,3,1,4,7,4,0,0,0,0,15882,7.0,17740,236,48,-916,-780,23.6,1588.2
4478115052,0,42,2,0,6,5,7,1,0,1,0,17098,7.4,20021,243,54,447,919,24.3,1709.8,89,1,1,5,6,6,0,0,0,0,16651,7.0,19102,220,67,-447,-919,22.0,1665.1
4452033699,0,17,3,0,7,11,12,0,0,0,0,17131,7.2,18470,242,34,-2550,-1700,24.2,1713.1,14,1,1,11,7,7,0,0,0,1,19681,7.2,20170,258,37,2550,1700,25.8,1968.1
4521314116,1,16,10,1,4,2,4,0,0,0,0,15532,6.8,17669,227,47,240,131,22.7,1553.2,41,1,0,2,4,2,0,0,0,0,15292,6.8,17538,240,56,-240,-131,24.0,1529.2
4515525902,1,15,4,1,9,4,15,1,1,0,0,18144,6.8,18210,224,52,1834,281,22.4,1814.4,40,2,0,4,9,4,0,0,0,0,16310,7.0,17929,231,42,-1834,-281,23.1,1631.0
4513970313,0,14,2,0,5,5,4,0,0,0,0,15888,6.8,18144,218,52,-149,645,21.8,1588.8,14,0,1,5,5,4,1,1,0,0,16037,6.6,17499,204,55,149,-645,20.4,1603.7
4497598810,0,15,1,1,2,4,1,0,0,0,0,15193,7.0,17619,252,48,-610,-1156,25.2,1519.3,39,1,0,4,2,6,1,1,0,0,15803,7.4,18775,215,60,610,1156,21.5,1580.3
4492378749,0,89,2,1,3,5,3,1,0,1,1,17159,7.0,18318,250,56,1075,525,25.0,1715.9,19,4,0,5,3,7,1,1,0,0,16084,7.0,17793,225,48,-1075,-525,22.5,1608.4
4521648781,1,20,3,1,10,6,11,0,0,0,0,19000,7.2,18915,233,39,1259,-60,23.3,1900.0,17,5,0,6,10,7,0,0,0,0,17741,7.0,18975,264,44,-1259,60,26.4,1774.1
4525106974,1,18,4,0,8,4,10,0,0,0,0,16870,7.2,18433,207,36,1417,1016,20.7,1687.0,16,1,1,4,8,3,1,0,1,0,15453,6.8,17417,221,48,-1417,-1016,22.1,1545.3
4458685012,1,15,3,1,9,3,11,0,0,0,0,18584,7.0,18383,203,70,3093,1285,20.3,1858.4,17,2,0,3,9,5,0,0,0,0,15491,6.8,17098,212,41,-3093,-1285,21.2,1549.1
4484202806,0,12,3,0,4,10,1,0,0,0,0,14816,6.6,16519,218,46,-4490,-3582,21.8,1481.6,15,0,1,10,4,6,2,1,1,1,19306,7.4,20101,247,56,4490,3582,24.7,1930.6
4494986980,0,14,3,0,0,9,0,0,0,0,0,13345,6.6,15982,230,42,-5508,-3648,23.0,1334.5,38,3,1,9,0,10,1,1,0,1,18853,7.2,19630,235,57,5508,3648,23.5,1885.3
4497717401,0,14,1,0,5,8,3,0,0,0,0,16367,7.2,18191,254,48,-1204,-717,25.4,1636.7,42,3,1,8,5,8,1,1,0,0,17571,7.0,18908,218,56,1204,717,21.8,1757.1
4496436861,1,14,16,1,8,2,9,0,0,0,0,16708,7.2,18529,230,41,1860,1500,23.0,1670.8,41,4,0,2,8,3,0,0,0,0,14848,6.6,17029,226,50,-1860,-1500,22.6,1484.8
4451716191,0,17,5,0,9,10,7,0,0,0,0,17407,7.2,18451,214,44,222,1716,21.4,1740.7,19,2,1,10,9,13,0,0,0,0,17185,6.6,16735,205,40,-222,-1716,20.5,1718.5
4510935065,1,23,3,0,6,5,8,2,1,1,0,17178,7.0,18411,234,74,2614,2285,23.4,1717.8,16,2,1,5,6,2,0,0,0,0,14564,6.4,16126,170,52,-2614,-2285,17.0,1456.4
4506869531,1,18,0,1,3,7,5,0,0,0,0,14995,7.0,17661,240,50,-2442,-1250,24.0,1499.5,25,1,0,7,3,11,1,1,0,0,17437,7.2,18911,264,38,2442,1250,26.4,1743.7
4474429080,0,18,4,0,5,6,5,0,0,0,0,15923,7.0,17907,212,62,-228,-387,21.2,1592.3,20,5,1,6,5,5,1,1,0,0,16151,7.0,18294,230,48,228,387,23.0,1615.1
4508411042,0,17,3,0,6,13,6,0,0,0,0,15166,6.6,15761,162,44,-3865,-2920,16.2,1516.6,21,2,1,13,6,17,1,1,0,0,19031,7.0,18681,204,52,3865,2920,20.4,1903.1
4505269056,0,14,3,0,4,6,5,1,1,0,0,15382,7.0,17876,218,56,-1182,-944,21.8,1538.2,18,1,1,6,4,4,1,0,1,0,16564,7.0,18820,207,54,1182,944,20.7,1656.4
4525225774,1,16,2,1,6,4,6,1,0,1,1,18341,7.2,19885,229,76,3347,2958,22.9,1834.1,16,4,0,4,6,8,1,1,0,0,14994,6.6,16927,206,47,-3347,-2958,20.6,1499.4
4495300852,1,15,5,1,13,3,13,0,0,0,0,20183,7.6,20925,239,48,5712,4581,23.9,2018.3,14,3,0,3,13,3,0,0,0,0,14471,6.6,16344,208,36,-5712,-4581,20.8,1447.1
4526817312,1,16,1,1,4,3,5,0,0,0,0,16425,7.0,17611,227,44,2167,538,22.7,1642.5,16,1,0,3,4,4,1,1,0,0,14258,6.8,17073,208,46,-2167,-538,20.8,1425.8
4493010632,1,18,3,1,7,6,7,1,1,0,0,16874,6.8,16967,225,53,2411,1563,22.5,1687.4,57,1,0,6,7,9,0,0,0,0,14463,6.4,15404,164,35,-2411,-1563,16.4,1446.3
4515245246,1,16,2,1,7,9,14,2,1,1,0,16571,6.2,14758,192,32,-684,-2401,19.2,1657.1,13,2,0,9,7,16,0,0,0,0,17255,6.8,17159,187,54,684,2401,18.7,1725.5
4524424120,0,13,1,1,9,8,11,0,0,0,0,16187,6.2,15234,156,30,-229,-487,15.6,1618.7,17,1,0,8,9,11,1,1,0,0,16416,6.2,15721,169,33,229,487,16.9,1641.6
4481608154,1,19,6,1,7,5,5,0,0,0,0,18047,7.2,18160,239,59,2175,506,23.9,1804.7,20,6,0,5,7,4,1,1,0,0,15872,6.8,17654,229,60,-2175,-506,22.9,1587.2
4497064417,1,14,2,1,10,1,10,2,1,1,0,19847,7.2,20768,250,64,6658,6189,25.0,1984.7,11,0,0,1,10,2,0,0,0,0,13189,6.2,14579,166,55,-6658,-6189,16.6,1318.9
4510149205,0,15,1,1,7,6,10,0,0,0,0,15889,7.0,18326,228,32,-1253,17,22.8,1588.9,16,3,0,6,7,7,0,0,0,0,17142,7.0,18309,225,44,1253,-17,22.5,1714.2
4480094113,0,13,1,0,11,16,10,0,0,0,0,17901,6.8,16538,171,44,-2529,-1607,17.1,1790.1,17,2,1,16,11,17,1,0,1,0,20430,7.0,18145,205,36,2529,1607,20.5,2043.0
4475660855,1,32,4,1,10,9,7,0,0,0,0,17584,6.4,16118,159,47,316,-1561,15.9,1758.4,39,2,0,9,10,8,0,0,0,0,17268,6.6,17679,202,47,-316,1561,20.2,1726.8
4523346192,0,13,1,0,5,7,5,1,0,1,0,15814,6.8,17936,229,39,-1706,-685,22.9,1581.4,13,3,1,7,5,10,1,1,0,0,17520,7.0,18621,238,68,1706,685,23.8,1752.0
4521199121,0,13,1,0,0,4,0,0,0,0,0,14211,7.0,17395,227,63,-1725,-1169,22.7,1421.1,50,3,1,4,0,7,1,1,0,0,15936,7.0,18564,230,55,1725,1169,23.0,1593.6
4524762045,1,33,0,1,9,1,10,1,1,0,0,17101,7.0,18332,207,42,3157,1899,20.7,1710.1,16,5,0,1,9,0,0,0,0,0,13944,6.4,16433,239,35,-3157,-1899,23.9,1394.4
4469372506,0,14,3,1,7,4,6,0,0,0,0,16157,6.8,17238,201,44,68,-369,20.1,1615.7,18,0,0,4,7,7,1,1,0,0,16089,7.0,17607,213,58,-68,369,21.3,1608.9
4464746011,1,13,4,0,8,4,6,1,1,0,0,16558,6.8,18174,238,36,241,-363,23.8,1655.8,23,2,1,4,8,6,0,0,0,0,16317,7.0,18537,222,66,-241,363,22.2,1631.7
4510518816,0,15,2,0,1,3,3,0,0,0,0,14626,6.6,17441,229,56,-1547,-916,22.9,1462.6,15,2,1,3,1,4,2,1,1,0,16173,7.2,18357,246,60,1547,916,24.6,1617.3
4513252060,0,15,2,0,3,4,4,0,0,0,0,15013,6.6,16860,212,56,-741,-637,21.2,1501.3,16,4,1,4,3,7,1,1,0,0,15754,6.8,17497,225,55,741,637,22.5,1575.4
4475474933,1,14,4,1,8,4,7,0,0,0,1,17634,6.8,17330,219,45,1930,425,21.9,1763.4,17,1,0,4,8,5,0,0,0,0,15704,6.4,16905,226,46,-1930,-425,22.6,1570.4
4524597902,1,15,1,1,10,9,13,1,1,0,0,18217,6.6,16663,190,44,1674,-648,19.0,1821.7,17,2,0,9,10,7,0,0,0,0,16543,7.0,17311,192,36,-1674,648,19.2,1654.3
4522150564,1,18,2,0,5,8,6,1,1,0,0,16313,7.0,17908,211,60,-531,241,21.1,1631.3,14,3,1,8,5,4,1,0,1,0,16844,6.8,17667,205,48,531,-241,20.5,1684.4
4522525839,0,15,3,1,6,6,6,0,0,0,0,17256,7.0,18564,236,47,823,-164,23.6,1725.6,15,2,0,6,6,7,0,0,0,0,16433,7.0,18728,230,48,-823,164,23.0,1643.3
4477903272,1,12,2,1,4,6,6,0,0,0,0,15575,6.8,17478,236,44,-1098,271,23.6,1557.5,17,1,0,6,4,10,0,0,0,0,16673,6.8,17207,245,39,1098,-271,24.5,1667.3
4480001106,1,34,3,1,10,6,9,0,0,0,0,17687,7.2,19488,197,67,1729,2306,19.7,1768.7,18,0,0,6,10,5,0,0,0,0,15958,6.8,17182,194,48,-1729,-2306,19.4,1595.8
4518674001,1,23,5,1,7,2,10,1,1,0,0,17693,7.2,18485,241,54,3712,2007,24.1,1769.3,18,2,0,2,7,4,0,0,0,0,13981,6.6,16478,196,49,-3712,-2007,19.6,1398.1
4502635512,1,17,6,1,10,1,9,1,1,0,0,18484,7.0,19140,230,54,3439,3469,23.0,1848.4,15,2,0,1,10,1,0,0,0,0,15045,6.4,15671,218,46,-3439,-3469,21.8,1504.5
4513473008,1,44,5,0,5,2,7,1,1,0,0,17126,6.8,17880,248,53,1936,448,24.8,1712.6,16,4,1,2,5,2,0,0,0,0,15190,6.8,17432,230,71,-1936,-448,23.0,1519.0
4453493719,0,63,1,1,3,2,2,0,0,0,0,15640,7.0,18748,246,65,77,630,24.6,1564.0,15,4,0,2,3,4,1,1,0,0,15563,7.0,18118,248,62,-77,-630,24.8,1556.3
4516554886,0,10,8,0,3,6,2,0,0,0,0,14998,7.0,17859,218,60,-993,-1150,21.8,1499.8,39,3,1,6,3,6,1,1,0,0,15991,7.0,19009,236,55,993,1150,23.6,1599.1
4525838366,0,16,6,0,2,7,1,0,0,0,0,14284,7.0,17853,243,40,-3304,-1505,24.3,1428.4,20,3,1,7,2,8,1,1,0,0,17588,7.2,19358,237,67,3304,1505,23.7,1758.8
4524880851,0,17,0,0,5,2,6,1,0,1,0,15894,6.8,18026,222,61,409,1405,22.2,1589.4,18,3,1,2,5,3,1,1,0,0,15485,6.8,16621,241,56,-409,-1405,24.1,1548.5
4521828179,0,15,2,0,8,9,10,1,1,0,0,17617,7.0,18094,217,50,685,1449,21.7,1761.7,14,0,1,9,8,12,0,0,0,0,16932,6.6,16645,180,56,-685,-1449,18.0,1693.2
4505938604,0,16,1,0,8,9,6,0,0,0,0,16972,7.2,19143,198,64,-1832,-386,19.8,1697.2,37,1,1,9,8,10,1,1,0,0,18804,7.4,19529,230,60,1832,386,23.0,1880.4
4525633564,1,15,4,1,10,9,12,2,1,1,0,17676,6.8,17633,186,67,1209,1019,18.6,1767.6,39,2,0,9,10,7,0,0,0,0,16467,6.8,16614,189,39,-1209,-1019,18.9,1646.7
4509170584,0,17,4,0,4,3,6,0,0,0,0,14353,6.8,17197,178,48,-1009,-280,17.8,1435.3,17,4,1,3,4,1,1,1,0,0,15362,6.8,17477,222,62,1009,280,22.2,1536.2
4462163208,1,43,1,0,9,8,11,1,1,0,0,16982,7.0,18420,191,44,-1346,-1607,19.1,1698.2,15,0,1,8,9,7,0,0,0,0,18328,7.4,20027,212,76,1346,1607,21.2,1832.8
4481684110,0,17,1,1,6,7,12,1,0,1,0,17191,6.8,17872,227,45,-355,-1775,22.7,1719.1,12,1,0,7,6,8,0,0,0,0,17546,7.2,19647,204,64,355,1775,20.4,1754.6
4515338624,0,13,1,0,5,11,8,0,0,0,0,15979,6.8,16648,190,39,-3456,-1429,19.0,1597.9,15,1,1,11,5,15,2,1,1,0,19435,7.0,18077,189,44,3456,1429,18.9,1943.5
4515353277,1,18,3,1,6,10,8,0,0,0,0,16481,6.8,17069,201,48,-1334,-1607,20.1,1648.1,14,4,0,10,6,12,1,1,0,0,17815,7.2,18676,198,44,1334,1607,19.8,1781.5
4523717454,0,22,1,1,2,0,4,1,0,1,0,14931,6.6,17257,215,53,1295,-80,21.5,1493.1,16,4,0,0,2,0,1,1,0,0,13636,7.0,17337,230,51,-1295,80,23.0,1363.6
4510087493,0,40,4,1,1,8,3,0,0,0,0,13802,6.4,15735,212,40,-4177,-2986,21.2,1380.2,15,3,0,8,1,9,1,1,0,0,17979,7.0,18721,247,43,4177,2986,24.7,1797.9
4527497632,1,15,8,1,7,14,5,0,0,0,0,16467,6.6,16438,190,41,-4264,-4127,19.0,1646.7,35,3,0,14,7,19,1,1,0,0,20731,7.4,20565,245,44,4264,4127,24.5,2073.1
4522524149,0,39,1,0,4,12,5,0,0,0,0,14899,6.8,16761,190,36,-5515,-3391,19.0,1489.9,19,2,1,12,4,19,0,0,0,0,20414,7.4,20152,239,44,5515,3391,23.9,2041.4
4517159658,0,14,2,0,5,6,4,1,0,1,0,15983,6.8,17562,222,51,-276,179,22.2,1598.3,16,3,1,6,5,8,0,0,0,0,16259,6.8,17383,189,48,276,-179,18.9,1625.9
4509228650,1,16,1,1,9,3,6,1,1,0,0,18558,7.2,19625,269,51,3958,3881,26.9,1855.8,12,1,0,3,9,4,1,0,1,0,14600,6.4,15744,194,43,-3958,-3881,19.4,1460.0
4510955458,0,12,4,1,3,8,2,0,0,0,0,14783,6.2,15957,206,50,-1905,-2223,20.6,1478.3,18,3,0,8,3,5,1,1,0,0,16688,7.0,18180,224,60,1905,2223,22.4,1668.8
4473786370,0,19,4,0,4,4,6,1,1,0,0,15867,6.6,17723,186,71,-1595,-1648,18.6,1586.7,21,1,1,4,4,4,0,0,0,0,17462,7.2,19371,253,64,1595,1648,25.3,1746.2
4524168146,1,11,3,1,9,7,12,2,1,1,0,17091,6.8,17740,214,40,940,503,21.4,1709.1,18,0,0,7,9,6,0,0,0,0,16151,6.8,17237,210,48,-940,-503,21.0,1615.1
4527017223,1,17,4,1,9,6,9,0,0,0,0,18050,6.6,17022,220,28,2847,1559,22.0,1805.0,20,1,0,6,9,6,1,1,0,0,15203,6.2,15463,176,52,-2847,-1559,17.6,1520.3
4520328098,1,20,4,1,5,4,6,0,0,0,0,15887,6.8,16554,201,44,231,-446,20.1,1588.7,21,3,0,4,5,4,0,0,0,0,15656,6.4,17000,210,44,-231,446,21.0,1565.6
4521333183,0,17,1,0,1,2,2,0,0,0,0,13863,6.8,17182,219,40,-1336,-1242,21.9,1386.3,16,3,1,2,1,1,1,1,0,0,15199,7.0,18424,226,75,1336,1242,22.6,1519.9
4522573873,0,20,8,1,4,6,8,0,0,0,0,17569,6.8,17848,265,40,1613,80,26.5,1756.9,16,4,0,6,4,4,2,1,1,0,15956,6.8,17768,214,60,-1613,-80,21.4,1595.6
4477707123,1,18,4,1,7,5,6,1,1,0,0,16099,7.0,18219,203,48,873,678,20.3,1609.9,15,4,0,5,7,2,0,0,0,0,15226,6.8,17541,208,44,-873,-678,20.8,1522.6
4495493566,0,15,3,1,6,8,8,0,0,0,1,18235,6.8,17856,229,52,517,-151,22.9,1823.5,17,4,0,8,6,11,1,0,1,0,17718,6.8,18007,213,41,-517,151,21.3,1771.8
4510326831,1,15,5,1,3,5,3,0,0,0,0,15135,7.0,17610,213,59,-1161,-1685,21.3,1513.5,16,5,0,5,3,8,0,0,0,0,16296,7.4,19295,251,58,1161,1685,25.1,1629.6
4494785966,1,14,3,0,4,6,7,1,0,1,0,16685,7.0,18643,236,71,289,-201,23.6,1668.5,18,2,1,6,4,4,1,1,0,0,16396,7.0,18844,234,52,-289,201,23.4,1639.6
4524676649,1,14,2,1,9,3,11,1,1,0,0,18519,7.2,18891,260,49,4756,3562,26.0,1851.9,16,2,0,3,9,3,0,0,0,0,13763,6.4,15329,196,24,-4756,-3562,19.6,1376.3
4481802992,0,19,6,1,8,6,12,1,1,0,0,16058,6.4,15685,178,40,-1441,-2022,17.8,1605.8,18,4,0,6,8,10,0,0,0,0,17499,6.8,17707,240,60,1441,2022,24.0,1749.9
4523058868,0,15,5,0,5,5,7,0,0,0,0,15799,7.0,17703,225,49,56,-694,22.5,1579.9,37,2,1,5,5,4,1,1,0,0,15743,7.2,18397,208,59,-56,694,20.8,1574.3
4487337497,0,13,1,1,6,5,9,1,1,0,0,16995,7.0,18679,230,64,930,567,23.0,1699.5,18,2,0,5,6,3,0,0,0,0,16065,7.0,18112,221,43,-930,-567,22.1,1606.5
4510972926,0,14,2,1,8,9,7,0,0,0,0,16617,7.0,17480,184,44,-985,-1441,18.4,1661.7,21,2,0,9,8,7,1,1,0,0,17602,7.2,18921,222,55,985,1441,22.2,1760.2
4518605903,1,16,6,0,6,9,7,0,0,0,0,17286,7.2,18839,222,61,431,625,22.2,1728.6,13,2,1,9,6,7,1,1,0,0,16855,7.0,18214,193,43,-431,-625,19.3,1685.5
4478736587,0,12,5,0,3,7,3,0,0,0,0,15992,6.8,17572,251,52,-1323,-1622,25.1,1599.2,18,1,1,7,3,10,2,1,1,0,17315,7.2,19194,218,60,1323,1622,21.8,1731.5
4500037487,1,37,2,0,7,7,4,0,0,0,0,15312,6.6,16667,174,36,-1785,-1581,17.4,1531.2,11,2,1,7,7,4,2,1,1,0,17097,7.0,18248,216,68,1785,1581,21.6,1709.7
4456161907,0,146,3,1,2,4,1,0,0,0,0,14848,6.8,17467,205,65,-132,119,20.5,1484.8,15,2,0,4,2,3,1,1,0,0,14980,6.8,17348,213,44,132,-119,21.3,1498.0
4455180442,1,14,13,1,12,3,10,1,1,0,0,19537,7.8,20680,246,51,4932,3923,24.6,1953.7,40,1,0,3,12,2,0,0,0,0,14605,6.6,16757,212,48,-4932,-3923,21.2,1460.5
4502370552,1,14,0,1,6,10,8,0,0,0,0,15091,6.2,14181,172,48,-2623,-3436,17.2,1509.1,10,1,0,10,6,15,1,1,0,0,17714,6.8,17617,211,49,2623,3436,21.1,1771.4
4467307786,0,16,2,0,7,9,8,0,0,0,0,15615,6.8,17025,188,39,-3370,-2779,18.8,1561.5,20,2,1,9,7,7,1,0,1,0,18985,7.2,19804,250,52,3370,2779,25.0,1898.5
4522622334,0,55,2,0,6,7,8,2,1,1,0,16289,6.8,17723,208,56,-963,-64,20.8,1628.9,14,6,1,7,6,11,0,0,0,0,17252,7.0,17787,230,56,963,64,23.0,1725.2
4503591121,1,17,6,0,7,8,7,1,1,0,0,17459,6.8,17773,209,56,-1,-459,20.9,1745.9,42,5,1,8,7,6,0,0,0,0,17460,6.8,18232,231,52,1,459,23.1,1746.0
4451008750,1,24,2,1,6,5,6,0,0,0,0,15871,6.6,17106,195,45,-245,-278,19.5,1587.1,14,2,0,5,6,6,1,1,0,0,16116,7.0,17384,221,45,245,278,22.1,1611.6
4448344869,1,16,5,1,8,3,8,0,0,0,0,17605,7.2,19955,247,40,2897,3195,24.7,1760.5,17,1,0,3,8,2,0,0,0,0,14708,6.6,16760,223,44,-2897,-3195,22.3,1470.8
4524960112,0,12,12,1,4,8,6,0,0,0,0,15263,6.8,16941,203,50,-2548,-2906,20.3,1526.3,33,5,0,8,4,14,1,1,0,0,17811,7.2,19847,232,62,2548,2906,23.2,1781.1
4479632045,0,16,5,1,2,3,2,0,0,0,0,14698,6.8,17544,208,69,-501,-1154,20.8,1469.8,37,2,0,3,2,2,1,1,0,0,15199,7.2,18698,227,59,501,1154,22.7,1519.9
4527368382,0,21,0,1,8,6,9,1,1,0,0,16338,6.4,16019,191,32,-577,-2221,19.1,1633.8,15,2,0,6,8,5,0,0,0,0,16915,7.2,18240,204,64,577,2221,20.4,1691.5
4498537692,1,37,8,1,7,4,8,0,0,0,0,16708,7.2,19294,212,45,1371,1179,21.2,1670.8,14,1,0,4,7,4,0,0,0,0,15337,6.8,18115,238,39,-1371,-1179,23.8,1533.7
4456001530,1,17,3,0,2,1,2,0,0,0,0,15031,6.8,17787,246,48,421,-160,24.6,1503.1,14,3,1,1,2,1,1,1,0,0,14610,6.8,17947,239,55,-421,160,23.9,1461.0
4489698898,0,16,7,1,12,12,16,1,1,0,0,18655,6.8,18368,173,51,-942,244,17.3,1865.5,63,4,0,12,12,15,0,0,0,0,19597,6.8,18124,226,48,942,-244,22.6,1959.7
4500568254,1,14,3,1,6,3,6,0,0,0,0,16195,7.0,17940,214,35,2254,1870,21.4,1619.5,14,1,0,3,6,1,0,0,0,0,13941,6.2,16070,193,56,-2254,-1870,19.3,1394.1
4478776750,0,50,4,1,4,4,9,1,1,0,0,15317,6.6,16907,226,52,-1300,-120,22.6,1531.7,18,2,0,4,4,7,1,0,1,1,16617,6.8,17027,211,48,1300,120,21.1,1661.7
4523749055,1,15,3,0,10,6,9,2,1,1,2,19197,7.2,18449,219,53,2941,1850,21.9,1919.7,15,6,1,6,10,6,0,0,0,0,16256,6.6,16599,192,52,-2941,-1850,19.2,1625.6
4521167934,1,16,2,1,6,3,3,0,0,0,0,16454,7.0,18902,228,63,1510,1545,22.8,1645.4,13,0,0,3,6,2,1,1,0,0,14944,7.0,17357,222,60,-1510,-1545,22.2,1494.4
4503380070,0,12,3,0,6,4,7,0,0,0,0,16438,6.8,16989,203,32,608,-85,20.3,1643.8,19,2,1,4,6,4,1,1,0,0,15830,6.8,17074,206,44,-608,85,20.6,1583.0
4510668822,0,13,1,0,6,9,8,0,0,0,0,15087,6.6,17017,177,43,-3782,-3060,17.7,1508.7,14,1,1,9,6,10,1,1,0,0,18869,7.4,20077,245,65,3782,3060,24.5,1886.9
4515792807,0,14,3,1,7,6,7,0,0,0,0,16835,7.0,18378,220,52,700,814,22.0,1683.5,14,3,0,6,7,6,0,0,0,0,16135,7.0,17564,210,45,-700,-814,21.0,1613.5
4504513789,0,18,4,1,5,3,4,0,0,0,0,15882,7.2,18646,214,63,-27,114,21.4,1588.2,17,5,0,3,5,3,1,1,0,0,15909,7.2,18532,254,53,27,-114,25.4,1590.9
4468830390,1,25,2,0,14,9,16,1,1,0,0,19904,7.0,18106,179,60,2685,1605,17.9,1990.4,17,4,1,9,14,7,0,0,0,0,17219,6.6,16501,205,44,-2685,-1605,20.5,1721.9
4515698630,0,19,1,0,7,9,8,0,0,0,0,16595,7.2,18645,231,47,-997,-330,23.1,1659.5,13,4,1,9,7,11,0,0,0,0,17592,7.2,18975,225,52,997,330,22.5,1759.2
4524396763,1,20,2,1,7,9,6,0,0,0,0,16806,6.6,17623,218,49,-369,-1242,21.8,1680.6,14,6,0,9,7,6,1,1,0,0,17175,7.2,18865,200,44,369,1242,20.0,1717.5
4457514410,1,19,5,1,10,3,10,1,1,0,0,18272,7.4,20304,219,48,3619,3192,21.9,1827.2,11,3,0,3,10,2,0,0,0,0,14653,6.6,17112,222,46,-3619,-3192,22.2,1465.3
4515231062,0,16,3,0,4,9,4,1,1,0,0,14588,6.2,15647,207,45,-2627,-4080,20.7,1458.8,36,2,1,9,4,4,1,0,1,0,17215,7.4,19727,225,51,2627,4080,22.5,1721.5
4519183876,1,15,1,1,11,3,11,2,1,1,0,18866,7.6,20876,214,60,3650,3906,21.4,1886.6,11,1,0,3,11,4,0,0,0,0,15216,6.8,16970,219,44,-3650,-3906,21.9,1521.6
4495670658,1,18,3,0,6,3,8,1,1,0,0,17146,7.2,18930,219,60,2326,1907,21.9,1714.6,14,0,1,3,6,2,0,0,0,0,14820,6.6,17023,206,59,-2326,-1907,20.6,1482.0
4495044262,0,16,1,1,4,6,2,0,0,0,0,15172,7.0,18276,205,55,-1066,10,20.5,1517.2,14,3,0,6,4,7,1,1,0,0,16238,6.8,18266,241,36,1066,-10,24.1,1623.8
4525129599,1,16,3,1,9,7,10,0,0,0,0,18064,7.2,19192,252,45,2321,1274,25.2,1806.4,18,2,0,7,9,5,1,1,0,0,15743,6.8,17918,198,41,-2321,-1274,19.8,1574.3
4523986345,1,17,3,0,5,7,4,1,1,0,0,15832,7.0,18359,236,44,-1741,-1348,23.6,1583.2,35,3,1,7,5,5,1,0,1,0,17573,7.4,19707,234,51,1741,1348,23.4,1757.3
4494792014,1,13,1,0,8,8,8,1,1,0,0,17137,6.8,17147,195,56,-718,-1666,19.5,1713.7,13,0,1,8,8,8,0,0,0,0,17855,7.0,18813,215,61,718,1666,21.5,1785.5
4523640765,1,15,2,1,4,0,3,1,1,0,0,15282,6.8,17848,211,45,1629,677,21.1,1528.2,38,0,0,0,4,0,0,0,0,0,13653,6.8,17171,246,44,-1629,-677,24.6,1365.3
4483120111,0,42,1,0,6,6,5,0,0,0,0,15651,6.8,17769,195,44,-919,-483,19.5,1565.1,16,2,1,6,6,5,1,1,0,0,16570,7.0,18252,203,68,919,483,20.3,1657.0
4495228612,0,17,1,0,2,6,2,0,0,0,0,14025,6.6,16510,205,51,-2846,-1964,20.5,1402.5,22,2,1,6,2,4,1,1,0,0,16871,6.8,18474,218,64,2846,1964,21.8,1687.1
4508648783,1,12,2,1,11,5,7,2,1,1,0,18576,7.2,20102,227,59,2276,1971,22.7,1857.6,15,1,0,5,11,6,0,0,0,0,16300,7.0,18131,213,67,-2276,-1971,21.3,1630.0
4482569036,0,24,0,1,4,7,5,0,0,0,0,15267,6.8,17008,212,52,-1002,-2319,21.2,1526.7,12,3,0,7,4,9,1,0,1,0,16269,7.0,19327,209,60,1002,2319,20.9,1626.9
4521560262,1,17,1,1,11,3,11,1,1,0,0,18633,7.4,19659,232,49,3784,2577,23.2,1863.3,15,1,0,3,11,3,0,0,0,0,14849,6.8,17082,209,57,-3784,-2577,20.9,1484.9
4484568700,1,19,4,1,3,2,2,0,0,0,0,15391,6.6,17387,232,41,1343,1089,23.2,1539.1,17,3,0,2,3,1,1,1,0,0,14048,6.4,16298,218,48,-1343,-1089,21.8,1404.8
4510853790,0,16,6,0,4,4,5,0,0,0,0,15694,6.8,18453,242,59,217,709,24.2,1569.4,17,3,1,4,4,4,1,1,0,0,15477,7.0,17744,214,60,-217,-709,21.4,1547.7
4453399746,1,17,2,1,11,4,4,2,1,1,0,18271,7.2,20332,224,48,2875,3178,22.4,1827.1,12,2,0,4,11,4,0,0,0,0,15396,6.8,17154,213,56,-2875,-3178,21.3,1539.6
4517941461,0,12,8,1,4,5,4,0,0,0,0,15223,6.8,18081,216,48,-375,180,21.6,1522.3,19,4,0,5,4,7,1,1,0,0,15598,7.2,17901,226,48,375,-180,22.6,1559.8
4520004131,1,14,4,1,5,5,4,1,1,0,0,15885,6.6,16411,213,54,-508,-1263,21.3,1588.5,35,1,0,5,5,5,0,0,0,0,16393,7.0,17674,235,46,508,1263,23.5,1639.3
4510150103,0,21,1,0,7,5,6,1,0,1,0,18345,7.4,20002,247,58,3272,3059,24.7,1834.5,10,3,1,5,7,8,1,1,0,0,15073,6.8,16943,183,37,-3272,-3059,18.3,1507.3
4440545159,1,15,6,1,10,6,6,0,0,0,0,17332,7.2,19582,235,65,1372,1668,23.5,1733.2,16,0,0,6,10,6,0,0,0,0,15960,7.0,17914,207,48,-1372,-1668,20.7,1596.0
4461960551,1,55,1,1,4,2,5,0,0,0,0,16161,6.8,17916,230,60,901,-1138,23.0,1616.1,14,0,0,2,4,3,1,1,0,0,15260,7.0,19054,246,60,-901,1138,24.6,1526.0
4521822365,0,16,2,1,3,6,4,1,1,0,0,14792,6.6,16218,205,52,-1183,-1235,20.5,1479.2,19,2,0,6,3,5,0,0,0,0,15975,6.8,17453,211,42,1183,1235,21.1,1597.5
4515437338,1,16,5,1,9,3,10,2,1,1,0,18293,7.2,19981,240,59,3691,2805,24.0,1829.3,11,3,0,3,9,3,0,0,0,0,14602,7.0,17176,186,51,-3691,-2805,18.6,1460.2
4516015369,1,11,4,1,13,6,8,0,0,0,0,19537,7.4,19905,242,46,3608,2893,24.2,1953.7,16,2,0,6,13,10,1,1,0,0,15929,6.6,17012,188,53,-3608,-2893,18.8,1592.9
4439604541,1,16,2,0,5,3,7,1,1,0,0,17182,7.4,19944,246,71,1591,1778,24.6,1718.2,15,0,1,3,5,4,0,0,0,0,15591,6.8,18166,257,47,-1591,-1778,25.7,1559.1
4514255015,0,16,5,0,4,9,5,1,1,0,0,15395,6.6,17472,221,44,-1421,-1367,22.1,1539.5,15,2,1,9,4,6,1,0,1,0,16816,7.0,18839,212,60,1421,1367,21.2,1681.6
4500962702,1,18,2,0,6,2,8,2,1,1,0,16814,7.2,18759,231,59,1519,1104,23.1,1681.4,17,0,1,2,6,2,0,0,0,0,15295,7.0,17655,234,52,-1519,-1104,23.4,1529.5
4495222052,0,16,1,0,6,15,9,0,0,0,0,15435,6.6,15816,161,40,-5097,-3482,16.1,1543.5,17,3,1,15,6,16,1,1,0,0,20532,7.4,19298,226,44,5097,3482,22.6,2053.2
4432091797,0,86,4,1,3,5,3,0,0,0,0,14754,6.6,17158,186,62,-1342,-1966,18.6,1475.4,36,6,0,5,3,6,1,1,0,0,16096,7.2,19124,218,54,1342,1966,21.8,1609.6
4515536564,0,15,5,1,6,11,6,1,1,0,0,15673,6.6,17330,197,63,-2420,-2518,19.7,1567.3,16,3,0,11,6,10,0,0,0,0,18093,7.4,19848,197,68,2420,2518,19.7,1809.3
4514415093,0,14,3,1,3,6,3,0,0,0,0,15761,7.0,18094,239,43,-983,-1574,23.9,1576.1,15,2,0,6,3,11,1,1,0,0,16744,7.2,19668,218,73,983,1574,21.8,1674.4
4524060620,0,15,0,0,5,14,5,0,0,0,0,15099,6.8,17734,156,45,-5206,-1622,15.6,1509.9,13,2,1,14,5,8,0,0,0,1,20305,7.0,19356,226,39,5206,1622,22.6,2030.5
4508010567,0,19,2,0,8,6,12,0,0,0,0,15958,6.6,17066,185,44,231,-184,18.5,1595.8,13,3,1,6,8,2,1,1,0,0,15727,6.8,17250,208,48,-231,184,20.8,1572.7
4519863866,1,81,3,0,16,7,12,1,1,0,0,21285,7.4,20332,229,60,5154,3837,22.9,2128.5,12,0,1,7,16,6,0,0,0,0,16131,6.8,16495,174,52,-5154,-3837,17.4,1613.1
4514826109,1,17,1,0,9,6,11,1,1,0,0,16863,7.0,18740,227,32,296,1370,22.7,1686.3,12,2,1,6,9,3,0,0,0,0,16567,7.0,17370,222,48,-296,-1370,22.2,1656.7
4525367812,1,17,5,0,1,4,0,0,0,0,0,14334,7.0,18293,242,52,-1878,-178,24.2,1433.4,22,2,1,4,1,6,1,1,0,0,16212,7.0,18471,262,56,1878,178,26.2,1621.2
4481832485,0,22,3,0,4,7,6,1,0,1,0,16135,7.0,18177,234,47,-1782,-1311,23.4,1613.5,17,3,1,7,4,8,1,1,0,0,17917,7.2,19488,264,53,1782,1311,26.4,1791.7
4495755688,1,16,3,1,8,5,7,1,1,0,0,18020,7.2,18981,253,56,2533,1172,25.3,1802.0,15,6,0,5,8,4,0,0,0,0,15487,6.8,17809,212,60,-2533,-1172,21.2,1548.7
4523300561,1,12,1,1,11,2,9,1,1,0,0,19280,7.6,20813,252,51,5041,3996,25.2,1928.0,19,4,0,2,11,3,0,0,0,0,14239,6.8,16817,215,59,-5041,-3996,21.5,1423.9
4513430767,1,14,1,1,6,4,12,1,1,0,0,16189,6.8,17737,224,39,625,-534,22.4,1618.9,102,1,0,4,6,4,0,0,0,0,15564,7.0,18271,217,48,-625,534,21.7,1556.4
4524613194,1,11,3,1,12,3,16,1,1,0,0,18280,7.4,19206,209,43,4254,3059,20.9,1828.0,17,1,0,3,12,4,0,0,0,0,14026,6.6,16147,204,44,-4254,-3059,20.4,1402.6
4494493149,1,17,3,1,7,2,11,2,1,1,0,17176,7.0,18575,200,62,2889,1215,20.0,1717.6,17,2,0,2,7,2,0,0,0,0,14287,6.8,17360,217,58,-2889,-1215,21.7,1428.7
4487456805,0,17,2,0,3,9,4,0,0,0,0,14017,6.6,16680,185,54,-5089,-1828,18.5,1401.7,13,3,1,9,3,10,0,0,0,0,19106,7.0,18508,245,52,5089,1828,24.5,1910.6
4524504649,0,15,3,1,10,4,15,2,1,1,0,18959,7.2,19473,244,60,3373,1784,24.4,1895.9,13,2,0,4,10,2,0,0,0,0,15586,6.8,17689,221,47,-3373,-1784,22.1,1558.6
4523307860,1,14,3,1,3,3,4,0,0,0,0,15387,7.0,18342,215,64,-923,-1234,21.5,1538.7,15,4,0,3,3,5,1,1,0,0,16310,7.4,19576,232,72,923,1234,23.2,1631.0
4523550797,0,12,4,0,2,6,2,0,0,0,0,14944,6.8,17906,237,45,-2150,-1318,23.7,1494.4,22,3,1,6,2,11,1,1,0,0,17094,7.2,19224,241,76,2150,1318,24.1,1709.4
4523121981,0,14,6,0,0,6,0,1,0,1,0,14238,6.8,16667,234,48,-2554,-2576,23.4,1423.8,15,1,1,6,0,11,0,0,0,0,16792,7.0,19243,225,52,2554,2576,22.5,1679.2
4508511932,0,14,3,1,2,8,2,0,0,0,0,14904,6.6,15958,222,50,-1302,-1959,22.2,1490.4,19,5,0,8,2,6,2,1,1,0,16206,7.0,17917,194,50,1302,1959,19.4,1620.6
4485957777,0,18,2,0,3,8,1,0,0,0,0,14496,6.8,16623,230,48,-2317,-1330,23.0,1449.6,17,4,1,8,3,11,2,1,1,0,16813,7.0,17953,223,44,2317,1330,22.3,1681.3
4518341446,1,17,6,1,4,2,6,0,0,0,0,16068,6.6,17607,235,52,932,-534,23.5,1606.8,20,2,0,2,4,2,0,0,0,0,15136,7.0,18141,241,58,-932,534,24.1,1513.6
4515543803,0,18,3,0,7,6,6,0,0,0,0,15847,6.6,16305,199,36,-1252,-1190,19.9,1584.7,16,5,1,6,7,6,1,0,1,0,17099,6.6,17495,231,51,1252,1190,23.1,1709.9
4482905439,1,14,0,0,6,3,7,1,1,0,0,15464,6.8,17053,219,32,679,-691,21.9,1546.4,16,1,1,3,6,2,1,0,1,0,14785,6.8,17744,220,44,-679,691,22.0,1478.5
4524336258,0,14,1,1,6,6,9,1,1,0,0,16640,7.2,17949,233,50,-276,-1424,23.3,1664.0,22,2,0,6,6,8,0,0,0,0,16916,7.4,19373,220,59,276,1424,22.0,1691.6
4514455389,1,18,4,1,9,8,6,0,0,0,0,17269,7.0,18087,209,42,8,84,20.9,1726.9,12,4,0,8,9,8,2,1,1,0,17261,7.0,18003,216,47,-8,-84,21.6,1726.1
4501319968,0,19,3,1,7,4,9,0,0,0,0,17226,7.0,18982,228,61,1857,2015,22.8,1722.6,14,4,0,4,7,2,1,1,0,0,15369,6.6,16967,202,49,-1857,-2015,20.2,1536.9
4516417495,0,82,2,0,5,3,5,0,0,0,0,16851,7.0,18647,225,65,1706,1154,22.5,1685.1,43,4,1,3,5,5,1,1,0,0,15145,7.0,17493,219,54,-1706,-1154,21.9,1514.5
4518296609,0,15,3,0,5,4,6,1,1,0,0,16086,7.0,18044,222,68,441,626,22.2,1608.6,16,2,1,4,5,5,0,0,0,0,15645,6.8,17418,235,44,-441,-626,23.5,1564.5
4486347504,0,18,4,1,4,4,6,1,0,1,0,15694,6.6,17103,248,40,567,-1018,24.8,1569.4,16,6,0,4,4,3,1,1,0,0,15127,7.0,18121,245,44,-567,1018,24.5,1512.7
4486656023,1,16,6,1,7,11,7,0,0,0,0,16851,6.8,16674,216,42,-778,-752,21.6,1685.1,13,4,0,11,7,14,1,1,0,0,17629,6.8,17426,200,34,778,752,20.0,1762.9
4524685045,1,12,3,0,8,6,9,1,1,0,0,16738,7.2,19296,214,60,624,1208,21.4,1673.8,14,0,1,6,8,3,0,0,0,0,16114,7.0,18088,225,33,-624,-1208,22.5,1611.4
4510541398,1,16,1,1,8,2,5,1,1,0,0,17030,6.8,18285,212,47,1866,80,21.2,1703.0,17,3,0,2,8,2,0,0,0,0,15164,7.2,18205,246,57,-1866,-80,24.6,1516.4
4486418499,0,15,2,0,1,6,1,0,0,0,0,14058,6.6,16215,213,51,-2675,-2192,21.3,1405.8,86,4,1,6,1,4,1,0,1,0,16733,7.0,18407,229,52,2675,2192,22.9,1673.3
4523305960,1,17,0,0,4,2,4,2,1,1,0,15752,7.2,19171,231,64,1064,2471,23.1,1575.2,54,2,1,2,4,4,0,0,0,0,14688,6.6,16700,235,44,-1064,-2471,23.5,1468.8
4494288234,1,38,0,1,8,2,8,0,0,0,0,18274,7.0,18615,238,45,3803,2825,23.8,1827.4,15,0,0,2,8,6,0,0,0,0,14471,6.4,15790,201,51,-3803,-2825,20.1,1447.1
4524637878,0,15,2,0,7,7,7,0,0,0,0,17332,7.0,18724,226,60,-6,1004,22.6,1733.2,15,1,1,7,7,9,2,1,1,0,17338,6.8,17720,188,56,6,-1004,18.8,1733.8
4524326112,0,13,2,1,4,4,4,1,0,1,0,16209,7.0,18146,254,52,316,-597,25.4,1620.9,15,1,0,4,4,4,1,1,0,0,15893,7.0,18743,237,57,-316,597,23.7,1589.3
4454250539,1,35,2,0,11,7,14,0,0,0,0,19106,6.8,17739,189,60,2013,900,18.9,1910.6,17,1,1,7,11,8,0,0,0,0,17093,6.6,16839,188,47,-2013,-900,18.8,1709.3
4526246289,1,16,4,0,8,5,11,0,0,0,0,17770,7.0,17974,228,55,1753,963,22.8,1777.0,86,5,1,5,8,6,0,0,0,0,16017,6.8,17011,233,40,-1753,-963,23.3,1601.7
4526197736,0,38,1,0,10,8,14,1,1,0,0,18294,7.4,18581,204,43,1058,527,20.4,1829.4,12,1,1,8,10,12,0,0,0,0,17236,7.0,18054,210,46,-1058,-527,21.0,1723.6
4464122036,1,13,9,1,7,3,7,1,0,1,0,16934,7.0,19205,228,44,1714,1369,22.8,1693.4,44,2,0,3,7,4,1,1,0,0,15220,6.8,17836,229,51,-1714,-1369,22.9,1522.0
4525216073,1,18,1,0,6,2,7,1,1,0,0,17062,7.2,20216,235,64,2436,2608,23.5,1706.2,12,5,1,2,6,3,1,0,1,0,14626,7.0,17608,203,60,-2436,-2608,20.3,1462.6
4517599722,1,16,1,1,8,5,9,1,1,0,0,16779,7.0,18171,224,43,1468,195,22.4,1677.9,24,4,0,5,8,4,1,0,1,0,15311,7.0,17976,212,44,-1468,-195,21.2,1531.1
4506659179,0,17,2,0,8,8,4,0,0,0,0,15686,6.8,17245,195,35,-2594,-1150,19.5,1568.6,15,2,1,8,8,9,0,0,0,0,18280,7.0,18395,236,60,2594,1150,23.6,1828.0
4423066417,1,11,1,0,6,10,4,1,0,1,0,16226,7.2,18754,221,46,-1613,474,22.1,1622.6,15,1,1,10,6,11,1,1,0,0,17839,7.0,18280,215,46,1613,-474,21.5,1783.9
4484556262,1,11,0,1,9,7,13,0,0,0,0,17252,6.4,15960,188,39,166,-1644,18.8,1725.2,16,3,0,7,9,8,1,1,0,0,17086,7.0,17604,192,54,-166,1644,19.2,1708.6
4522528300,0,20,3,0,4,3,5,1,1,0,0,15562,7.2,18694,235,62,-526,496,23.5,1556.2,15,4,1,3,4,2,0,0,0,0,16088,7.0,18198,219,63,526,-496,21.9,1608.8
4523569413,1,15,2,1,8,6,8,1,1,0,0,18198,7.0,18250,246,40,2713,464,24.6,1819.8,14,0,0,6,8,3,1,0,1,0,15485,6.8,17786,187,56,-2713,-464,18.7,1548.5
4506645494,0,15,2,1,7,6,5,0,0,0,0,16359,7.0,17684,219,40,117,-113,21.9,1635.9,13,2,0,6,7,7,1,1,0,0,16242,6.8,17797,229,44,-117,113,22.9,1624.2
4521744333,0,16,2,1,2,4,3,1,0,1,0,15739,7.0,16738,223,46,657,-1141,22.3,1573.9,15,1,0,4,2,5,1,1,0,0,15082,6.8,17879,199,60,-657,1141,19.9,1508.2
4526206684,0,19,1,0,5,6,3,0,0,0,0,15580,6.6,17286,197,44,-502,-1113,19.7,1558.0,13,2,1,6,5,4,1,0,1,0,16082,7.2,18399,197,55,502,1113,19.7,1608.2
4512831945,1,15,2,1,10,2,11,0,0,0,0,19151,7.4,19146,220,52,5241,3129,22.0,1915.1,15,2,0,2,10,3,2,1,1,0,13910,6.4,16017,196,51,-5241,-3129,19.6,1391.0
4524524823,1,18,3,1,9,5,7,0,0,0,0,16755,6.8,16362,179,40,2154,2068,17.9,1675.5,18,1,0,5,9,3,0,0,0,0,14601,5.8,14294,199,11,-2154,-2068,19.9,1460.1
4523884002,0,17,0,0,1,7,2,0,0,0,0,13976,6.6,16595,211,48,-2971,-1923,21.1,1397.6,138,1,1,7,1,7,1,1,0,0,16947,7.2,18518,231,59,2971,1923,23.1,1694.7
4514409289,1,12,8,1,8,7,7,1,1,0,0,16840,7.2,19004,193,51,-144,-157,19.3,1684.0,42,3,0,7,8,7,0,0,0,0,16984,7.2,19161,218,56,144,157,21.8,1698.4
4516533526,1,32,4,1,8,4,11,2,1,1,0,17094,6.8,17845,202,45,1509,-543,20.2,1709.4,17,0,0,4,8,4,0,0,0,0,15585,7.0,18388,220,60,-1509,543,22.0,1558.5
4524384067,0,43,1,0,4,5,5,1,0,1,0,15157,7.0,17954,201,55,-1321,-7,20.1,1515.7,15,2,1,5,4,10,0,0,0,0,16478,7.0,17961,235,47,1321,7,23.5,1647.8
4526256395,0,37,3,0,1,6,1,1,0,1,0,14308,6.8,17611,235,48,-2634,-1282,23.5,1430.8,19,3,1,6,1,9,1,1,0,0,16942,7.4,18893,247,66,2634,1282,24.7,1694.2
4527490147,0,9,2,0,3,12,0,0,0,0,0,14798,6.8,17372,225,48,-5533,-2481,22.5,1479.8,79,5,1,12,3,13,0,0,0,0,20331,7.6,19853,233,49,5533,2481,23.3,2033.1
4511356248,1,12,5,0,5,9,7,0,0,0,0,16142,7.2,17532,237,44,-1711,-1086,23.7,1614.2,17,5,1,9,5,12,2,1,1,0,17853,7.2,18618,195,56,1711,1086,19.5,1785.3
4512514727,1,13,5,0,4,2,1,0,0,0,0,15555,7.2,19127,254,51,1019,1368,25.4,1555.5,23,1,1,2,4,2,1,1,0,0,14536,7.0,17759,217,60,-1019,-1368,21.7,1453.6
4495413330,1,43,4,0,5,8,4,0,0,0,0,16616,7.4,19302,240,64,-616,728,24.0,1661.6,16,5,1,8,5,9,1,1,0,0,17232,7.2,18574,234,48,616,-728,23.4,1723.2
4524326952,1,19,0,0,9,6,9,0,0,0,0,17368,6.8,18134,219,40,280,-1018,21.9,1736.8,15,3,1,6,9,8,0,0,0,0,17088,7.2,19152,227,59,-280,1018,22.7,1708.8
4503747242,0,18,1,0,4,5,4,0,0,0,0,15300,6.6,17024,212,43,-188,-535,21.2,1530.0,18,4,1,5,4,5,0,0,0,0,15488,6.8,17559,232,48,188,535,23.2,1548.8
4525226479,0,14,7,1,7,10,11,0,0,0,0,17297,7.0,18422,228,51,-2526,-1811,22.8,1729.7,17,3,0,10,7,11,2,1,1,1,19823,7.4,20233,221,47,2526,1811,22.1,1982.3
4518463006,0,40,3,0,10,8,10,0,0,0,0,17546,7.2,18498,191,44,510,921,19.1,1754.6,14,2,1,8,10,7,1,1,0,0,17036,7.0,17577,217,51,-510,-921,21.7,1703.6
4433044293,0,19,2,0,3,5,3,1,1,0,0,14587,6.8,16414,222,48,-2395,-2214,22.2,1458.7,26,4,1,5,3,6,1,0,1,0,16982,7.0,18628,254,60,2395,2214,25.4,1698.2
4452577229,1,16,4,1,10,8,8,0,0,0,0,18602,7.4,20068,200,64,123,1313,20.0,1860.2,29,3,0,8,10,6,1,0,1,1,18479,7.2,18755,226,46,-123,-1313,22.6,1847.9
4467269320,0,46,8,1,3,2,5,1,1,0,0,15570,7.2,18813,236,60,-61,-100,23.6,1557.0,24,8,0,2,3,2,0,0,0,0,15631,7.2,18913,260,60,61,100,26.0,1563.1
4526479094,0,16,2,0,3,6,2,0,0,0,0,16178,7.0,19240,258,56,-183,257,25.8,1617.8,13,3,1,6,3,5,1,1,0,0,16361,7.2,18983,226,68,183,-257,22.6,1636.1
4494015371,0,11,1,0,3,5,4,1,1,0,0,13770,6.4,15846,192,33,-2374,-2316,19.2,1377.0,14,2,1,5,3,5,0,0,0,0,16144,7.0,18162,239,36,2374,2316,23.9,1614.4
4511777552,0,13,2,0,7,7,12,0,0,0,0,16449,7.0,18091,211,39,-986,-484,21.1,1644.9,10,3,1,7,7,13,1,1,0,0,17435,7.2,18575,238,53,986,484,23.8,1743.5
4476486795,0,68,6,0,4,6,4,0,0,0,0,15528,6.8,17590,230,43,-2446,-1508,23.0,1552.8,15,4,1,6,4,4,1,1,0,1,17974,7.0,19098,248,72,2446,1508,24.8,1797.4
4492832056,1,15,2,1,6,5,5,1,1,0,0,17056,7.2,18811,234,48,739,711,23.4,1705.6,14,0,0,5,6,6,0,0,0,0,16317,6.8,18100,231,53,-739,-711,23.1,1631.7
4484689883,0,13,4,0,5,5,5,1,1,0,0,16131,6.8,17436,223,48,874,818,22.3,1613.1,15,2,1,5,5,5,0,0,0,0,15257,6.6,16618,219,32,-874,-818,21.9,1525.7
4524701312,1,16,2,1,6,5,5,2,1,1,0,16555,6.8,18782,224,57,-11,-176,22.4,1655.5,18,1,0,5,6,5,0,0,0,0,16566,7.4,18958,227,56,11,176,22.7,1656.6
4501505628,0,21,3,0,4,7,2,0,0,0,0,14811,6.6,17429,224,44,-2076,-679,22.4,1481.1,19,3,1,7,4,6,0,0,0,0,16887,6.8,18108,235,36,2076,679,23.5,1688.7
4481260961,1,15,2,0,5,5,5,0,0,0,0,15552,7.0,16960,211,44,726,-512,21.1,1555.2,16,3,1,5,5,3,1,1,0,0,14826,6.8,17472,192,42,-726,512,19.2,1482.6
4515529980,0,58,2,0,4,8,7,1,0,1,0,15848,6.6,17347,238,56,-1845,-606,23.8,1584.8,17,1,1,8,4,14,1,1,0,0,17693,6.8,17953,224,60,1845,606,22.4,1769.3
4446530367,1,95,1,1,7,5,14,1,1,0,0,17964,7.2,18073,216,55,4042,4968,21.6,1796.4,11,2,0,5,7,4,0,0,0,0,13922,5.4,13105,172,4,-4042,-4968,17.2,1392.2
4515697055,0,13,7,1,7,6,7,0,0,0,0,16443,7.0,18461,193,52,-1706,-1027,19.3,1644.3,16,1,0,6,7,6,0,0,0,0,18149,7.2,19488,247,68,1706,1027,24.7,1814.9
4500179611,1,16,3,0,1,2,2,0,0,0,0,13772,6.6,16974,231,48,-845,-571,23.1,1377.2,22,3,1,2,1,4,1,1,0,0,14617,7.0,17545,197,60,845,571,19.7,1461.7
4500621503,0,17,2,0,4,9,5,0,0,0,0,15054,6.8,16739,204,44,-2327,-2471,20.4,1505.4,15,2,1,9,4,8,0,0,0,0,17381,7.2,19210,209,69,2327,2471,20.9,1738.1
4524587916,0,26,3,0,2,3,4,0,0,0,0,14680,7.0,17465,207,56,-1602,-1412,20.7,1468.0,16,4,1,3,2,2,2,1,1,0,16282,7.2,18877,243,68,1602,1412,24.3,1628.2
4508507583,0,18,2,0,6,4,4,1,0,1,0,16179,6.8,17928,215,52,989,631,21.5,1617.9,24,4,1,4,6,3,0,0,0,0,15190,6.8,17297,212,44,-989,-631,21.2,1519.0
4419578933,1,20,1,0,6,6,8,0,0,0,0,16140,7.0,17727,211,47,556,879,21.1,1614.0,15,4,1,6,6,3,1,1,0,0,15584,6.6,16848,215,48,-556,-879,21.5,1558.4
4519668670,0,136,4,1,9,5,9,0,0,0,0,17700,6.8,18269,216,38,2986,2450,21.6,1770.0,16,0,0,5,9,8,0,0,0,0,14714,6.4,15819,154,48,-2986,-2450,15.4,1471.4
4507328701,1,16,2,1,9,4,10,1,1,0,0,17779,7.2,19282,220,52,2178,1829,22.0,1777.9,11,2,0,4,9,2,0,0,0,0,15601,6.8,17453,244,56,-2178,-1829,24.4,1560.1
4518310338,1,14,3,0,6,3,6,1,1,0,0,16255,7.0,18434,225,39,974,748,22.5,1625.5,15,3,1,3,6,4,0,0,0,0,15281,7.0,17686,201,56,-974,-748,20.1,1528.1
4516044973,0,13,0,0,5,4,3,1,1,0,0,15961,7.0,17670,224,44,-41,-1008,22.4,1596.1,15,1,1,4,5,2,0,0,0,0,16002,7.2,18678,233,60,41,1008,23.3,1600.2
4513650091,0,19,3,1,8,3,4,1,0,1,1,19224,7.6,20086,225,56,4674,2219,22.5,1922.4,34,3,0,3,8,4,1,1,0,0,14550,7.0,17867,189,64,-4674,-2219,18.9,1455.0
4505081158,1,16,1,0,5,6,4,1,0,1,0,15072,7.0,17951,189,53,-1925,-904,18.9,1507.2,12,2,1,6,5,5,0,0,0,0,16997,7.2,18855,244,67,1925,904,24.4,1699.7
4518606893,1,18,0,1,9,6,13,0,0,0,0,17855,7.2,19265,200,51,2063,2131,20.0,1785.5,39,2,0,6,9,10,1,1,0,0,15792,7.0,17134,182,42,-2063,-2131,18.2,1579.2
4439770963,1,15,4,1,3,5,2,1,1,0,0,15164,6.8,17404,218,51,-1592,-2199,21.8,1516.4,11,1,0,5,3,5,0,0,0,0,16756,7.2,19603,255,52,1592,2199,25.5,1675.6
4524966850,1,10,2,1,9,6,8,0,0,0,0,16396,6.6,17294,168,56,975,659,16.8,1639.6,19,0,0,6,9,4,0,0,0,0,15421,6.6,16635,191,48,-975,-659,19.1,1542.1
4516722172,0,15,2,1,7,3,7,2,1,1,0,16467,6.8,17952,209,48,1418,129,20.9,1646.7,31,1,0,3,7,2,0,0,0,0,15049,6.8,17823,231,56,-1418,-129,23.1,1504.9
4477734915,1,20,3,1,5,2,4,0,0,0,0,16230,7.0,18489,235,61,932,542,23.5,1623.0,15,5,0,2,5,4,0,0,0,0,15298,7.2,17947,247,56,-932,-542,24.7,1529.8
4523047693,0,17,5,1,7,3,9,0,0,0,0,16847,7.0,17476,223,48,1840,-279,22.3,1684.7,38,3,0,3,7,1,1,1,0,0,15007,6.8,17755,224,51,-1840,279,22.4,1500.7
4520750319,1,11,2,0,9,5,8,1,1,0,0,17491,7.2,19706,216,53,2599,3321,21.6,1749.1,15,1,1,5,9,3,0,0,0,0,14892,6.4,16385,189,47,-2599,-3321,18.9,1489.2
4524322157,0,15,3,0,4,9,6,0,0,0,0,14693,6.6,15883,169,41,-3874,-2423,16.9,1469.3,15,2,1,9,4,13,0,0,0,0,18567,7.0,18306,223,43,3874,2423,22.3,1856.7
4514350751,0,15,1,1,3,4,4,0,0,0,0,15372,6.8,17983,234,51,-6,-1746,23.4,1537.2,14,6,0,4,3,0,1,1,0,0,15378,7.2,19729,236,48,6,1746,23.6,1537.8
4445293450,0,13,2,0,4,4,5,0,0,0,0,15252,6.8,17517,225,46,-615,-347,22.5,1525.2,14,5,1,4,4,3,1,1,0,0,15867,6.6,17864,229,54,615,347,22.9,1586.7
4521934653,1,15,1,1,9,7,12,0,0,0,0,17704,7.0,18183,196,68,639,1171,19.6,1770.4,15,1,0,7,9,10,0,0,0,0,17065,6.4,17012,208,39,-639,-1171,20.8,1706.5
4453255599,1,17,3,0,10,13,8,1,0,1,0,18255,6.8,17685,206,29,-1237,-874,20.6,1825.5,14,1,1,13,10,22,0,0,0,0,19492,7.0,18559,203,50,1237,874,20.3,1949.2
4526148132,1,13,3,1,5,4,4,1,1,0,0,16328,6.8,17531,223,62,1192,836,22.3,1632.8,14,4,0,4,5,4,0,0,0,0,15136,6.4,16695,219,52,-1192,-836,21.9,1513.6
4479644130,0,127,3,0,9,7,8,1,0,1,1,18502,7.2,19709,212,51,2010,2112,21.2,1850.2,52,2,1,7,9,11,1,1,0,0,16492,6.6,17597,194,48,-2010,-2112,19.4,1649.2
4523459818,0,16,5,1,3,5,2,1,1,0,0,14098,6.2,14987,198,49,-2511,-2288,19.8,1409.8,20,1,0,5,3,6,0,0,0,0,16609,6.8,17275,216,40,2511,2288,21.6,1660.9
4506217760,1,14,3,1,11,6,14,1,1,0,0,18056,6.8,17829,195,54,250,287,19.5,1805.6,268,2,0,6,11,7,1,0,1,1,17806,7.0,17542,210,59,-250,-287,21.0,1780.6
4482467049,0,16,6,1,4,3,5,1,1,0,0,15054,6.6,16861,223,56,-387,-725,22.3,1505.4,19,1,0,3,4,5,0,0,0,0,15441,6.6,17586,210,56,387,725,21.0,1544.1
4491835607,1,58,4,1,16,6,20,2,1,1,1,21747,7.4,19828,244,49,5742,3475,24.4,2174.7,12,3,0,6,16,6,0,0,0,0,16005,6.6,16353,190,48,-5742,-3475,19.0,1600.5
4494473176,1,19,4,1,8,9,12,1,1,0,0,16096,6.4,15907,197,48,-447,-2127,19.7,1609.6,40,5,0,9,8,7,0,0,0,0,16543,7.0,18034,193,36,447,2127,19.3,1654.3
4475349750,1,16,1,0,5,13,5,1,0,1,0,15858,6.4,16120,219,29,-3945,-1758,21.9,1585.8,13,5,1,13,5,19,1,1,0,1,19803,7.2,17878,196,47,3945,1758,19.6,1980.3
4506258913,1,13,2,1,8,4,11,0,0,0,0,18343,6.8,18609,246,56,3314,2262,24.6,1834.3,15,1,0,4,8,4,0,0,0,0,15029,6.6,16347,204,36,-3314,-2262,20.4,1502.9
4523414749,1,11,2,1,7,4,6,0,0,0,0,17441,7.4,19668,214,55,2947,2247,21.4,1744.1,12,2,0,4,7,1,1,0,1,0,14494,7.0,17421,190,60,-2947,-2247,19.0,1449.4
4503175131,0,16,6,1,8,6,8,0,0,0,0,16970,6.8,17201,226,45,510,-601,22.6,1697.0,25,5,0,6,8,10,1,1,0,0,16460,6.8,17802,230,48,-510,601,23.0,1646.0
4515858089,0,19,2,1,6,12,7,1,0,1,0,16203,6.4,16391,203,51,-2787,-1507,20.3,1620.3,20,3,0,12,6,23,1,1,0,0,18990,7.0,17898,209,42,2787,1507,20.9,1899.0
4519452833,0,19,3,0,3,4,4,1,1,0,0,14267,6.6,17033,186,58,-1190,-762,18.6,1426.7,17,4,1,4,3,3,0,0,0,0,15457,7.0,17795,206,44,1190,762,20.6,1545.7
4524651202,0,14,3,1,6,7,4,0,0,0,0,16060,6.4,16764,200,60,-27,-1847,20.0,1606.0,87,3,0,7,6,7,1,1,0,0,16087,7.0,18611,194,53,27,1847,19.4,1608.7
4473436327,0,11,1,1,6,9,2,1,1,0,0,15290,6.8,16843,195,55,-2543,-538,19.5,1529.0,88,0,0,9,6,8,0,0,0,0,17833,6.6,17381,215,34,2543,538,21.5,1783.3
4511678371,0,16,3,0,4,10,5,0,0,0,0,14993,6.4,16201,208,48,-3416,-2347,20.8,1499.3,18,1,1,10,4,12,1,1,0,0,18409,7.2,18548,206,64,3416,2347,20.6,1840.9
4494341320,1,16,3,1,4,2,8,1,1,0,0,16547,7.2,19666,259,64,1268,1705,25.9,1654.7,31,0,0,2,4,3,0,0,0,0,15279,7.0,17961,249,44,-1268,-1705,24.9,1527.9
4477571512,1,15,7,1,8,4,12,1,1,0,0,16819,6.8,17190,199,58,1896,1069,19.9,1681.9,24,2,0,4,8,5,0,0,0,0,14923,6.6,16121,216,41,-1896,-1069,21.6,1492.3
4497178201,0,47,1,1,5,5,8,0,0,0,0,15937,7.0,17560,212,45,-1321,-1186,21.2,1593.7,12,1,0,5,5,5,1,1,0,0,17258,7.2,18746,241,64,1321,1186,24.1,1725.8
4527909697,1,40,4,0,4,1,13,2,1,1,0,16047,7.0,18644,244,48,1976,1778,24.4,1604.7,13,6,1,1,4,1,0,0,0,0,14071,6.8,16866,222,44,-1976,-1778,22.2,1407.1
4469526700,1,106,0,1,12,4,12,1,1,0,0,19058,7.2,19477,214,61,3723,2815,21.4,1905.8,11,1,0,4,12,7,1,0,1,0,15335,6.6,16662,200,48,-3723,-2815,20.0,1533.5
4516700251,1,38,5,0,8,3,9,1,1,0,0,17328,7.2,19304,228,69,2357,2202,22.8,1732.8,17,3,1,3,8,2,0,0,0,0,14971,6.8,17102,222,44,-2357,-2202,22.2,1497.1
4501443265,1,14,2,0,7,9,7,0,0,0,0,17309,6.8,17384,231,46,334,-302,23.1,1730.9,16,1,1,9,7,12,1,1,0,0,16975,7.0,17686,191,52,-334,302,19.1,1697.5
4526211011,1,14,2,0,5,7,4,0,0,0,0,15553,6.6,15768,203,40,-977,-2180,20.3,1555.3,17,0,1,7,5,5,2,1,1,0,16530,7.0,17948,222,54,977,2180,22.2,1653.0
4502937096,0,13,2,1,6,5,5,0,0,0,0,16051,7.0,17771,197,41,523,-1060,19.7,1605.1,15,5,0,5,6,4,1,1,0,0,15528,7.2,18831,226,54,-523,1060,22.6,1552.8
4517507679,0,86,1,0,6,11,5,0,0,0,0,15214,7.0,17796,171,48,-3709,-1635,17.1,1521.4,18,1,1,11,6,10,0,0,0,0,18923,7.2,19431,228,40,3709,1635,22.8,1892.3
4462622512,1,34,2,0,11,8,11,0,0,0,0,18291,7.0,18744,195,42,939,1327,19.5,1829.1,16,1,1,8,11,9,0,0,0,0,17352,7.0,17417,209,40,-939,-1327,20.9,1735.2
4496344135,0,17,4,0,6,11,4,1,1,0,0,16036,6.6,16916,191,39,-2308,-1767,19.1,1603.6,19,6,1,11,6,14,0,0,0,0,18344,7.2,18683,206,28,2308,1767,20.6,1834.4
4465355260,0,18,6,0,6,7,4,0,0,0,0,15919,6.6,16708,205,51,-3288,-2511,20.5,1591.9,44,5,1,7,6,10,2,1,1,1,19207,7.2,19219,229,52,3288,2511,22.9,1920.7
4509784380,1,18,3,0,9,8,7,1,1,0,0,17977,7.0,18162,235,41,705,192,23.5,1797.7,16,0,1,8,9,8,0,0,0,0,17272,7.0,17970,207,44,-705,-192,20.7,1727.2
4506337812,1,41,1,1,7,3,6,1,1,0,0,18195,7.4,20319,252,64,4197,3107,25.2,1819.5,14,3,0,3,7,1,1,0,1,0,13998,6.8,17212,187,53,-4197,-3107,18.7,1399.8
4527400010,1,15,1,0,7,5,10,0,0,0,0,16271,7.0,17500,218,40,787,846,21.8,1627.1,15,1,1,5,7,4,1,1,0,0,15484,6.8,16654,208,46,-787,-846,20.8,1548.4
4379661286,0,16,1,0,5,9,3,1,1,0,0,15101,6.4,16888,187,48,-3014,-357,18.7,1510.1,23,5,1,9,5,13,0,0,0,0,18115,6.6,17245,252,49,3014,357,25.2,1811.5
4524447311,0,16,3,0,2,9,1,0,0,0,0,15218,6.8,17342,227,51,-2789,-1511,22.7,1521.8,14,5,1,9,2,7,1,1,0,0,18007,7.0,18853,248,56,2789,1511,24.8,1800.7
4523494411,1,23,5,0,3,5,3,1,1,0,0,14684,6.8,16985,217,49,-2212,-1666,21.7,1468.4,37,1,1,5,3,4,0,0,0,0,16896,7.2,18651,258,57,2212,1666,25.8,1689.6
4525159735,1,14,2,0,4,2,9,0,0,0,0,16289,7.4,19421,229,72,1025,1276,22.9,1628.9,14,4,1,2,4,1,2,1,1,0,15264,7.0,18145,271,48,-1025,-1276,27.1,1526.4
4455474376,0,89,2,0,8,6,5,0,0,0,0,17208,7.6,20217,218,54,931,740,21.8,1720.8,15,3,1,6,8,5,0,0,0,0,16277,7.2,19477,209,56,-931,-740,20.9,1627.7
4517672775,1,15,1,1,7,3,11,1,1,0,0,17072,7.0,19087,227,52,1782,1234,22.7,1707.2,11,3,0,3,7,1,0,0,0,0,15290,7.0,17853,212,61,-1782,-1234,21.2,1529.0
4467051072,0,17,3,0,3,9,4,1,0,1,0,15284,7.0,17637,207,72,-3712,-3375,20.7,1528.4,35,6,1,9,3,6,1,1,0,0,18996,7.6,21012,246,61,3712,3375,24.6,1899.6
4518221648,1,15,1,1,4,6,4,0,0,0,0,15298,6.6,16504,208,47,-1596,-1269,20.8,1529.8,13,2,0,6,4,10,1,1,0,0,16894,6.8,17773,210,52,1596,1269,21.0,1689.4
4498270130,0,39,1,0,3,9,6,0,0,0,0,14515,6.6,16542,175,64,-4152,-1948,17.5,1451.5,18,9,1,9,3,14,1,1,0,0,18667,7.0,18490,253,40,4152,1948,25.3,1866.7
4514798405,0,18,2,1,5,6,7,1,1,0,0,15850,6.2,15600,210,51,29,-1552,21.0,1585.0,65,4,0,6,5,8,0,0,0,0,15821,6.6,17152,222,31,-29,1552,22.2,1582.1
4445189250,0,19,2,1,2,5,1,1,1,0,0,14902,7.0,17656,242,44,-1186,-892,24.2,1490.2,14,4,0,5,2,6,0,0,0,0,16088,7.0,18548,215,47,1186,892,21.5,1608.8
4456272410,0,14,3,0,5,3,4,0,0,0,0,15381,7.2,19473,211,52,-187,2135,21.1,1538.1,17,1,1,3,5,5,1,1,0,0,15568,6.8,17338,238,48,187,-2135,23.8,1556.8
4525793792,0,26,0,0,12,10,13,0,0,0,0,17513,6.8,17486,193,48,-773,-734,19.3,1751.3,15,4,1,10,12,11,1,1,0,0,18286,6.8,18220,208,54,773,734,20.8,1828.6
4523428789,0,17,0,0,6,1,8,1,1,0,0,16973,7.0,18787,250,55,2983,1577,25.0,1697.3,13,4,1,1,6,1,1,0,1,0,13990,6.8,17210,199,48,-2983,-1577,19.9,1399.0
4493188082,1,19,3,1,10,6,12,0,0,0,0,18384,7.2,18718,226,52,1717,1335,22.6,1838.4,17,2,0,6,10,10,0,0,0,0,16667,6.8,17383,229,43,-1717,-1335,22.9,1666.7
4452121549,1,18,5,1,9,4,9,1,1,0,0,17585,7.4,18820,240,40,2268,635,24.0,1758.5,19,1,0,4,9,3,0,0,0,0,15317,7.2,18185,219,43,-2268,-635,21.9,1531.7
4525292315,1,38,2,0,6,10,7,1,0,1,0,16014,7.2,18062,211,56,-2651,-1289,21.1,1601.4,15,3,1,10,6,13,1,1,0,0,18665,7.2,19351,240,51,2651,1289,24.0,1866.5
4467826784,0,17,0,0,9,10,8,1,1,0,0,16690,6.6,17356,215,44,170,1174,21.5,1669.0,11,1,1,10,9,8,0,0,0,0,16520,6.4,16182,189,36,-170,-1174,18.9,1652.0
4478112089,1,14,1,1,10,8,8,1,1,0,0,18214,7.2,19620,227,66,1295,1330,22.7,1821.4,13,3,0,8,10,9,0,0,0,0,16919,7.0,18290,205,52,-1295,-1330,20.5,1691.9
4440655415,0,37,4,0,4,12,5,0,0,0,0,16433,7.0,18008,227,46,-2203,-2676,22.7,1643.3,18,13,1,12,4,13,1,0,1,0,18636,7.4,20684,204,55,2203,2676,20.4,1863.6
4491667305,0,16,1,1,6,6,4,0,0,0,0,17045,7.2,18787,245,56,848,129,24.5,1704.5,12,2,0,6,6,8,0,0,0,0,16197,7.0,18658,192,52,-848,-129,19.2,1619.7
4423286445,1,36,3,1,5,5,3,1,1,0,0,16282,7.2,19492,225,61,813,1913,22.5,1628.2,13,0,0,5,5,4,0,0,0,0,15469,7.0,17579,225,52,-813,-1913,22.5,1546.9
4500647186,1,33,4,1,4,2,4,1,1,0,0,16607,7.0,19014,261,68,2261,1906,26.1,1660.7,16,5,0,2,4,0,0,0,0,0,14346,6.6,17108,221,52,-2261,-1906,22.1,1434.6
4523694743,0,106,4,0,3,10,4,1,1,0,0,14385,6.4,15780,195,42,-4413,-3109,19.5,1438.5,16,1,1,10,3,12,1,0,1,0,18798,7.0,18889,234,41,4413,3109,23.4,1879.8
4492342077,1,14,1,1,8,7,7,1,1,0,0,17717,7.4,19042,203,66,1227,996,20.3,1771.7,14,0,0,7,8,8,0,0,0,0,16490,6.8,18046,225,49,-1227,-996,22.5,1649.0
4498636614,1,15,2,1,7,4,7,2,1,1,0,18227,7.2,19568,256,61,2689,2827,25.6,1822.7,15,1,0,4,7,4,0,0,0,0,15538,6.6,16741,224,36,-2689,-2827,22.4,1553.8
4510979839,1,16,2,1,7,6,10,1,0,1,0,16468,6.4,15869,226,33,635,-1157,22.6,1646.8,51,3,0,6,7,6,1,1,0,0,15833,6.8,17026,228,54,-635,1157,22.8,1583.3
4481806461,0,23,1,0,6,14,7,1,1,0,0,15880,6.6,16941,204,45,-4526,-2062,20.4,1588.0,18,2,1,14,6,23,0,0,0,0,20406,7.0,19003,201,49,4526,2062,20.1,2040.6
4521180315,0,17,0,1,5,6,3,1,0,1,0,15048,6.6,16313,209,47,-2099,-2717,20.9,1504.8,18,0,0,6,5,6,1,1,0,0,17147,7.4,19030,239,55,2099,2717,23.9,1714.7
4494773466,0,16,0,1,5,9,7,0,0,0,0,16163,6.8,16772,190,52,-819,-1926,19.0,1616.3,48,6,0,9,5,8,0,0,0,0,16982,7.0,18698,225,50,819,1926,22.5,1698.2
4459545656,0,18,6,0,4,6,3,0,0,0,0,15967,7.0,18406,227,56,-1413,-1302,22.7,1596.7,18,4,1,6,4,9,2,1,1,0,17380,7.2,19708,256,72,1413,1302,25.6,1738.0
4516781152,0,12,4,1,7,4,5,1,1,0,0,17214,7.0,19173,235,48,1746,2273,23.5,1721.4,14,4,0,4,7,6,0,0,0,0,15468,6.8,16900,205,56,-1746,-2273,20.5,1546.8
4499732263,1,16,4,0,4,12,2,0,0,0,0,14997,6.8,17191,218,44,-3401,-2179,21.8,1499.7,18,2,1,12,4,15,2,1,1,0,18398,7.4,19370,219,40,3401,2179,21.9,1839.8
4516306111,0,15,2,0,2,5,0,0,0,0,0,15080,6.8,17979,262,56,-1267,427,26.2,1508.0,13,5,1,5,2,6,2,1,1,0,16347,7.0,17552,255,48,1267,-427,25.5,1634.7
4507366175,1,17,1,1,4,4,3,1,1,0,0,15239,7.2,18213,222,49,-251,231,22.2,1523.9,15,3,0,4,4,6,1,0,1,0,15490,6.8,17982,213,55,251,-231,21.3,1549.0
4454553196,1,16,3,1,8,7,11,0,0,0,0,17592,7.0,18440,224,46,1635,1705,22.4,1759.2,16,2,0,7,8,7,0,0,0,0,15957,6.4,16735,195,42,-1635,-1705,19.5,1595.7
4527354492,1,15,7,0,5,6,3,0,0,0,0,15678,6.8,17696,211,51,-596,774,21.1,1567.8,19,3,1,6,5,9,0,0,0,0,16274,6.8,16922,223,32,596,-774,22.3,1627.4
4480352834,1,18,1,1,7,3,10,0,0,0,0,17350,7.2,18363,233,46,2896,1979,23.3,1735.0,15,0,0,3,7,6,0,0,0,0,14454,6.4,16384,199,40,-2896,-1979,19.9,1445.4
4453181385,1,15,4,0,7,5,4,2,1,1,0,16372,7.2,19294,208,54,1162,2078,20.8,1637.2,14,4,1,5,7,5,0,0,0,0,15210,7.0,17216,193,40,-1162,-2078,19.3,1521.0
4518734421,0,19,4,0,5,10,6,1,0,1,0,15020,6.6,16196,182,52,-2620,-1037,18.2,1502.0,41,8,1,10,5,11,1,1,0,0,17640,6.8,17233,197,51,2620,1037,19.7,1764.0
4522207978,0,21,0,1,5,4,6,0,0,0,0,16158,7.4,19418,175,83,-811,1024,17.5,1615.8,15,4,0,4,5,2,2,1,1,1,16969,7.2,18394,232,48,811,-1024,23.2,1696.9
4452185923,1,18,2,0,6,9,10,0,0,0,0,17013,7.0,17832,246,42,-941,-1717,24.6,1701.3,16,2,1,9,6,7,0,0,0,0,17954,7.4,19549,240,40,941,1717,24.0,1795.4
4525312935,1,22,1,0,6,4,4,1,0,1,0,16926,7.2,19020,229,52,1947,1677,22.9,1692.6,17,3,1,4,6,1,1,1,0,0,14979,6.8,17343,230,44,-1947,-1677,23.0,1497.9
4519566772,0,21,2,1,3,5,5,0,0,0,0,15544,7.0,18015,238,48,-961,-1410,23.8,1554.4,18,6,0,5,3,4,1,1,0,0,16505,7.2,19425,239,76,961,1410,23.9,1650.5
4516748968,0,26,3,1,3,9,4,0,0,0,0,14280,6.2,15054,190,45,-3555,-3207,19.0,1428.0,15,1,0,9,3,10,1,1,0,0,17835,7.0,18261,220,43,3555,3207,22.0,1783.5
4513046591,0,16,1,1,8,12,7,0,0,0,0,16247,6.6,16555,189,36,-3023,-3630,18.9,1624.7,14,4,0,12,8,9,0,0,0,0,19270,7.6,20185,244,52,3023,3630,24.4,1927.0
4496746747,1,55,3,1,7,5,5,0,0,0,0,16812,7.0,19678,228,56,1322,2276,22.8,1681.2,17,4,0,5,7,5,1,1,0,0,15490,6.6,17402,215,64,-1322,-2276,21.5,1549.0
4518463691,1,20,4,1,7,0,11,1,1,0,0,16942,6.6,17249,214,48,3843,2831,21.4,1694.2,12,3,0,0,7,0,0,0,0,0,13099,6.2,14418,191,46,-3843,-2831,19.1,1309.9
4523068709,1,36,3,1,5,4,6,0,0,0,1,17519,6.8,17307,215,46,1953,135,21.5,1751.9,15,2,0,4,5,6,0,0,0,0,15566,6.6,17172,215,48,-1953,-135,21.5,1556.6
4514370002,0,13,1,0,3,4,5,0,0,0,0,14751,6.8,17562,217,39,-982,36,21.7,1475.1,13,1,1,4,3,6,1,1,0,0,15733,6.8,17526,210,72,982,-36,21.0,1573.3
4526960902,0,15,6,0,10,5,9,1,0,1,1,20419,7.6,20428,246,53,5113,4028,24.6,2041.9,50,1,1,5,10,5,1,1,0,0,15306,6.6,16400,186,40,-5113,-4028,18.6,1530.6
4522289326,0,13,2,1,2,3,1,1,1,0,0,14667,6.8,18007,202,55,-751,-1229,20.2,1466.7,13,2,0,3,2,5,0,0,0,0,15418,7.2,19236,239,60,751,1229,23.9,1541.8
4450504768,0,22,3,0,0,5,0,0,0,0,0,13643,7.0,16820,217,62,-3585,-3405,21.7,1364.3,18,4,1,5,0,6,1,1,0,0,17228,7.4,20225,266,68,3585,3405,26.6,1722.8
4524340195,0,13,3,0,4,6,3,0,0,0,0,15855,7.0,17820,212,71,-891,-768,21.2,1585.5,15,0,1,6,4,1,1,1,0,0,16746,7.0,18588,264,53,891,768,26.4,1674.6
4481959018,0,16,3,0,6,11,9,0,0,0,0,16230,6.8,17275,225,51,-2725,-2117,22.5,1623.0,16,4,1,11,6,12,1,1,0,0,18955,7.0,19392,221,74,2725,2117,22.1,1895.5
4521141561,0,19,4,0,5,12,5,0,0,0,0,15341,6.4,15896,188,32,-3588,-1795,18.8,1534.1,14,6,1,12,5,13,1,1,0,0,18929,6.6,17691,230,44,3588,1795,23.0,1892.9
4527257242,0,15,2,1,6,4,3,0,0,0,0,16366,7.0,18102,237,61,1980,1777,23.7,1636.6,17,1,0,4,6,4,1,1,0,0,14386,6.4,16325,203,40,-1980,-1777,20.3,1438.6
4509390548,0,16,0,1,6,9,9,0,0,0,0,15728,6.6,17183,208,44,-2701,-2275,20.8,1572.8,16,2,0,9,6,8,0,0,0,0,18429,7.2,19458,208,56,2701,2275,20.8,1842.9
4513948107,1,20,3,1,11,6,13,1,1,0,0,18401,7.0,18465,201,51,1843,1402,20.1,1840.1,16,3,0,6,11,8,0,0,0,0,16558,6.8,17063,212,36,-1843,-1402,21.2,1655.8
4520807181,1,14,3,0,2,3,1,1,1,0,0,14516,6.8,17487,229,55,-1558,-1472,22.9,1451.6,36,3,1,3,2,3,0,0,0,0,16074,7.0,18959,255,64,1558,1472,25.5,1607.4
4509066141,1,16,4,0,5,3,10,0,0,0,1,16981,6.8,17309,214,38,384,-465,21.4,1698.1,21,1,1,3,5,2,2,1,1,1,16597,7.0,17774,224,64,-384,465,22.4,1659.7
4500224763,0,8,1,0,1,5,2,0,0,0,0,13444,6.4,16544,197,52,-3445,-2015,19.7,1344.4,14,0,1,5,1,5,0,0,0,0,16889,7.0,18559,246,53,3445,2015,24.6,1688.9
4522558200,0,39,1,1,7,4,6,0,0,0,0,15885,7.2,19056,207,52,125,2058,20.7,1588.5,22,5,0,4,7,4,0,0,0,0,15760,6.8,16998,224,47,-125,-2058,22.4,1576.0
4495074549,0,16,4,1,3,6,3,0,0,0,0,14910,6.6,15466,195,36,-821,-2540,19.5,1491.0,44,3,0,6,3,4,1,1,0,0,15731,6.8,18006,206,67,821,2540,20.6,1573.1
4508130828,1,17,5,1,10,3,3,2,1,1,1,19904,7.6,21324,272,68,5305,4619,27.2,1990.4,16,2,0,3,10,3,0,0,0,0,14599,6.6,16705,210,58,-5305,-4619,21.0,1459.9
4515690341,1,16,6,1,8,11,13,1,1,0,0,16965,6.8,17225,200,44,-659,-701,20.0,1696.5,17,7,0,11,8,15,0,0,0,0,17624,6.8,17926,220,44,659,701,22.0,1762.4
4515960899,0,15,1,1,11,3,13,1,1,0,0,18102,7.0,18787,216,56,1712,1178,21.6,1810.2,15,2,0,3,11,1,1,0,1,1,16390,6.8,17609,226,36,-1712,-1178,22.6,1639.0
4501845720,1,13,5,1,10,4,7,0,0,0,0,18402,7.4,20050,258,48,3311,3166,25.8,1840.2,14,4,0,4,10,5,1,1,0,0,15091,6.6,16884,197,56,-3311,-3166,19.7,1509.1
4513943216,0,13,5,1,12,7,11,0,0,0,0,18306,6.6,16973,214,34,1898,274,21.4,1830.6,18,3,0,7,12,10,1,1,0,0,16408,6.4,16699,197,49,-1898,-274,19.7,1640.8
4502261943,1,45,3,0,7,6,10,1,1,0,0,16164,7.0,17989,196,48,-876,-1141,19.6,1616.4,19,6,1,6,7,4,0,0,0,0,17040,7.0,19130,239,60,876,1141,23.9,1704.0
4467514491,1,20,2,1,9,7,14,1,1,0,0,17722,7.0,18023,215,44,1672,1341,21.5,1772.2,18,2,0,7,9,8,0,0,0,0,16050,6.8,16682,205,35,-1672,-1341,20.5,1605.0
4496874595,0,15,1,1,7,9,8,0,0,0,0,17543,7.2,19187,236,47,204,-344,23.6,1754.3,13,4,0,9,7,7,1,1,0,0,17339,7.2,19531,237,43,-204,344,23.7,1733.9
4509467207,1,19,2,0,4,4,3,0,0,0,0,15588,6.8,17603,225,51,192,88,22.5,1558.8,45,4,1,4,4,7,2,1,1,0,15396,6.6,17515,241,46,-192,-88,24.1,1539.6
4508088834,1,86,4,1,9,0,7,1,1,0,0,18968,7.6,20401,239,56,5344,3793,23.9,1896.8,12,3,0,0,9,0,0,0,0,0,13624,6.4,16608,225,51,-5344,-3793,22.5,1362.4
4482149055,0,49,2,1,4,4,4,1,0,1,0,16777,6.8,18671,243,60,441,-233,24.3,1677.7,14,1,0,4,4,5,1,1,0,0,16336,7.2,18904,251,60,-441,233,25.1,1633.6
4451947704,0,83,2,1,5,5,7,0,0,0,0,16560,7.0,18547,225,50,761,830,22.5,1656.0,38,3,0,5,5,8,1,1,0,0,15799,6.8,17717,225,47,-761,-830,22.5,1579.9
4451694219,0,24,0,0,1,5,0,0,0,0,0,14824,7.2,18421,230,72,-1424,-2416,23.0,1482.4,14,2,1,5,1,3,1,1,0,0,16248,7.6,20837,228,68,1424,2416,22.8,1624.8
4449074537,1,19,1,1,11,3,10,2,1,1,1,20259,7.0,19498,238,52,6210,3599,23.8,2025.9,36,3,0,3,11,4,0,0,0,0,14049,6.6,15899,180,52,-6210,-3599,18.0,1404.9
4525832836,0,17,4,1,5,4,3,1,1,0,0,15926,6.6,16415,247,48,-299,-1889,24.7,1592.6,36,2,0,4,5,4,0,0,0,0,16225,7.0,18304,230,49,299,1889,23.0,1622.5
4527426713,1,21,4,0,11,3,14,1,1,0,0,18293,7.2,19481,218,52,2685,1151,21.8,1829.3,19,5,1,3,11,4,0,0,0,0,15608,7.0,18330,228,55,-2685,-1151,22.8,1560.8
4503387883,1,15,4,1,6,0,8,1,1,0,0,17482,7.2,19196,216,65,3781,3184,21.6,1748.2,17,2,0,0,6,0,0,0,0,0,13701,6.4,16012,223,56,-3781,-3184,22.3,1370.1
4523289245,1,15,1,0,7,7,7,1,0,1,0,16122,6.8,18226,168,57,-1167,259,16.8,1612.2,15,1,1,7,7,3,0,0,0,0,17289,7.0,17967,210,47,1167,-259,21.0,1728.9
4525855407,1,13,3,0,6,10,5,1,1,0,0,15741,6.8,17468,198,43,-1864,-1069,19.8,1574.1,17,3,1,10,6,7,0,0,0,0,17605,7.2,18537,205,48,1864,1069,20.5,1760.5
4491049455,0,16,4,0,5,11,6,0,0,0,0,15424,6.6,16080,208,45,-3692,-3112,20.8,1542.4,14,4,1,11,5,16,2,1,1,0,19116,7.2,19192,195,55,3692,3112,19.5,1911.6
4525113077,0,14,2,0,7,6,10,1,1,0,0,16243,6.8,17548,192,47,-555,-1462,19.2,1624.3,40,2,1,6,7,6,1,0,1,0,16798,7.2,19010,232,64,555,1462,23.2,1679.8
4516987544,0,13,3,1,3,3,3,0,0,0,0,16064,7.2,18651,247,56,1117,472,24.7,1606.4,17,2,0,3,3,0,2,1,1,0,14947,6.8,18179,229,54,-1117,-472,22.9,1494.7
4515321502,1,56,5,1,6,1,6,0,0,0,0,17592,7.6,19904,259,61,3031,1196,25.9,1759.2,13,2,0,1,6,1,0,0,0,0,14561,7.2,18708,224,77,-3031,-1196,22.4,1456.1
4475365709,1,18,0,0,5,3,6,1,1,0,0,15899,7.0,18161,225,42,698,101,22.5,1589.9,36,5,1,3,5,2,0,0,0,0,15201,7.0,18060,221,59,-698,-101,22.1,1520.1
4511791303,1,15,1,1,5,3,2,1,1,0,0,16421,7.0,18152,241,48,1239,-1051,24.1,1642.1,42,1,0,3,5,2,0,0,0,0,15182,7.2,19203,219,73,-1239,1051,21.9,1518.2
4452111743,1,17,5,1,10,5,6,2,1,1,0,17156,7.4,19115,235,32,777,977,23.5,1715.6,18,3,0,5,10,3,0,0,0,0,16379,7.0,18138,254,31,-777,-977,25.4,1637.9
4512278735,1,15,4,0,4,6,7,0,0,0,0,15634,7.2,18046,235,49,-1848,-617,23.5,1563.4,24,2,1,6,4,9,1,1,0,0,17482,7.2,18663,256,54,1848,617,25.6,1748.2
4502054946,0,15,4,0,8,4,11,0,0,0,0,17476,7.2,19033,245,52,1716,1970,24.5,1747.6,15,3,1,4,8,8,0,0,0,0,15760,6.6,17063,209,48,-1716,-1970,20.9,1576.0
4489994401,1,14,9,0,11,6,12,1,0,1,0,17850,7.4,18858,204,64,1926,3729,20.4,1785.0,17,0,1,6,11,8,1,1,0,0,15924,6.4,15129,167,39,-1926,-3729,16.7,1592.4
4472127504,0,20,1,1,8,8,10,2,1,1,0,16906,6.8,17910,207,48,226,221,20.7,1690.6,15,3,0,8,8,4,0,0,0,0,16680,6.8,17689,176,54,-226,-221,17.6,1668.0
4494605842,1,14,3,0,6,11,8,0,0,0,0,16557,6.8,17924,232,55,-2564,170,23.2,1655.7,15,2,1,11,6,25,1,1,0,0,19121,6.8,17754,219,55,2564,-170,21.9,1912.1
4413595915,1,14,3,1,6,1,6,0,0,0,0,17066,7.6,20061,239,75,3215,2650,23.9,1706.6,11,1,0,1,6,0,1,0,1,0,13851,6.8,17411,220,56,-3215,-2650,22.0,1385.1
4489207578,0,15,7,1,4,5,4,0,0,0,0,15079,7.0,18092,196,55,-1226,-1378,19.6,1507.9,39,3,0,5,4,3,0,0,0,0,16305,7.2,19470,261,56,1226,1378,26.1,1630.5
4515671076,0,18,0,0,2,7,3,1,1,0,0,14258,6.6,16594,198,52,-3903,-2516,19.8,1425.8,21,4,1,7,2,8,0,0,0,0,18161,7.2,19110,261,48,3903,2516,26.1,1816.1
4523105100,0,12,5,1,2,6,1,0,0,0,0,14417,6.6,16652,198,60,-1930,-2043,19.8,1441.7,17,2,0,6,2,7,1,1,0,0,16347,7.2,18695,223,53,1930,2043,22.3,1634.7
4512490031,1,13,1,0,3,4,3,1,1,0,0,14943,6.8,17710,223,51,-626,61,22.3,1494.3,18,1,1,4,3,8,0,0,0,0,15569,6.8,17649,233,48,626,-61,23.3,1556.9
4524509004,1,16,2,0,3,5,3,0,0,0,0,15366,7.0,17861,230,55,-1364,-87,23.0,1536.6,15,2,1,5,3,7,1,1,0,0,16730,6.8,17948,243,40,1364,87,24.3,1673.0
4506537337,0,16,4,1,4,5,3,0,0,0,0,15347,7.0,17655,234,46,-1374,-1041,23.4,1534.7,22,0,0,5,4,7,2,1,1,0,16721,6.8,18696,238,57,1374,1041,23.8,1672.1
4516597523,0,16,2,0,5,8,4,0,0,0,0,15476,6.8,16908,184,57,-1972,-1621,18.4,1547.6,16,1,1,8,5,10,2,1,1,0,17448,7.2,18529,213,48,1972,1621,21.3,1744.8
4518664448,0,13,5,1,7,9,9,0,0,0,0,15570,6.8,15894,198,36,-2365,-1443,19.8,1557.0,20,2,0,9,7,14,0,0,0,0,17935,6.8,17337,204,44,2365,1443,20.4,1793.5
4462148925,1,17,2,1,4,3,10,1,1,0,0,15730,7.0,18484,241,52,739,-270,24.1,1573.0,16,2,0,3,4,5,0,0,0,0,14991,7.0,18754,239,59,-739,270,23.9,1499.1
4500852521,0,35,2,1,6,5,6,0,0,0,0,16575,7.0,18673,233,50,-134,-146,23.3,1657.5,16,3,0,5,6,6,1,1,0,0,16709,7.2,18819,242,68,134,146,24.2,1670.9
4442070152,0,15,4,0,5,4,8,0,0,0,0,15552,6.6,17234,201,37,-1493,-1179,20.1,1555.2,18,2,1,4,5,5,1,1,0,0,17045,7.0,18413,250,68,1493,1179,25.0,1704.5
4526441626,0,13,3,0,7,11,8,0,0,0,0,16786,6.6,16781,189,60,-1739,-838,18.9,1678.6,16,2,1,11,7,16,1,1,0,0,18525,7.0,17619,196,52,1739,838,19.6,1852.5
4501989781,1,11,1,1,6,4,6,0,0,0,0,16368,7.2,18776,204,52,1418,1328,20.4,1636.8,12,1,0,4,6,4,1,1,0,0,14950,6.8,17448,194,55,-1418,-1328,19.4,1495.0
4506553264,1,14,0,1,10,3,9,1,1,0,0,18096,7.2,19349,242,46,3738,4262,24.2,1809.6,11,4,0,3,10,4,0,0,0,0,14358,6.4,15087,198,47,-3738,-4262,19.8,1435.8
4498670956,1,129,4,0,7,9,10,1,1,0,0,16570,7.0,18238,206,56,-1262,-769,20.6,1657.0,13,5,1,9,7,14,0,0,0,0,17832,7.0,19007,231,50,1262,769,23.1,1783.2
4472618887,1,17,3,1,9,6,8,1,1,0,0,17410,7.0,18627,190,60,1578,495,19.0,1741.0,15,2,0,6,9,6,0,0,0,0,15832,7.0,18132,195,52,-1578,-495,19.5,1583.2
4496543857,0,15,5,0,9,10,9,0,0,0,0,17987,6.8,17683,209,41,-368,-612,20.9,1798.7,17,2,1,10,9,11,0,0,0,0,18355,7.2,18295,236,54,368,612,23.6,1835.5
4500722833,1,25,3,1,6,1,9,1,1,0,0,17450,7.2,19276,233,44,3610,2295,23.3,1745.0,12,2,0,1,6,1,0,0,0,0,13840,6.4,16981,226,39,-3610,-2295,22.6,1384.0
4500814768,1,22,2,1,6,4,9,1,1,0,0,16231,6.8,17392,222,50,124,-2259,22.2,1623.1,13,3,0,4,6,2,0,0,0,0,16107,7.4,19651,239,68,-124,2259,23.9,1610.7
4475997366,0,19,1,1,6,3,6,1,0,1,0,17170,6.8,18330,238,56,2241,639,23.8,1717.0,15,2,0,3,6,3,0,0,0,0,14929,6.6,17691,214,60,-2241,-639,21.4,1492.9
4522851544,0,15,2,0,4,8,5,0,0,0,0,14993,6.6,16251,215,33,-1845,-1879,21.5,1499.3,14,6,1,8,4,10,1,1,0,0,16838,7.0,18130,229,52,1845,1879,22.9,1683.8
4505233035,1,39,0,1,5,7,4,0,0,0,0,16247,6.8,17790,189,52,-820,-575,18.9,1624.7,16,5,0,7,5,6,1,1,0,0,17067,7.0,18365,222,57,820,575,22.2,1706.7
4518231271,0,12,3,0,3,8,3,1,1,0,0,15222,6.8,17667,220,55,-1650,-1358,22.0,1522.2,70,1,1,8,3,9,1,0,1,0,16872,7.2,19025,217,52,1650,1358,21.7,1687.2
4516833244,0,15,2,0,6,8,6,1,0,1,0,16005,6.6,17346,188,58,-1205,-1042,18.8,1600.5,17,4,1,8,6,6,1,1,0,0,17210,7.2,18388,232,34,1205,1042,23.2,1721.0
4454696616,1,15,2,0,2,2,2,0,0,0,0,15367,7.0,18723,238,72,183,-231,23.8,1536.7,49,1,1,2,2,2,2,1,1,0,15184,7.2,18954,233,67,-183,231,23.3,1518.4
4521976422,1,16,2,0,7,8,5,1,0,1,0,16697,7.4,19017,205,44,-333,1358,20.5,1669.7,19,3,1,8,7,8,1,1,0,0,17030,6.8,17659,222,52,333,-1358,22.2,1703.0
4484014215,0,15,6,0,6,5,6,0,0,0,0,15355,7.2,17702,197,51,-843,147,19.7,1535.5,25,1,1,5,6,7,1,1,0,0,16198,7.0,17555,223,55,843,-147,22.3,1619.8
4524019203,0,19,4,0,8,5,9,0,0,0,0,18098,7.2,19504,212,76,2730,3068,21.2,1809.8,19,2,1,5,8,2,1,1,0,0,15368,6.4,16436,215,40,-2730,-3068,21.5,1536.8
4506509024,0,15,5,0,4,7,2,1,1,0,0,13960,6.4,16218,184,52,-2791,-2142,18.4,1396.0,14,6,1,7,4,7,0,0,0,0,16751,7.0,18360,238,49,2791,2142,23.8,1675.1
4511068350,1,36,1,1,10,3,10,1,0,1,0,19886,7.4,20060,240,67,5349,3639,24.0,1988.6,15,1,0,3,10,5,0,0,0,0,14537,6.6,16421,189,44,-5349,-3639,18.9,1453.7
4464085930,0,30,0,1,9,9,9,0,0,0,0,17658,7.0,17546,214,47,108,-88,21.4,1765.8,16,2,0,9,9,8,1,0,1,0,17550,7.0,17634,235,36,-108,88,23.5,1755.0
4508518310,0,16,2,0,2,3,4,0,0,0,0,14505,6.8,18139,230,51,-1183,-182,23.0,1450.5,42,3,1,3,2,4,1,1,0,0,15688,7.0,18321,253,48,1183,182,25.3,1568.8
4510986413,1,18,1,1,9,2,8,1,0,1,1,20027,7.2,19439,257,55,6790,4889,25.7,2002.7,17,3,0,2,9,4,1,1,0,0,13237,6.2,14550,165,49,-6790,-4889,16.5,1323.7
4510543830,1,15,0,1,5,6,3,2,1,1,0,15524,6.8,17366,182,63,-700,83,18.2,1552.4,13,4,0,6,5,7,0,0,0,0,16224,6.8,17283,194,39,700,-83,19.4,1622.4
4492093382,0,14,4,0,2,11,4,0,0,0,0,14660,6.6,17284,232,52,-3941,-2386,23.2,1466.0,17,4,1,11,2,19,1,1,0,0,18601,7.4,19670,195,56,3941,2386,19.5,1860.1
4497747862,1,17,3,0,10,10,10,0,0,0,0,19035,7.2,18221,219,38,120,1209,21.9,1903.5,13,1,1,10,10,10,1,0,1,1,18915,6.6,17012,208,31,-120,-1209,20.8,1891.5
4499681914,0,15,1,1,1,13,1,0,0,0,0,12622,5.8,13759,185,32,-6954,-5631,18.5,1262.2,17,4,0,13,1,16,2,1,1,0,19576,7.4,19390,228,44,6954,5631,22.8,1957.6
4476823895,1,11,1,0,14,9,14,0,0,0,0,19170,7.0,18219,193,42,3062,2772,19.3,1917.0,11,1,1,9,14,13,0,0,0,0,16108,6.2,15447,142,38,-3062,-2772,14.2,1610.8
4523445497,1,21,5,1,7,5,8,1,1,0,0,16940,7.0,18209,238,44,1995,345,23.8,1694.0,74,6,0,5,7,4,1,0,1,0,14945,7.2,17864,193,50,-1995,-345,19.3,1494.5
4480411096,0,15,2,1,8,7,7,0,0,0,0,17378,7.2,18525,242,39,708,302,24.2,1737.8,13,1,0,7,8,6,0,0,0,0,16670,7.0,18223,235,45,-708,-302,23.5,1667.0
4520036166,0,14,2,0,1,11,0,0,0,0,0,13701,6.6,15626,200,48,-4873,-2666,20.0,1370.1,15,1,1,11,1,12,1,1,0,0,18574,7.2,18292,222,46,4873,2666,22.2,1857.4
4439457123,1,76,2,1,5,5,6,1,0,1,0,16298,7.0,18210,230,60,924,323,23.0,1629.8,14,4,0,5,5,5,1,1,0,0,15374,6.8,17887,209,50,-924,-323,20.9,1537.4
4517768764,0,34,1,0,1,3,0,0,0,0,0,14434,6.8,17904,221,67,-920,-451,22.1,1443.4,16,10,1,3,1,3,1,1,0,0,15354,6.8,18355,230,48,920,451,23.0,1535.4
4432528181,1,16,0,1,8,5,11,0,0,0,0,17145,7.0,17795,204,70,2563,1726,20.4,1714.5,13,3,0,5,8,5,1,1,0,0,14582,6.6,16069,181,36,-2563,-1726,18.1,1458.2
4526051141,0,13,5,0,6,9,3,0,0,0,0,15450,6.8,17448,207,31,-1989,-1299,20.7,1545.0,16,0,1,9,6,9,0,0,0,0,17439,7.2,18747,213,36,1989,1299,21.3,1743.9
4526523004,0,14,5,1,7,3,14,1,1,0,0,16594,7.0,18266,217,51,611,290,21.7,1659.4,18,1,0,3,7,1,0,0,0,0,15983,6.8,17976,239,60,-611,-290,23.9,1598.3
4450484115,1,17,3,1,11,3,9,1,1,0,0,18583,7.2,18852,204,55,4280,2681,20.4,1858.3,17,1,0,3,11,2,0,0,0,0,14303,6.4,16171,202,48,-4280,-2681,20.2,1430.3
4521619561,1,11,2,1,14,6,12,0,0,0,0,19588,7.2,19987,217,45,3864,2988,21.7,1958.8,28,1,0,6,14,10,0,0,0,0,15724,6.8,16999,162,50,-3864,-2988,16.2,1572.4
4513293772,0,17,0,1,3,9,2,0,0,0,0,13820,5.8,13497,158,45,-3996,-2986,15.8,1382.0,90,1,0,9,3,14,1,1,0,0,17816,6.6,16483,190,48,3996,2986,19.0,1781.6
4481839790,0,14,1,0,4,8,2,0,0,0,0,15155,6.6,16875,201,68,-2548,-826,20.1,1515.5,14,1,1,8,4,10,1,1,0,0,17703,7.2,17701,212,44,2548,826,21.2,1770.3
4507176171,0,18,3,0,4,4,6,0,0,0,0,15089,6.8,17046,213,40,-494,-817,21.3,1508.9,20,6,1,4,4,4,2,1,1,0,15583,6.8,17863,216,61,494,817,21.6,1558.3
4442091284,0,20,4,1,5,8,6,0,0,0,0,16440,6.8,17567,238,55,-892,-255,23.8,1644.0,18,1,0,8,5,14,1,1,0,0,17332,7.0,17822,206,44,892,255,20.6,1733.2
4515240006,0,16,5,0,5,10,8,0,0,0,0,15829,6.8,17626,236,53,-3567,-1828,23.6,1582.9,18,4,1,10,5,11,2,1,1,1,19396,7.2,19454,234,49,3567,1828,23.4,1939.6
4518610443,0,18,4,0,6,7,9,1,1,0,0,15689,6.6,17178,171,63,-808,-266,17.1,1568.9,13,3,1,7,6,9,0,0,0,0,16497,6.8,17444,211,52,808,266,21.1,1649.7
4472857814,1,18,3,0,5,5,8,1,1,0,0,16498,7.0,18296,259,50,460,183,25.9,1649.8,11,3,1,5,5,7,0,0,0,0,16038,7.0,18113,213,53,-460,-183,21.3,1603.8
4489707726,1,30,2,0,8,7,12,1,1,0,0,16957,6.6,17656,215,42,78,658,21.5,1695.7,15,3,1,7,8,11,0,0,0,0,16879,6.8,16998,207,40,-78,-658,20.7,1687.9
4519898107,1,14,2,0,7,2,12,2,1,1,0,18025,7.2,19864,261,68,3558,3243,26.1,1802.5,25,0,1,2,7,3,0,0,0,0,14467,6.8,16621,220,56,-3558,-3243,22.0,1446.7
4515518860,0,13,2,1,7,7,4,1,0,1,0,16699,7.0,18064,212,48,559,55,21.2,1669.9,16,3,0,7,7,7,1,1,0,0,16140,7.2,18009,194,56,-559,-55,19.4,1614.0
4437519921,1,9,1,0,5,4,3,0,0,0,0,16823,7.2,19226,226,68,1409,2767,22.6,1682.3,15,0,1,4,5,7,0,0,0,0,15414,6.6,16459,188,52,-1409,-2767,18.8,1541.4
4474570659,1,13,3,1,11,6,10,0,0,0,0,18335,6.8,17921,238,36,2498,732,23.8,1833.5,15,1,0,6,11,7,0,0,0,0,15837,6.8,17189,194,52,-2498,-732,19.4,1583.7
4458085215,0,17,2,0,6,11,8,0,0,0,0,15250,6.2,15780,183,50,-4699,-4580,18.3,1525.0,16,3,1,11,6,12,1,1,0,0,19949,7.4,20360,237,56,4699,4580,23.7,1994.9
4508688616,0,11,6,0,5,9,4,0,0,0,0,15106,7.0,17323,200,36,-2793,83,20.0,1510.6,21,3,1,9,5,12,1,0,1,0,17899,6.8,17240,215,35,2793,-83,21.5,1789.9
4521580366,0,32,3,0,6,10,5,1,0,1,0,16406,7.0,17714,208,55,-1530,-988,20.8,1640.6,14,4,1,10,6,10,1,1,0,0,17936,7.0,18702,224,56,1530,988,22.4,1793.6
4526028711,0,19,3,0,3,7,4,0,0,0,0,15191,6.6,17269,214,61,-1848,-1472,21.4,1519.1,19,5,1,7,3,9,2,1,1,0,17039,7.0,18741,219,47,1848,1472,21.9,1703.9
4523922035,1,19,2,0,3,3,3,1,1,0,0,15231,7.0,17617,221,52,1076,759,22.1,1523.1,20,6,1,3,3,0,0,0,0,0,14155,6.8,16858,223,37,-1076,-759,22.3,1415.5
4527306829,0,12,1,0,5,10,4,1,1,0,0,16107,6.8,17630,229,54,-2534,-1019,22.9,1610.7,13,4,1,10,5,14,1,0,1,0,18641,7.2,18649,204,41,2534,1019,20.4,1864.1
4503065497,0,91,3,1,6,1,4,2,1,1,0,17016,7.2,19237,214,55,3266,1337,21.4,1701.6,14,0,0,1,6,0,0,0,0,0,13750,6.8,17900,218,56,-3266,-1337,21.8,1375.0
4298114879,1,21,2,0,6,2,8,0,0,0,0,16818,6.8,16961,204,52,1448,-664,20.4,1681.8,19,4,1,2,6,2,1,1,0,0,15370,7.0,17625,250,60,-1448,664,25.0,1537.0
4520688318,0,54,4,0,11,6,22,1,0,1,0,18640,7.0,18015,226,48,1931,1200,22.6,1864.0,13,2,1,6,11,10,1,1,0,0,16709,6.6,16815,232,62,-1931,-1200,23.2,1670.9
4492336087,1,35,0,0,3,6,4,1,1,0,0,14798,6.8,16659,179,54,-2402,-1757,17.9,1479.8,14,0,1,6,3,7,0,0,0,0,17200,6.8,18416,227,52,2402,1757,22.7,1720.0
4489614649,1,14,2,1,11,5,18,1,1,0,0,18324,7.0,18016,205,47,2158,640,20.5,1832.4,15,2,0,5,11,8,0,0,0,0,16166,7.0,17376,219,45,-2158,-640,21.9,1616.6
4525136994,1,77,3,0,5,6,6,0,0,0,0,16627,7.0,18363,223,59,-135,-997,22.3,1662.7,52,3,1,6,5,7,1,1,0,0,16762,7.0,19360,236,68,135,997,23.6,1676.2
4523425333,0,21,5,0,4,5,4,0,0,0,0,15564,6.8,17895,216,59,-433,445,21.6,1556.4,16,5,1,5,4,7,1,1,0,0,15997,6.8,17450,225,52,433,-445,22.5,1599.7
4527729232,0,36,3,0,4,13,5,0,0,0,0,14478,6.2,14665,171,32,-5087,-4618,17.1,1447.8,40,3,1,13,4,12,0,0,0,0,19565,7.2,19283,199,71,5087,4618,19.9,1956.5
4492308589,0,15,5,1,5,8,6,0,0,0,0,15627,6.8,17457,199,56,-2690,-3245,19.9,1562.7,58,1,0,8,5,9,2,1,1,0,18317,7.6,20702,230,92,2690,3245,23.0,1831.7
4470051820,0,17,7,0,3,5,2,2,1,1,0,14303,6.2,15787,187,58,-2657,-2095,18.7,1430.3,21,2,1,5,3,6,0,0,0,0,16960,7.0,17882,237,51,2657,2095,23.7,1696.0
4523957220,1,16,2,1,11,4,7,1,1,0,0,18265,7.6,20351,237,52,3362,3874,23.7,1826.5,44,2,0,4,11,2,0,0,0,0,14903,6.6,16477,187,50,-3362,-3874,18.7,1490.3
4455082508,1,17,2,0,9,4,9,1,0,1,0,18622,7.0,18509,230,44,2962,1156,23.0,1862.2,13,2,1,4,9,6,1,1,0,0,15660,6.8,17353,181,79,-2962,-1156,18.1,1566.0
4465188797,0,14,1,1,6,7,5,0,0,0,0,15891,7.0,17964,207,41,-1190,-911,20.7,1589.1,14,1,0,7,6,4,0,0,0,0,17081,7.0,18875,224,54,1190,911,22.4,1708.1
4508411289,1,14,3,0,4,4,4,1,1,0,0,17055,7.2,19132,228,80,1400,488,22.8,1705.5,14,3,1,4,4,3,0,0,0,0,15655,7.2,18644,235,47,-1400,-488,23.5,1565.5
4486499465,1,14,4,1,7,9,7,0,0,0,0,16149,6.4,16018,186,48,-393,-478,18.6,1614.9,15,1,0,9,7,7,0,0,0,0,16542,6.4,16496,173,48,393,478,17.3,1654.2
4518790705,0,10,0,0,6,8,8,0,0,0,0,16985,7.0,18802,240,43,-805,254,24.0,1698.5,14,2,1,8,6,10,1,1,0,0,17790,7.0,18548,221,53,805,-254,22.1,1779.0
4519461793,0,18,1,0,4,7,7,0,0,0,0,15818,6.8,17864,233,47,-60,1347,23.3,1581.8,62,3,1,7,4,13,1,1,0,0,15878,6.6,16517,186,36,60,-1347,18.6,1587.8
4526791420,1,18,2,0,3,3,3,1,0,1,1,16748,7.0,17820,221,64,2533,1524,22.1,1674.8,38,1,1,3,3,4,1,1,0,0,14215,6.4,16296,198,44,-2533,-1524,19.8,1421.5
4513780081,1,16,2,1,11,6,13,1,1,0,0,18136,7.0,18077,194,55,649,343,19.4,1813.6,15,3,0,6,11,8,0,0,0,0,17487,7.0,17734,239,44,-649,-343,23.9,1748.7
4519865094,1,57,4,0,7,2,8,2,1,1,0,17750,7.4,20138,237,56,3673,2756,23.7,1775.0,16,0,1,2,7,1,0,0,0,0,14077,6.8,17382,204,56,-3673,-2756,20.4,1407.7
4518151873,0,31,5,0,7,7,6,0,0,0,0,18282,7.0,19001,240,56,1542,1059,24.0,1828.2,18,2,1,7,7,7,1,1,0,0,16740,7.0,17942,212,59,-1542,-1059,21.2,1674.0
4510604428,0,14,3,1,1,8,1,0,0,0,0,14742,6.8,16872,219,51,-2177,-2726,21.9,1474.2,13,2,0,8,1,15,2,1,1,0,16919,7.2,19598,197,61,2177,2726,19.7,1691.9
4465204267,0,40,4,0,1,7,1,0,0,0,0,13556,6.8,16451,200,48,-3846,-2306,20.0,1355.6,17,5,1,7,1,7,1,1,0,0,17402,7.2,18757,253,52,3846,2306,25.3,1740.2
4508607080,1,39,4,0,10,10,12,0,0,0,0,17860,7.0,17673,182,52,-268,407,18.2,1786.0,15,4,1,10,10,16,0,0,0,0,18128,6.8,17266,199,40,268,-407,19.9,1812.8
4522592356,1,18,5,1,8,3,5,0,0,0,0,16818,7.0,18454,231,45,3138,2806,23.1,1681.8,16,1,0,3,8,0,2,1,1,0,13680,6.4,15648,196,51,-3138,-2806,19.6,1368.0
4477642564,0,21,4,0,5,6,2,1,1,0,0,14969,6.6,16860,200,60,-1579,-1179,20.0,1496.9,18,11,1,6,5,1,0,0,0,0,16548,7.2,18039,226,56,1579,1179,22.6,1654.8
4522662878,0,15,1,0,5,4,7,0,0,0,0,16129,7.0,18291,222,54,627,174,22.2,1612.9,12,0,1,4,5,5,1,1,0,0,15502,7.2,18117,219,57,-627,-174,21.9,1550.2
4527532742,1,36,6,1,12,6,16,0,0,0,0,18460,7.0,18568,229,27,2974,2777,22.9,1846.0,16,2,0,6,12,11,0,0,0,0,15486,6.4,15791,185,43,-2974,-2777,18.5,1548.6
4452219290,1,52,6,1,5,1,9,1,1,0,0,16809,7.2,18916,241,55,2192,464,24.1,1680.9,16,4,0,1,5,1,0,0,0,0,14617,6.8,18452,246,59,-2192,-464,24.6,1461.7
4508792949,1,11,2,1,11,4,12,2,1,1,0,17970,7.2,19866,208,64,2003,2155,20.8,1797.0,20,1,0,4,11,4,0,0,0,0,15967,7.0,17711,230,54,-2003,-2155,23.0,1596.7
4492300291,1,17,3,0,11,5,15,1,1,0,0,18204,7.0,18154,186,60,1790,350,18.6,1820.4,38,5,1,5,11,4,0,0,0,0,16414,7.0,17804,229,57,-1790,-350,22.9,1641.4
4450209621,0,21,3,0,8,9,9,2,1,1,0,17421,6.8,17858,217,44,-1330,378,21.7,1742.1,19,9,1,9,8,10,0,0,0,1,18751,7.0,17480,217,37,1330,-378,21.7,1875.1
4518759823,1,37,3,1,12,5,15,1,1,0,0,19141,7.6,20647,192,60,4294,4438,19.2,1914.1,15,2,0,5,12,3,0,0,0,0,14847,6.4,16209,210,36,-4294,-4438,21.0,1484.7
4522569310,0,15,7,0,1,4,1,0,0,0,0,13512,6.4,16628,224,47,-2327,-742,22.4,1351.2,17,2,1,4,1,6,1,1,0,0,15839,7.0,17370,215,48,2327,742,21.5,1583.9
4525999978,1,15,15,0,12,5,11,1,0,1,0,19659,7.2,19474,241,48,3745,1627,24.1,1965.9,27,3,1,5,12,6,0,0,0,0,15914,7.0,17847,230,53,-3745,-1627,23.0,1591.4
4455400959,1,35,3,1,8,3,13,0,0,0,0,17325,7.0,18380,217,26,3454,2249,21.7,1732.5,14,0,0,3,8,3,1,1,0,0,13871,6.8,16131,193,48,-3454,-2249,19.3,1387.1
4526667175,0,17,5,0,3,7,3,1,1,0,0,14322,6.4,16812,186,60,-3441,-1732,18.6,1432.2,21,4,1,7,3,9,1,0,1,0,17763,7.0,18544,227,48,3441,1732,22.7,1776.3
4521292011,0,48,3,1,6,4,8,0,0,0,0,15708,6.8,16783,197,36,-189,-211,19.7,1570.8,13,1,0,4,6,3,1,0,1,0,15897,6.8,16994,244,28,189,211,24.4,1589.7
4503214718,0,20,2,1,1,2,1,0,0,0,0,13993,6.6,16977,213,43,-961,-1080,21.3,1399.3,38,2,0,2,1,2,1,0,1,0,14954,7.0,18057,235,63,961,1080,23.5,1495.4
4476185279,0,43,3,0,9,12,8,0,0,0,0,17030,6.8,16983,176,41,-1567,1876,17.6,1703.0,15,0,1,12,9,15,0,0,0,0,18597,6.2,15107,171,36,1567,-1876,17.1,1859.7
4523454499,0,90,3,0,12,9,13,0,0,0,0,18131,7.0,17297,193,40,1025,439,19.3,1813.1,25,2,1,9,12,13,1,1,0,0,17106,6.8,16858,213,40,-1025,-439,21.3,1710.6
4504180691,1,12,4,1,7,3,8,1,1,0,0,18068,7.2,19266,252,60,3299,1803,25.2,1806.8,17,0,0,3,7,3,1,0,1,0,14769,6.8,17463,201,59,-3299,-1803,20.1,1476.9
4464918638,0,123,2,1,5,7,6,0,0,0,0,16560,7.2,19116,235,57,-529,-54,23.5,1656.0,65,1,0,7,5,8,1,1,0,0,17089,7.0,19170,223,63,529,54,22.3,1708.9
4500418922,1,16,3,1,9,8,11,2,1,1,0,17097,6.8,16795,202,46,-197,-2391,20.2,1709.7,75,4,0,8,9,8,0,0,0,0,17294,7.2,19186,219,48,197,2391,21.9,1729.4
4516410666,0,19,4,1,4,7,7,1,0,1,0,15904,6.6,16786,232,47,-1067,-1598,23.2,1590.4,18,3,0,7,4,5,1,1,0,0,16971,7.0,18384,230,39,1067,1598,23.0,1697.1
4520773672,0,19,3,1,13,4,17,0,0,0,0,19145,7.2,19160,218,40,4947,3211,21.8,1914.5,15,4,0,4,13,2,1,1,0,0,14198,6.2,15949,203,36,-4947,-3211,20.3,1419.8
4471757577,1,14,3,1,11,5,13,1,0,1,0,18984,7.2,18355,246,40,3522,1442,24.6,1898.4,11,5,0,5,11,4,0,0,0,0,15462,6.6,16913,186,56,-3522,-1442,18.6,1546.2
4467606891,1,16,1,0,6,7,7,0,0,0,0,16489,7.2,17951,219,55,-592,-223,21.9,1648.9,14,3,1,7,6,9,2,1,1,0,17081,7.0,18174,227,52,592,223,22.7,1708.1
4477273718,1,14,1,1,4,2,4,0,0,0,0,15843,7.2,18349,236,47,1284,395,23.6,1584.3,17,3,0,2,4,1,1,1,0,0,14559,7.0,17954,204,64,-1284,-395,20.4,1455.9
4468615107,0,87,3,0,7,3,10,2,1,1,0,16335,7.2,18087,212,56,600,-81,21.2,1633.5,16,2,1,3,7,3,0,0,0,0,15735,7.0,18168,246,56,-600,81,24.6,1573.5
4489529457,1,21,1,1,8,7,13,0,0,0,0,17212,7.0,17919,227,41,684,167,22.7,1721.2,14,2,0,7,8,6,0,0,0,0,16528,6.8,17752,199,55,-684,-167,19.9,1652.8
4526332479,1,19,3,0,11,5,9,0,0,0,0,18786,7.4,19353,244,40,3559,3296,24.4,1878.6,15,4,1,5,11,5,0,0,0,0,15227,6.4,16057,187,56,-3559,-3296,18.7,1522.7
4525811703,0,17,3,1,9,5,10,0,0,0,0,16515,6.6,16954,198,42,1547,1218,19.8,1651.5,16,3,0,5,9,4,1,1,0,0,14968,6.4,15736,193,44,-1547,-1218,19.3,1496.8
4517776994,1,63,4,0,6,2,6,1,1,0,0,16152,7.0,18649,228,53,1069,1104,22.8,1615.2,11,19,1,2,6,2,0,0,0,0,15083,6.8,17545,238,46,-1069,-1104,23.8,1508.3
4520933584,1,17,6,0,7,3,7,0,0,0,0,16849,7.0,18439,231,44,1991,1977,23.1,1684.9,16,3,1,3,7,3,1,1,0,0,14858,6.4,16462,223,49,-1991,-1977,22.3,1485.8
4497737191,0,17,3,0,3,3,2,1,1,0,0,14409,6.4,17030,212,44,-108,-914,21.2,1440.9,42,3,1,3,3,5,1,0,1,0,14517,7.0,17944,200,50,108,914,20.0,1451.7
4515413572,0,66,2,1,6,6,6,1,0,1,0,16124,6.6,17227,225,24,-725,-925,22.5,1612.4,14,4,0,6,6,6,1,1,0,0,16849,6.8,18152,246,54,725,925,24.6,1684.9
4518071306,1,18,3,1,15,8,12,1,1,0,0,20855,7.2,20164,196,46,4083,3740,19.6,2085.5,17,3,0,8,15,8,0,0,0,0,16772,6.6,16424,171,44,-4083,-3740,17.1,1677.2
4496579153,1,16,2,1,8,2,7,1,0,1,0,17755,7.2,19720,228,48,3755,2662,22.8,1775.5,14,1,0,2,8,3,0,0,0,0,14000,6.6,17058,183,51,-3755,-2662,18.3,1400.0
4521841751,0,16,0,0,6,14,9,1,1,0,0,15544,6.2,15313,176,43,-4625,-3447,17.6,1554.4,14,5,1,14,6,17,1,0,1,1,20169,7.2,18760,239,40,4625,3447,23.9,2016.9
4492509344,1,18,3,0,4,3,3,1,1,0,0,15442,7.2,18590,220,64,-79,-815,22.0,1544.2,51,3,1,3,4,4,1,0,1,0,15521,7.2,19405,217,72,79,815,21.7,1552.1
4482285408,0,16,1,0,2,11,2,0,0,0,0,13449,6.4,15122,180,44,-6076,-3107,18.0,1344.9,13,2,1,11,2,12,1,0,1,1,19525,6.8,18229,193,55,6076,3107,19.3,1952.5
4458756399,1,24,6,0,10,8,7,0,0,0,0,19280,7.2,19831,240,52,2365,2052,24.0,1928.0,41,2,1,8,10,8,0,0,0,0,16915,7.0,17779,211,40,-2365,-2052,21.1,1691.5
4525590476,1,19,6,1,8,6,10,2,1,1,0,17537,7.2,19766,236,60,2008,2714,23.6,1753.7,25,6,0,6,8,5,0,0,0,0,15529,6.8,17052,210,42,-2008,-2714,21.0,1552.9
4521632835,0,13,5,0,7,7,7,1,1,0,0,16635,7.0,17795,215,62,544,758,21.5,1663.5,33,1,1,7,7,10,0,0,0,0,16091,6.6,17037,194,49,-544,-758,19.4,1609.1
4509918642,1,17,2,1,10,1,5,0,0,0,1,19699,7.4,20307,251,43,5935,2933,25.1,1969.9,13,1,0,1,10,1,1,1,0,0,13764,7.0,17374,184,70,-5935,-2933,18.4,1376.4
4525317439,0,16,1,0,5,5,5,0,0,0,0,15930,6.8,17859,236,48,179,-962,23.6,1593.0,37,3,1,5,5,4,2,1,1,0,15751,7.2,18821,225,52,-179,962,22.5,1575.1
4522565095,1,144,3,0,4,4,5,0,0,0,0,17001,7.2,19717,242,61,759,467,24.2,1700.1,10,3,1,4,4,4,0,0,0,0,16242,7.2,19250,242,63,-759,-467,24.2,1624.2
4506503377,1,13,4,1,8,9,8,1,1,0,0,17800,7.2,19759,223,72,-95,194,22.3,1780.0,12,3,0,9,8,9,0,0,0,0,17895,7.0,19565,232,52,95,-194,23.2,1789.5
4526435139,1,19,7,1,4,4,3,2,1,1,0,16127,6.8,18248,235,64,1071,644,23.5,1612.7,23,2,0,4,4,4,0,0,0,0,15056,6.6,17604,212,41,-1071,-644,21.2,1505.6
4519913894,1,19,3,1,3,4,2,1,0,1,1,17035,7.2,18941,257,52,1487,617,25.7,1703.5,18,3,0,4,3,6,1,1,0,0,15548,7.0,18324,223,64,-1487,-617,22.3,1554.8
4458383359,1,15,3,0,8,8,8,1,1,0,0,17706,6.8,18217,217,60,-492,-173,21.7,1770.6,16,0,1,8,8,11,0,0,0,0,18198,7.2,18390,230,52,492,173,23.0,1819.8
4409455091,1,41,2,1,6,3,10,1,0,1,0,16363,6.8,17356,209,44,2448,1861,20.9,1636.3,16,3,0,3,6,4,0,0,0,0,13915,6.4,15495,184,47,-2448,-1861,18.4,1391.5
4506996952,1,15,3,0,8,7,10,2,1,1,0,17217,7.2,18214,185,60,-414,-47,18.5,1721.7,14,2,1,7,8,3,0,0,0,1,17631,7.0,18261,198,68,414,47,19.8,1763.1
4421907838,1,30,2,1,7,3,7,1,0,1,0,17622,7.2,19582,230,64,3071,2643,23.0,1762.2,20,3,0,3,7,4,0,0,0,0,14551,6.6,16939,220,36,-3071,-2643,22.0,1455.1
4526079366,1,38,2,1,7,6,6,0,0,0,0,17232,7.2,18525,238,54,672,411,23.8,1723.2,16,2,0,6,7,13,1,1,0,0,16560,7.0,18114,210,52,-672,-411,21.0,1656.0
4452601584,0,13,27,0,9,7,7,0,0,0,0,18012,7.0,19569,239,41,1194,2051,23.9,1801.2,45,4,1,7,9,6,1,1,0,0,16818,6.6,17518,221,42,-1194,-2051,22.1,1681.8
4512258772,0,18,4,1,8,1,6,1,0,1,0,18607,7.4,20228,264,53,4488,3191,26.4,1860.7,15,1,0,1,8,1,1,1,0,0,14119,6.6,17037,210,60,-4488,-3191,21.0,1411.9
4519513452,0,17,4,1,4,8,3,1,1,0,0,14395,6.4,16209,175,45,-2618,-1567,17.5,1439.5,19,1,0,8,4,11,0,0,0,0,17013,7.0,17776,213,50,2618,1567,21.3,1701.3
4522814344,0,17,4,1,2,4,3,0,0,0,0,14615,7.0,18302,221,47,-1530,-1114,22.1,1461.5,16,4,0,4,2,5,1,1,0,0,16145,7.4,19416,243,71,1530,1114,24.3,1614.5
4519091334,0,37,1,1,4,7,4,1,1,0,0,14867,7.0,17173,216,35,-2153,-2348,21.6,1486.7,15,2,0,7,4,4,0,0,0,0,17020,7.2,19521,220,75,2153,2348,22.0,1702.0
4521886990,1,20,3,1,7,2,13,1,1,0,0,17075,6.8,17444,202,56,1531,-222,20.2,1707.5,14,6,0,2,7,2,0,0,0,0,15544,6.8,17666,252,48,-1531,222,25.2,1554.4
4518214462,1,34,3,1,8,6,5,1,0,1,0,17540,7.4,19850,232,56,1499,2433,23.2,1754.0,15,3,0,6,8,4,0,0,0,0,16041,7.0,17417,187,48,-1499,-2433,18.7,1604.1
4513299372,1,14,5,1,4,2,1,0,0,0,0,15727,7.4,18760,264,56,1441,473,26.4,1572.7,14,2,0,2,4,0,0,0,0,0,14286,7.0,18287,211,43,-1441,-473,21.1,1428.6
4507859079,1,18,2,1,4,4,4,0,0,0,0,15760,7.0,18295,215,48,-137,-351,21.5,1576.0,15,1,0,4,4,1,1,1,0,0,15897,7.0,18646,227,72,137,351,22.7,1589.7
4447554215,1,17,5,0,4,3,4,1,1,0,1,17490,7.0,18903,233,56,2755,1492,23.3,1749.0,39,2,1,3,4,3,1,0,1,0,14735,7.0,17411,197,52,-2755,-1492,19.7,1473.5
4467677156,1,19,3,0,5,4,6,0,0,0,0,15865,6.8,16893,208,43,-480,-1045,20.8,1586.5,17,5,1,4,5,3,1,1,0,0,16345,6.6,17938,226,57,480,1045,22.6,1634.5
4479275865,0,46,1,0,7,8,7,2,1,1,0,16473,7.0,18395,201,52,-932,150,20.1,1647.3,16,1,1,8,7,11,0,0,0,0,17405,7.0,18245,246,63,932,-150,24.6,1740.5
4524776788,1,53,2,1,7,6,5,1,1,0,0,16817,6.8,17889,208,63,1060,952,20.8,1681.7,16,1,0,6,7,5,1,0,1,0,15757,6.4,16937,185,40,-1060,-952,18.5,1575.7
4514750583,1,13,1,1,6,2,4,0,0,0,0,16853,6.8,18346,234,44,2097,1569,23.4,1685.3,106,2,0,2,6,1,0,0,0,0,14756,6.6,16777,228,50,-2097,-1569,22.8,1475.6
4486146372,0,13,1,0,3,13,4,0,0,0,0,14126,6.4,15246,200,44,-6319,-3391,20.0,1412.6,16,3,1,13,3,22,1,1,0,0,20445,7.2,18637,193,56,6319,3391,19.3,2044.5
4396684519,0,16,3,0,8,6,13,1,1,0,0,17003,6.8,17843,222,43,253,-1300,22.2,1700.3,18,3,1,6,8,7,0,0,0,0,16750,7.2,19143,218,75,-253,1300,21.8,1675.0
4448434808,1,13,1,0,10,3,11,1,1,0,0,17793,7.6,19766,208,55,1988,1552,20.8,1779.3,15,2,1,3,10,2,0,0,0,0,15805,7.0,18214,217,53,-1988,-1552,21.7,1580.5
4524774054,1,17,4,0,9,5,13,0,0,0,0,17626,7.2,18770,219,44,2511,3602,21.9,1762.6,41,1,1,5,9,13,2,1,1,0,15115,6.0,15168,162,47,-2511,-3602,16.2,1511.5
4488299127,0,14,1,0,2,12,3,0,0,0,0,14579,6.4,15758,196,52,-4225,-2478,19.6,1457.9,10,4,1,12,2,16,0,0,0,0,18804,7.2,18236,230,32,4225,2478,23.0,1880.4
4523336586,1,17,2,1,13,5,9,2,1,1,0,18170,7.0,19022,191,49,3058,3283,19.1,1817.0,13,4,0,5,13,6,0,0,0,0,15112,6.4,15739,189,46,-3058,-3283,18.9,1511.2
4519993636,0,16,3,0,7,5,10,0,0,0,0,16772,6.4,16548,228,42,192,-1496,22.8,1677.2,18,2,1,5,7,5,2,1,1,0,16580,6.8,18044,234,56,-192,1496,23.4,1658.0
4439348607,0,19,5,0,7,11,11,1,1,0,0,16187,6.4,16701,216,30,-2377,-2355,21.6,1618.7,20,0,1,11,7,14,0,0,0,0,18564,7.0,19056,206,67,2377,2355,20.6,1856.4
4433327463,0,15,18,0,5,8,4,0,0,0,0,15243,6.4,16159,193,35,-2449,-3095,19.3,1524.3,39,3,1,8,5,8,1,1,0,0,17692,7.2,19254,257,49,2449,3095,25.7,1769.2
4525559533,0,30,4,0,7,4,7,0,0,0,0,16559,7.0,18604,205,45,715,545,20.5,1655.9,16,2,1,4,7,4,1,1,0,0,15844,6.8,18059,235,54,-715,-545,23.5,1584.4
4455347152,1,25,7,0,7,6,11,0,0,0,0,16414,6.8,17333,205,48,-33,-677,20.5,1641.4,16,10,1,6,7,6,0,0,0,0,16447,7.0,18010,223,56,33,677,22.3,1644.7
4522784053,0,19,3,1,7,5,5,1,1,0,0,17466,6.8,17536,239,61,2887,2085,23.9,1746.6,37,3,0,5,7,7,0,0,0,0,14579,6.2,15451,174,46,-2887,-2085,17.4,1457.9
4524675236,1,13,3,0,5,5,1,0,0,0,0,15514,7.0,18750,217,58,-343,481,21.7,1551.4,13,1,1,5,5,5,1,1,0,0,15857,6.8,18269,204,46,343,-481,20.4,1585.7
4520321309,0,13,1,1,6,4,5,0,0,0,0,16304,6.8,17328,212,36,205,-1306,21.2,1630.4,14,4,0,4,6,5,2,1,1,0,16099,7.0,18634,203,75,-205,1306,20.3,1609.9
4495556599,1,38,4,0,7,3,6,0,0,0,0,16738,7.4,19318,219,61,1031,1909,21.9,1673.8,15,3,1,3,7,1,1,1,0,0,15707,7.0,17409,218,61,-1031,-1909,21.8,1570.7
4524654966,0,43,8,1,6,13,6,0,0,0,0,15336,6.8,16216,196,44,-3534,-1814,19.6,1533.6,17,5,0,13,6,13,1,1,0,0,18870,7.0,18030,208,40,3534,1814,20.8,1887.0
4423246769,0,12,2,1,7,8,5,1,1,0,0,15810,6.6,16837,193,48,-1305,-2023,19.3,1581.0,12,0,0,8,7,5,0,0,0,1,17115,7.2,18860,189,62,1305,2023,18.9,1711.5
4521336289,0,149,2,1,2,5,4,0,0,0,0,14147,6.6,16605,226,52,-1400,-1716,22.6,1414.7,38,2,0,5,2,9,1,1,0,0,15547,7.0,18321,197,60,1400,1716,19.7,1554.7
4517796937,1,13,7,1,10,9,12,1,1,0,0,17828,7.0,18635,184,59,371,514,18.4,1782.8,16,2,0,9,10,9,1,0,1,0,17457,7.0,18121,219,35,-371,-514,21.9,1745.7
4484513545,1,18,6,1,6,2,8,2,1,1,0,17501,7.2,19153,248,52,2122,1958,24.8,1750.1,18,3,0,2,6,2,0,0,0,0,15379,6.6,17195,229,52,-2122,-1958,22.9,1537.9
4467777075,1,15,4,1,8,4,8,1,1,0,0,17798,7.2,18795,220,56,3120,2464,22.0,1779.8,14,3,0,4,8,5,0,0,0,0,14678,6.6,16331,192,48,-3120,-2464,19.2,1467.8
4465757156,1,18,2,1,6,2,7,0,0,0,0,16695,6.8,17863,236,51,1755,717,23.6,1669.5,35,5,0,2,6,1,1,1,0,0,14940,6.8,17146,234,52,-1755,-717,23.4,1494.0
4483881099,1,17,4,1,7,4,14,1,0,1,0,17610,6.8,17839,236,47,3259,2282,23.6,1761.0,19,4,0,4,7,6,1,1,0,0,14351,6.4,15557,199,38,-3259,-2282,19.9,1435.1
4521984246,1,14,3,1,5,6,5,1,1,0,0,16331,7.0,17720,231,44,-377,-1234,23.1,1633.1,21,5,0,6,5,7,0,0,0,0,16708,7.2,18954,229,56,377,1234,22.9,1670.8
4526363486,1,20,3,0,4,8,5,1,1,0,0,15579,6.8,18054,203,67,-2227,-1077,20.3,1557.9,15,4,1,8,4,6,1,0,1,0,17806,7.2,19131,254,53,2227,1077,25.4,1780.6
4517750444,1,18,3,1,7,5,8,1,1,0,0,17561,6.6,17813,215,64,545,411,21.5,1756.1,16,1,0,5,7,1,1,0,1,1,17016,6.6,17402,218,44,-545,-411,21.8,1701.6
4457517479,0,15,3,0,4,8,6,0,0,0,0,15431,6.8,17309,218,47,-2661,-3190,21.8,1543.1,106,5,1,8,4,9,2,1,1,0,18092,7.2,20499,260,63,2661,3190,26.0,1809.2
4495892893,0,16,5,0,5,9,5,1,1,0,1,17087,6.8,17225,206,44,-988,-1321,20.6,1708.7,59,3,1,9,5,8,1,0,1,1,18075,7.2,18546,201,39,988,1321,20.1,1807.5
4519862589,1,16,2,1,10,6,12,1,0,1,0,18692,7.4,19767,248,48,2830,1589,24.8,1869.2,12,2,0,6,10,4,0,0,0,0,15862,6.8,18178,210,39,-2830,-1589,21.0,1586.2
4520613300,1,23,6,0,3,4,5,0,0,0,0,15390,7.0,18666,245,51,-387,879,24.5,1539.0,17,5,1,4,3,8,0,0,0,0,15777,7.0,17787,239,55,387,-879,23.9,1577.7
4509881889,0,20,4,0,3,5,4,1,1,0,0,15557,7.0,18380,251,56,-101,-380,25.1,1555.7,14,1,1,5,3,2,0,0,0,0,15658,7.2,18760,210,64,101,380,21.0,1565.8
4515577349,1,19,6,0,4,3,7,1,1,0,0,14970,6.8,17530,212,52,-595,364,21.2,1497.0,19,2,1,3,4,1,0,0,0,0,15565,6.8,17166,238,51,595,-364,23.8,1556.5
4395598976,0,12,3,1,4,9,5,0,0,0,0,14420,6.4,15196,192,32,-2519,-1095,19.2,1442.0,18,3,0,9,4,15,0,0,0,0,16939,6.4,16291,194,46,2519,1095,19.4,1693.9
4509091721,1,42,4,1,9,10,15,0,0,0,0,18483,7.0,18474,222,44,270,-688,22.2,1848.3,19,4,0,10,9,13,1,1,0,0,18213,7.2,19162,207,68,-270,688,20.7,1821.3
4465525606,0,18,2,1,4,12,5,0,0,0,0,14246,6.4,16141,189,52,-5112,-2602,18.9,1424.6,17,4,0,12,4,19,1,1,0,0,19358,7.0,18743,200,46,5112,2602,20.0,1935.8
4489934544,0,15,4,0,6,8,4,1,0,1,0,16860,7.2,19037,239,51,-259,357,23.9,1686.0,16,1,1,8,6,6,0,0,0,0,17119,7.2,18680,238,49,259,-357,23.8,1711.9
4524614022,1,18,3,0,2,2,4,0,0,0,0,14795,6.4,16396,208,47,204,-1452,20.8,1479.5,17,2,1,2,2,1,1,1,0,0,14591,6.8,17848,223,60,-204,1452,22.3,1459.1
4499941811,1,11,1,1,8,11,6,1,1,0,0,16836,6.6,16495,215,41,-1521,-2096,21.5,1683.6,18,3,0,11,8,12,0,0,0,0,18357,7.0,18591,215,51,1521,2096,21.5,1835.7
4519489484,0,8,2,1,4,5,4,1,1,0,0,15875,7.0,17873,235,51,-396,-1091,23.5,1587.5,29,3,0,5,4,6,0,0,0,0,16271,7.2,18964,210,58,396,1091,21.0,1627.1
4502491381,0,12,4,1,6,9,5,0,0,0,0,15967,6.6,17065,217,47,-2162,-2253,21.7,1596.7,41,5,0,9,6,9,0,0,0,0,18129,7.2,19318,224,53,2162,2253,22.4,1812.9
4500229448,1,48,3,0,5,7,3,1,1,0,0,16103,6.8,17939,216,52,-511,303,21.6,1610.3,17,3,1,7,5,9,0,0,0,0,16614,7.0,17636,237,36,511,-303,23.7,1661.4
4524954038,0,21,4,0,6,12,3,1,1,0,0,15861,6.6,17082,208,47,-3197,-1400,20.8,1586.1,15,4,1,12,6,20,0,0,0,0,19058,7.4,18482,208,48,3197,1400,20.8,1905.8
4456677220,0,15,1,0,2,10,2,0,0,0,0,14194,6.2,14858,195,48,-5553,-4226,19.5,1419.4,13,0,1,10,2,12,1,0,1,1,19747,7.2,19084,233,49,5553,4226,23.3,1974.7
4525800444,1,69,3,1,9,3,11,0,0,0,0,16678,7.0,17929,201,42,1351,433,20.1,1667.8,13,2,0,3,9,6,1,1,0,0,15327,6.8,17496,228,62,-1351,-433,22.8,1532.7
4524317634,0,17,3,1,1,4,1,0,0,0,0,14064,6.6,16539,220,37,-1765,-2344,22.0,1406.4,17,4,0,4,1,2,1,1,0,0,15829,6.8,18883,244,62,1765,2344,24.4,1582.9
4525819102,0,20,2,0,3,6,3,0,0,0,0,15373,7.2,18554,225,61,-991,-136,22.5,1537.3,16,2,1,6,3,8,1,1,0,0,16364,7.2,18690,220,51,991,136,22.0,1636.4
4506509560,1,22,3,1,17,1,23,1,1,0,0,20151,7.4,19504,226,38,6783,4718,22.6,2015.1,23,1,0,1,17,2,0,0,0,0,13368,6.2,14786,177,53,-6783,-4718,17.7,1336.8
4524454688,1,17,7,1,7,4,9,0,0,0,0,16992,7.0,18716,224,36,1582,1344,22.4,1699.2,20,4,0,4,7,6,1,1,0,0,15410,7.0,17372,209,47,-1582,-1344,20.9,1541.0
4497823613,0,16,5,1,2,1,5,1,0,1,0,15063,6.6,17160,227,56,790,-1155,22.7,1506.3,19,2,0,1,2,0,1,1,0,0,14273,7.0,18315,217,68,-790,1155,21.7,1427.3
4519607934,1,44,3,1,7,5,4,1,1,0,0,16749,7.0,18142,192,60,976,2257,19.2,1674.9,13,2,0,5,7,8,0,0,0,0,15773,6.6,15885,209,35,-976,-2257,20.9,1577.3
4510089098,1,17,0,1,8,1,10,0,0,0,0,18888,7.2,18408,232,42,4662,2019,23.2,1888.8,12,1,0,1,8,1,0,0,0,0,14226,6.6,16389,207,64,-4662,-2019,20.7,1422.6
4527566867,0,22,1,0,2,6,0,0,0,0,0,14485,6.8,17588,233,64,-1422,-861,23.3,1448.5,68,0,1,6,2,7,1,1,0,0,15907,7.0,18449,235,56,1422,861,23.5,1590.7
4513907463,0,16,1,1,6,3,5,1,0,1,0,15960,6.8,17046,180,44,664,185,18.0,1596.0,12,4,0,3,6,1,1,1,0,0,15296,6.6,16861,205,64,-664,-185,20.5,1529.6
4521083858,1,17,4,1,5,6,11,1,1,0,0,17076,7.4,19064,223,60,629,1496,22.3,1707.6,18,2,0,6,5,11,0,0,0,0,16447,6.8,17568,215,33,-629,-1496,21.5,1644.7
4500144079,1,24,3,1,4,7,4,1,1,0,0,15712,6.8,17100,213,51,-418,15,21.3,1571.2,19,5,0,7,4,11,0,0,0,0,16130,6.8,17085,166,53,418,-15,16.6,1613.0
4500166392,0,14,1,1,3,6,1,1,1,0,0,15298,6.8,17728,233,64,-1317,-872,23.3,1529.8,17,3,0,6,3,11,0,0,0,0,16615,7.0,18600,204,60,1317,872,20.4,1661.5
4459480413,0,15,1,0,4,6,5,0,0,0,0,15506,6.8,17710,231,50,-672,-1420,23.1,1550.6,12,1,1,6,4,4,1,1,0,0,16178,7.2,19130,214,49,672,1420,21.4,1617.8
4479460532,1,21,3,0,3,4,3,1,1,0,0,14850,6.8,17967,226,57,-858,847,22.6,1485.0,21,3,1,4,3,5,0,0,0,0,15708,6.8,17120,239,44,858,-847,23.9,1570.8
4471981120,1,14,2,1,12,6,11,0,0,0,0,18002,7.0,19391,199,36,2621,2483,19.9,1800.2,12,0,0,6,12,5,0,0,0,0,15381,6.8,16908,195,44,-2621,-2483,19.5,1538.1
4457117855,1,21,4,1,11,9,13,1,1,0,0,19236,7.4,20585,231,48,2249,2480,23.1,1923.6,16,2,0,9,11,8,0,0,0,0,16987,7.0,18105,219,40,-2249,-2480,21.9,1698.7
4466772650,0,25,3,0,3,8,1,0,0,0,0,14868,6.6,16222,237,41,-3346,-3153,23.7,1486.8,18,5,1,8,3,9,2,1,1,0,18214,7.2,19375,229,52,3346,3153,22.9,1821.4
4524387614,1,36,4,1,6,2,4,1,1,0,0,16432,7.4,18849,208,59,2390,1778,20.8,1643.2,15,5,0,2,6,1,0,0,0,0,14042,6.6,17071,219,48,-2390,-1778,21.9,1404.2
4478269360,0,12,2,1,1,6,1,0,0,0,0,14598,6.6,17033,217,69,-2286,-2574,21.7,1459.8,13,3,0,6,1,9,1,1,0,0,16884,7.2,19607,227,68,2286,2574,22.7,1688.4
4519169394,0,15,4,1,7,11,9,0,0,0,0,17984,7.2,18708,230,56,537,-477,23.0,1798.4,16,4,0,11,7,11,1,1,0,0,17447,7.2,19185,178,51,-537,477,17.8,1744.7
4524775982,1,36,3,1,7,5,7,0,0,0,0,16590,7.0,19121,210,60,1057,1295,21.0,1659.0,16,1,0,5,7,5,1,1,0,0,15533,7.0,17826,227,48,-1057,-1295,22.7,1553.3
4524248019,1,15,1,1,7,3,6,1,1,0,0,16272,7.0,18613,232,48,1471,806,23.2,1627.2,12,1,0,3,7,3,0,0,0,0,14801,6.8,17807,239,45,-1471,-806,23.9,1480.1
4527427825,1,10,9,0,9,9,6,2,1,1,0,17913,6.8,18248,217,37,785,1373,21.7,1791.3,40,3,1,9,9,15,0,0,0,0,17128,6.8,16875,191,40,-785,-1373,19.1,1712.8
4512073832,1,15,3,1,7,6,12,0,0,0,0,16963,7.0,17857,212,45,707,730,21.2,1696.3,13,2,0,6,7,7,0,0,0,0,16256,6.6,17127,200,50,-707,-730,20.0,1625.6
4491198019,1,17,4,1,2,4,0,0,0,0,0,15321,7.0,18162,255,55,305,992,25.5,1532.1,56,2,0,4,2,5,1,1,0,0,15016,6.8,17170,222,40,-305,-992,22.2,1501.6
4509839658,0,18,1,1,15,4,22,2,1,1,0,19660,7.0,17870,186,71,5255,2255,18.6,1966.0,16,0,0,4,15,4,0,0,0,0,14405,6.2,15615,183,36,-5255,-2255,18.3,1440.5
4524992548,1,18,1,0,7,8,8,1,1,0,0,17570,7.0,18283,238,58,527,1493,23.8,1757.0,16,2,1,8,7,11,0,0,0,0,17043,6.8,16790,176,48,-527,-1493,17.6,1704.3
4522601475,1,8,0,1,6,5,6,1,0,1,0,15760,7.2,18719,167,72,-2072,412,16.7,1576.0,16,2,0,5,6,2,1,1,0,1,17832,7.0,18307,268,51,2072,-412,26.8,1783.2
4518755831,0,14,3,1,7,10,8,0,0,0,0,16259,6.8,16527,184,46,-2295,-2516,18.4,1625.9,13,2,0,10,7,13,0,0,0,0,18554,7.2,19043,228,47,2295,2516,22.8,1855.4
4518193450,0,16,3,0,6,10,8,0,0,0,0,16837,7.2,17911,191,59,-2152,-2041,19.1,1683.7,16,4,1,10,6,8,2,1,1,0,18989,7.4,19952,237,56,2152,2041,23.7,1898.9
4496598849,0,19,3,0,3,8,3,0,0,0,0,16060,7.2,17844,213,57,-1603,-1134,21.3,1606.0,41,3,1,8,3,11,1,1,0,0,17663,7.2,18978,227,53,1603,1134,22.7,1766.3
4487218004,1,37,4,1,10,7,11,0,0,0,0,18423,7.2,18773,212,40,2514,1424,21.2,1842.3,16,4,0,7,10,6,1,0,1,0,15909,6.8,17349,200,40,-2514,-1424,20.0,1590.9
4517035921,1,17,2,0,6,4,8,1,1,0,0,16623,7.0,18012,243,48,598,-456,24.3,1662.3,16,3,1,4,6,1,1,0,1,0,16025,7.0,18468,224,56,-598,456,22.4,1602.5
4502709604,1,11,2,0,6,7,8,1,0,1,0,17192,7.0,18065,221,56,662,44,22.1,1719.2,14,2,1,7,6,6,1,1,0,0,16530,6.8,18021,196,51,-662,-44,19.6,1653.0
4415176080,0,12,2,1,8,6,6,0,0,0,0,17040,7.2,18469,230,56,1740,929,23.0,1704.0,14,2,0,6,8,5,1,1,0,0,15300,6.8,17540,198,48,-1740,-929,19.8,1530.0
4516517025,1,36,2,1,7,5,4,0,0,0,0,17301,7.8,20766,241,67,1207,2244,24.1,1730.1,11,1,0,5,7,4,0,0,0,0,16094,7.0,18522,243,52,-1207,-2244,24.3,1609.4
4467510471,0,13,2,0,5,10,7,0,0,0,0,16161,6.8,16954,213,53,-3761,-2475,21.3,1616.1,16,3,1,10,5,13,2,1,1,1,19922,7.2,19429,241,52,3761,2475,24.1,1992.2
4464483348,0,17,3,0,1,5,0,1,1,0,0,14916,6.8,17511,239,59,-1325,-15,23.9,1491.6,18,4,1,5,1,8,0,0,0,0,16241,6.8,17526,251,33,1325,15,25.1,1624.1
4523449093,0,26,1,0,6,6,5,2,1,1,0,15539,6.8,17101,191,56,8,572,19.1,1553.9,17,2,1,6,6,8,0,0,0,0,15531,6.4,16529,208,48,-8,-572,20.8,1553.1
4519316312,1,12,2,1,8,7,10,0,0,0,0,17946,7.2,18778,204,48,2401,727,20.4,1794.6,15,0,0,7,8,5,0,0,0,0,15545,6.8,18051,187,51,-2401,-727,18.7,1554.5
4454963096,0,31,3,1,7,6,8,1,1,0,0,16972,7.0,18412,221,51,1807,733,22.1,1697.2,14,1,0,6,7,3,1,0,1,0,15165,7.0,17679,211,40,-1807,-733,21.1,1516.5
4493154896,1,37,6,1,10,4,10,0,0,0,0,18456,7.2,19319,218,48,3765,2661,21.8,1845.6,15,2,0,4,10,3,0,0,0,0,14691,6.8,16658,193,47,-3765,-2661,19.3,1469.1
4455594728,1,26,5,0,3,5,2,0,0,0,0,15221,6.8,17841,218,60,-531,28,21.8,1522.1,17,3,1,5,3,6,1,1,0,0,15752,7.0,17813,240,44,531,-28,24.0,1575.2
4521067380,0,20,3,0,4,10,2,1,1,0,0,14843,6.4,16207,176,45,-2691,-1778,17.6,1484.3,14,3,1,10,4,12,1,0,1,0,17534,7.2,17985,199,52,2691,1778,19.9,1753.4
4517786912,0,14,3,1,5,7,6,2,1,1,0,15157,6.8,17194,218,38,-1301,-502,21.8,1515.7,14,2,0,7,5,8,0,0,0,0,16458,7.0,17696,209,52,1301,502,20.9,1645.8
4521058802,1,17,4,1,7,2,8,0,0,0,0,16830,7.2,18443,232,54,2431,1886,23.2,1683.0,31,1,0,2,7,2,0,0,0,0,14399,6.6,16557,209,48,-2431,-1886,20.9,1439.9
4468929593,0,14,2,1,3,7,4,1,1,0,0,15315,6.8,17144,210,50,-2478,-2136,21.0,1531.5,15,2,0,7,3,7,0,0,0,0,17793,7.2,19280,231,60,2478,2136,23.1,1779.3
4475094281,1,19,5,1,7,10,7,0,0,0,0,16643,6.8,17554,227,44,-1820,-1412,22.7,1664.3,17,7,0,10,7,11,0,0,0,0,18463,7.2,18966,231,45,1820,1412,23.1,1846.3
4525063460,1,14,1,1,9,8,17,0,0,0,0,18119,6.4,16050,204,38,740,-692,20.4,1811.9,18,2,0,8,9,18,1,1,0,0,17379,6.8,16742,210,36,-740,692,21.0,1737.9
4516402388,1,15,4,1,4,3,2,1,0,1,0,15833,7.2,18396,250,52,904,1043,25.0,1583.3,21,4,0,3,4,3,1,1,0,0,14929,6.8,17353,213,64,-904,-1043,21.3,1492.9
4518392539,0,12,3,1,10,4,14,0,0,0,0,18019,6.8,17440,210,48,4581,2792,21.0,1801.9,15,1,0,4,10,3,0,0,0,0,13438,6.0,14648,153,28,-4581,-2792,15.3,1343.8
4523542787,0,17,1,0,3,5,4,0,0,0,0,14776,6.8,17631,203,64,-1960,-1464,20.3,1477.6,13,2,1,5,3,5,1,1,0,0,16736,7.2,19095,252,56,1960,1464,25.2,1673.6
4444894425,0,18,6,0,3,5,4,0,0,0,0,15144,7.4,18640,214,56,-439,775,21.4,1514.4,17,2,1,5,3,6,2,1,1,0,15583,6.6,17865,241,32,439,-775,24.1,1558.3
4516946022,0,26,0,0,14,8,12,1,1,0,0,19094,7.2,19076,196,56,1693,1287,19.6,1909.4,16,3,1,8,14,6,0,0,0,0,17401,6.8,17789,214,43,-1693,-1287,21.4,1740.1
4526227837,1,15,2,0,11,7,9,0,0,0,0,19425,7.4,20998,218,67,3143,2852,21.8,1942.5,16,2,1,7,11,5,1,1,0,0,16282,7.0,18146,216,56,-3143,-2852,21.6,1628.2
4521281559,1,16,5,0,9,7,6,1,0,1,0,17807,6.8,17661,217,42,1383,1273,21.7,1780.7,17,3,1,7,9,6,1,1,0,0,16424,6.6,16388,192,60,-1383,-1273,19.2,1642.4
4526992864,0,16,1,1,6,4,11,0,0,0,0,16324,6.8,17601,197,47,541,875,19.7,1632.4,11,6,0,4,6,3,0,0,0,0,15783,6.8,16726,240,44,-541,-875,24.0,1578.3
4503839400,0,18,1,0,5,9,4,0,0,0,0,15167,6.6,16733,195,56,-2132,-1088,19.5,1516.7,17,3,1,9,5,7,0,0,0,0,17299,7.0,17821,215,42,2132,1088,21.5,1729.9
4518908419,1,38,1,1,5,6,7,1,1,0,0,15761,6.6,17003,187,56,-839,-800,18.7,1576.1,17,4,0,6,5,9,1,0,1,0,16600,7.2,17803,206,49,839,800,20.6,1660.0
4493819835,1,13,4,1,8,2,8,0,0,0,0,18288,7.2,18800,223,56,4377,1719,22.3,1828.8,14,3,0,2,8,0,0,0,0,0,13911,6.8,17081,220,48,-4377,-1719,22.0,1391.1
4506218156,0,17,1,1,11,7,6,0,0,0,0,17500,7.2,18895,193,54,658,747,19.3,1750.0,13,1,0,7,11,10,0,0,0,0,16842,6.8,18148,193,64,-658,-747,19.3,1684.2
4505568037,0,18,15,1,6,6,6,2,1,1,0,15771,6.8,17334,187,59,-2842,-1722,18.7,1577.1,37,4,0,6,6,9,0,0,0,1,18613,7.0,19056,264,52,2842,1722,26.4,1861.3
4517889362,0,43,2,0,6,5,10,1,1,0,0,15521,6.2,15093,146,42,189,-2888,14.6,1552.1,42,3,1,5,6,1,1,0,1,0,15332,6.8,17981,193,54,-189,2888,19.3,1533.2
4464665757,1,13,3,1,9,6,10,2,1,1,1,18924,7.0,18340,216,64,2660,-730,21.6,1892.4,20,4,0,6,9,3,0,0,0,0,16264,7.0,19070,221,83,-2660,730,22.1,1626.4
4525569864,0,39,3,0,5,3,5,1,0,1,0,15824,7.2,19141,221,52,225,1404,22.1,1582.4,128,3,1,3,5,6,1,1,0,0,15599,6.8,17737,248,60,-225,-1404,24.8,1559.9
4514329925,1,17,2,0,9,6,6,1,1,0,0,17261,7.0,18577,219,56,1704,2023,21.9,1726.1,15,1,1,6,9,8,0,0,0,0,15557,6.6,16554,182,42,-1704,-2023,18.2,1555.7
4511992629,1,15,5,1,3,3,6,1,0,1,0,15204,6.8,17963,209,68,153,917,20.9,1520.4,13,4,0,3,3,3,1,1,0,0,15051,6.8,17046,232,51,-153,-917,23.2,1505.1
4475524558,0,13,4,0,5,12,3,0,0,0,0,16143,6.6,17759,212,47,-3283,-582,21.2,1614.3,16,2,1,12,5,8,0,0,0,0,19426,6.8,18341,194,56,3283,582,19.4,1942.6
4523507519,1,14,4,1,9,4,14,0,0,0,0,17495,7.0,18537,208,40,2546,1928,20.8,1749.5,15,2,0,4,9,2,0,0,0,0,14949,6.6,16609,211,50,-2546,-1928,21.1,1494.9
4439121035,1,34,3,1,5,3,6,2,1,1,1,16703,6.8,17483,201,51,1051,612,20.1,1670.3,46,3,0,3,5,9,0,0,0,0,15652,6.8,16871,228,52,-1051,-612,22.8,1565.2
4496972532,0,16,2,1,5,8,6,0,0,0,0,15985,7.0,18011,214,52,-12,-1161,21.4,1598.5,12,2,0,8,5,4,0,0,0,0,15997,7.2,19172,194,45,12,1161,19.4,1599.7
4523465477,0,10,3,0,2,5,2,0,0,0,0,14695,6.8,16864,230,42,-1947,-2097,23.0,1469.5,18,3,1,5,2,6,1,1,0,0,16642,7.2,18961,255,54,1947,2097,25.5,1664.2
4513902880,1,11,1,1,5,2,4,0,0,0,0,14945,6.8,17524,168,48,-145,850,16.8,1494.5,16,3,0,2,5,2,1,1,0,0,15090,6.6,16674,233,48,145,-850,23.3,1509.0
4511166126,1,35,2,0,4,7,6,0,0,0,0,15074,6.8,17596,214,52,-2054,-731,21.4,1507.4,16,0,1,7,4,10,2,1,1,0,17128,7.0,18327,211,50,2054,731,21.1,1712.8
4485213247,0,17,8,0,7,8,8,0,0,0,0,16670,7.0,17287,220,42,-508,-1385,22.0,1667.0,20,3,1,8,7,6,0,0,0,0,17178,7.0,18672,217,54,508,1385,21.7,1717.8
4458889473,0,59,7,1,7,7,12,1,0,1,0,17543,7.0,17748,195,51,994,-547,19.5,1754.3,37,6,0,7,7,11,1,1,0,0,16549,7.0,18295,215,36,-994,547,21.5,1654.9
4457455707,0,15,1,0,4,8,5,0,0,0,0,14732,6.6,16524,208,35,-2642,-2116,20.8,1473.2,33,1,1,8,4,8,0,0,0,0,17374,7.0,18640,227,44,2642,2116,22.7,1737.4
4505844973,0,12,4,0,6,10,5,0,0,0,0,15476,6.8,16691,198,50,-2199,-2258,19.8,1547.6,38,2,1,10,6,10,1,1,0,0,17675,7.2,18949,218,48,2199,2258,21.8,1767.5
4446053181,1,15,2,0,5,6,8,0,0,0,0,15964,6.8,17988,206,65,-243,860,20.6,1596.4,17,2,1,6,5,8,2,1,1,0,16207,6.6,17128,205,43,243,-860,20.5,1620.7
4474002258,0,16,3,1,6,9,8,1,1,0,0,16052,7.0,17653,221,45,-1558,-500,22.1,1605.2,16,3,0,9,6,9,0,0,0,0,17610,7.0,18153,212,40,1558,500,21.2,1761.0
4498216490,1,40,7,0,8,9,9,1,0,1,0,16968,7.0,18900,214,45,306,1895,21.4,1696.8,25,4,1,9,8,10,0,0,0,0,16662,6.6,17005,208,33,-306,-1895,20.8,1666.2
4465399083,0,15,2,0,1,7,1,0,0,0,0,13745,6.6,16710,198,55,-3426,-997,19.8,1374.5,72,4,1,7,1,9,1,1,0,0,17171,7.0,17707,212,60,3426,997,21.2,1717.1
4437747585,1,13,3,0,8,5,9,1,1,0,0,17367,7.0,19496,215,67,1992,2096,21.5,1736.7,12,3,1,5,8,4,0,0,0,0,15375,6.6,17400,211,44,-1992,-2096,21.1,1537.5
4476398273,1,18,4,1,8,5,8,0,0,0,1,18775,7.0,18390,230,40,2666,400,23.0,1877.5,17,3,0,5,8,4,1,0,1,0,16109,6.8,17990,215,49,-2666,-400,21.5,1610.9
4516335736,1,20,3,1,12,8,11,0,0,0,0,18713,7.2,19848,226,48,1355,1403,22.6,1871.3,16,2,0,8,12,7,1,1,0,0,17358,7.2,18445,196,64,-1355,-1403,19.6,1735.8
4518410386,1,38,1,0,2,8,1,0,0,0,0,14141,6.6,16555,211,37,-2749,-800,21.1,1414.1,24,0,1,8,2,14,0,0,0,0,16890,6.8,17355,206,44,2749,800,20.6,1689.0
4511071650,0,15,0,0,4,12,5,0,0,0,0,14799,6.6,15917,218,35,-4740,-3081,21.8,1479.9,16,2,1,12,4,8,2,1,1,0,19539,7.0,18998,231,69,4740,3081,23.1,1953.9
4469659542,0,14,1,0,7,9,8,0,0,0,1,18072,7.2,18740,221,40,222,1327,22.1,1807.2,12,3,1,9,7,10,1,1,0,0,17850,6.8,17413,202,51,-222,-1327,20.2,1785.0
4455312963,1,13,2,1,11,7,11,0,0,0,0,17662,7.2,18294,195,24,1673,536,19.5,1766.2,47,0,0,7,11,5,1,0,1,0,15989,7.0,17758,173,63,-1673,-536,17.3,1598.9
4517032052,1,116,2,0,10,8,13,0,0,0,0,16991,6.6,16213,180,36,803,490,18.0,1699.1,13,3,1,8,10,13,0,0,0,0,16188,6.4,15723,177,40,-803,-490,17.7,1618.8
4527531982,0,15,3,0,10,13,7,0,0,0,0,17938,7.0,18477,150,29,-1415,-1826,15.0,1793.8,72,5,1,13,10,7,0,0,0,0,19353,7.6,20303,196,60,1415,1826,19.6,1935.3
4521783603,0,17,3,0,1,4,1,0,0,0,0,13858,6.4,16054,232,45,-2552,-2268,23.2,1385.8,14,1,1,4,1,6,2,1,1,0,16410,7.0,18322,239,63,2552,2268,23.9,1641.0
4450399741,0,21,5,1,8,6,10,0,0,0,0,17136,7.0,18233,202,54,1363,-147,20.2,1713.6,18,5,0,6,8,2,1,0,1,0,15773,7.0,18380,218,56,-1363,147,21.8,1577.3
4517684494,1,19,5,0,9,4,7,1,1,0,0,17482,7.2,19093,214,48,2089,2123,21.4,1748.2,16,1,1,4,9,4,0,0,0,0,15393,6.8,16970,222,43,-2089,-2123,22.2,1539.3
4525815564,0,12,5,0,7,9,8,1,1,0,0,16695,7.2,19057,189,66,-771,483,18.9,1669.5,17,2,1,9,7,6,0,0,0,0,17466,7.0,18574,244,40,771,-483,24.4,1746.6
4511710215,1,16,5,0,5,10,6,0,0,0,0,16413,6.8,18104,225,50,-3036,-2088,22.5,1641.3,16,3,1,10,5,8,1,1,0,0,19449,7.4,20192,251,69,3036,2088,25.1,1944.9
4523400104,0,13,1,1,5,7,6,0,0,0,0,15738,6.8,16794,191,56,-1712,-2334,19.1,1573.8,16,3,0,7,5,9,1,1,0,0,17450,7.2,19128,222,66,1712,2334,22.2,1745.0
4519166800,1,17,4,0,7,4,6,1,1,0,0,17329,7.4,19569,239,54,1257,1123,23.9,1732.9,14,2,1,4,7,3,0,0,0,0,16072,7.2,18446,242,57,-1257,-1123,24.2,1607.2
4498606360,0,19,4,0,4,3,7,1,1,0,0,14891,6.6,17103,210,44,-996,-1894,21.0,1489.1,16,2,1,3,4,3,0,0,0,0,15887,7.0,18997,261,60,996,1894,26.1,1588.7
4521907618,0,13,3,0,6,8,8,1,0,1,1,18234,6.6,17526,205,59,1619,-575,20.5,1823.4,17,3,1,8,6,5,0,0,0,0,16615,7.0,18101,209,46,-1619,575,20.9,1661.5
4497277699,0,21,1,1,1,4,2,0,0,0,0,14270,6.6,16394,230,43,-1103,-2692,23.0,1427.0,14,3,0,4,1,3,1,1,0,0,15373,7.0,19086,244,52,1103,2692,24.4,1537.3
4523482714,0,31,0,0,5,12,2,0,0,0,0,14930,6.0,15593,169,56,-5298,-4670,16.9,1493.0,11,1,1,12,5,14,1,1,0,0,20228,7.4,20263,242,52,5298,4670,24.2,2022.8
4515539649,1,45,2,1,8,3,15,1,1,0,0,16902,7.2,18641,189,52,1787,1001,18.9,1690.2,15,4,0,3,8,4,1,0,1,0,15115,6.8,17640,222,48,-1787,-1001,22.2,1511.5
4526544291,0,18,2,0,7,8,10,0,0,0,0,16137,6.4,17136,203,48,-1563,-1007,20.3,1613.7,16,3,1,8,7,8,1,1,0,0,17700,7.0,18143,219,48,1563,1007,21.9,1770.0
4524879567,1,16,2,1,4,4,4,1,1,0,0,16238,7.0,18332,234,64,-348,-11,23.4,1623.8,15,3,0,4,4,3,1,0,1,0,16586,7.0,18343,236,72,348,11,23.6,1658.6
4477725637,0,15,6,0,6,7,12,0,0,0,0,15656,6.4,16252,195,44,-1275,-551,19.5,1565.6,21,3,1,7,6,8,1,1,0,0,16931,6.6,16803,202,44,1275,551,20.2,1693.1
4458124147,1,12,3,0,12,6,16,0,0,0,0,18669,7.2,19226,213,39,1788,761,21.3,1866.9,40,3,1,6,12,7,1,1,0,0,16881,7.0,18465,208,55,-1788,-761,20.8,1688.1
4470434724,1,15,0,0,10,5,6,0,0,0,0,19140,7.4,20293,257,72,4170,4481,25.7,1914.0,11,1,1,5,10,3,0,0,0,0,14970,6.4,15812,171,60,-4170,-4481,17.1,1497.0
4451744895,1,16,3,1,9,3,12,1,1,0,0,17020,6.8,17178,185,44,1377,-673,18.5,1702.0,21,2,0,3,9,2,0,0,0,0,15643,7.0,17851,232,51,-1377,673,23.2,1564.3
4524923771,1,20,6,1,9,2,10,0,0,0,0,17855,7.2,18853,211,60,4076,2996,21.1,1785.5,44,2,0,2,9,1,1,1,0,0,13779,6.6,15857,211,44,-4076,-2996,21.1,1377.9
4518628901,1,35,5,1,9,4,9,0,0,0,0,17356,7.2,19154,195,50,2356,1297,19.5,1735.6,23,3,0,4,9,3,0,0,0,0,15000,7.0,17857,193,56,-2356,-1297,19.3,1500.0
4522521968,1,13,1,0,5,2,3,2,1,1,0,15216,7.2,18894,216,53,-101,-556,21.6,1521.6,15,0,1,2,5,0,0,0,0,0,15317,7.2,19450,248,68,101,556,24.8,1531.7
4513730011,1,18,3,1,5,6,2,0,0,0,0,17250,7.0,19462,251,68,929,1352,25.1,1725.0,13,3,0,6,5,9,1,1,0,0,16321,7.2,18110,211,44,-929,-1352,21.1,1632.1
4472568378,0,15,3,0,1,6,0,0,0,0,0,13921,6.6,16963,207,56,-2641,-2207,20.7,1392.1,16,3,1,6,1,5,1,0,1,0,16562,7.0,19170,242,44,2641,2207,24.2,1656.2
4497718869,1,37,4,1,4,2,1,1,1,0,0,16752,7.4,19777,232,85,2210,2411,23.2,1675.2,23,1,0,2,4,0,0,0,0,0,14542,6.6,17366,214,53,-2210,-2411,21.4,1454.2
4467557868,0,32,3,1,4,6,4,1,0,1,0,16203,6.8,17228,205,45,-635,-1525,20.5,1620.3,17,1,0,6,4,8,1,1,0,0,16838,7.2,18753,206,61,635,1525,20.6,1683.8
4521688394,1,15,4,0,4,4,5,0,0,0,0,16333,7.2,19527,237,65,60,-341,23.7,1633.3,23,5,1,4,4,3,1,1,0,0,16273,7.6,19868,252,80,-60,341,25.2,1627.3
4482124456,1,17,2,1,9,10,16,1,1,0,0,17308,6.8,16748,203,50,-999,-1466,20.3,1730.8,18,2,0,10,9,13,1,0,1,0,18307,7.2,18214,212,48,999,1466,21.2,1830.7
4524273849,1,11,2,1,5,8,5,1,1,0,0,16781,6.6,17452,237,50,633,-295,23.7,1678.1,16,2,0,8,5,13,0,0,0,0,16148,6.8,17747,180,44,-633,295,18.0,1614.8
4526264359,0,15,0,1,3,3,2,1,0,1,0,15567,7.0,18798,232,52,62,1348,23.2,1556.7,12,0,0,3,3,5,0,0,0,0,15505,7.0,17450,237,56,-62,-1348,23.7,1550.5
4524017392,1,15,1,1,12,4,9,1,0,1,0,18657,7.2,19205,227,37,4083,2884,22.7,1865.7,15,2,0,4,12,1,1,1,0,0,14574,6.6,16321,191,52,-4083,-2884,19.1,1457.4
4525823181,1,60,5,1,3,4,7,0,0,0,0,15029,6.6,16462,244,41,-29,-781,24.4,1502.9,26,3,0,4,3,4,1,1,0,0,15058,6.8,17243,207,55,29,781,20.7,1505.8
4462044332,0,22,3,0,5,9,2,0,0,0,1,15600,6.2,14986,193,36,-3128,-2320,19.3,1560.0,15,6,1,9,5,9,1,0,1,1,18728,6.8,17306,232,46,3128,2320,23.2,1872.8
4522847001,0,17,0,0,1,10,2,0,0,0,0,13342,6.4,15464,177,48,-6540,-4772,17.7,1334.2,33,3,1,10,1,13,2,1,1,0,19882,7.4,20236,234,56,6540,4772,23.4,1988.2
4513381950,1,15,11,1,4,1,2,1,1,0,0,15304,7.0,18188,228,48,1093,720,22.8,1530.4,46,1,0,1,4,1,0,0,0,0,14211,6.8,17468,215,56,-1093,-720,21.5,1421.1
4513242798,0,16,3,1,7,4,4,0,0,0,0,16589,7.0,18105,231,49,-17,-355,23.1,1658.9,18,2,0,4,7,4,1,1,0,0,16606,7.2,18460,220,66,17,355,22.0,1660.6
4520391395,0,17,1,1,8,10,9,1,0,1,1,18374,7.2,18219,218,54,1142,969,21.8,1837.4,14,0,0,10,8,14,0,0,0,0,17232,6.8,17250,188,50,-1142,-969,18.8,1723.2
4524969913,1,15,0,1,14,3,19,1,1,0,0,21020,7.6,21002,237,73,7166,4491,23.7,2102.0,14,3,0,3,14,6,0,0,0,0,13854,6.6,16511,193,40,-7166,-4491,19.3,1385.4
4519143177,0,17,4,1,4,0,5,1,0,1,0,15714,7.0,17384,210,56,1378,-144,21.0,1571.4,15,5,0,0,4,0,1,1,0,0,14336,6.8,17528,259,60,-1378,144,25.9,1433.6
4512808961,0,17,4,0,5,11,5,1,1,0,0,16280,6.6,17350,199,48,-2198,-1633,19.9,1628.0,15,3,1,11,5,15,0,0,0,0,18478,7.2,18983,188,46,2198,1633,18.8,1847.8
4457248839,1,14,2,0,13,7,11,0,0,0,0,18692,7.4,19886,238,40,1872,3579,23.8,1869.2,13,2,1,7,13,11,0,0,0,0,16820,6.6,16307,215,36,-1872,-3579,21.5,1682.0
4524951656,0,14,2,0,4,15,5,0,0,0,0,15316,6.6,15976,184,44,-2883,-3312,18.4,1531.6,18,3,1,15,4,15,1,1,0,0,18199,7.2,19288,194,48,2883,3312,19.4,1819.9
4509907014,0,19,13,1,3,2,6,1,0,1,0,15840,6.6,16848,212,40,1811,-631,21.2,1584.0,43,4,0,2,3,1,1,1,0,0,14029,6.8,17479,221,48,-1811,631,22.1,1402.9
4496533687,1,14,4,0,4,8,3,1,1,0,0,15049,7.0,17666,218,52,-2088,-870,21.8,1504.9,16,3,1,8,4,7,0,0,0,0,17137,7.2,18536,240,47,2088,870,24.0,1713.7
4483586875,1,13,0,1,12,6,13,1,1,0,0,18704,7.4,19748,223,56,2765,2798,22.3,1870.4,30,1,0,6,12,5,0,0,0,0,15939,6.8,16950,233,42,-2765,-2798,23.3,1593.9
4486714617,0,21,2,0,1,8,1,0,0,0,0,14022,6.8,16586,223,59,-4075,-3154,22.3,1402.2,15,2,1,8,1,7,2,1,1,1,18097,7.2,19740,211,60,4075,3154,21.1,1809.7
4476300428,0,15,8,0,8,3,8,1,1,0,0,17429,7.4,19044,239,48,2800,2474,23.9,1742.9,15,5,1,3,8,1,0,0,0,0,14629,6.6,16570,197,66,-2800,-2474,19.7,1462.9
4497571086,1,18,5,0,5,3,6,1,1,0,0,16108,7.2,18920,240,61,976,1599,24.0,1610.8,39,3,1,3,5,5,0,0,0,0,15132,6.8,17321,230,42,-976,-1599,23.0,1513.2
4447906863,0,14,1,1,4,6,5,0,0,0,0,15522,7.0,18255,220,52,-1711,-1406,22.0,1552.2,9,2,0,6,4,6,1,1,0,0,17233,7.4,19661,239,68,1711,1406,23.9,1723.3
4510187946,0,12,3,0,1,5,2,0,0,0,0,14257,6.6,17053,230,44,-3234,-2889,23.0,1425.7,17,3,1,5,1,9,0,0,0,0,17491,7.2,19942,247,68,3234,2889,24.7,1749.1
4524221277,1,16,0,1,9,5,14,0,0,0,0,18203,7.2,18324,223,48,2718,91,22.3,1820.3,45,2,0,5,9,5,0,0,0,0,15485,6.8,18233,216,48,-2718,-91,21.6,1548.5
4446210050,1,38,3,1,3,3,0,1,1,0,0,14162,6.8,17402,201,54,-1078,692,20.1,1416.2,14,1,0,3,3,4,0,0,0,0,15240,6.8,16710,240,45,1078,-692,24.0,1524.0
4518045882,1,17,1,1,4,5,4,1,1,0,0,15519,6.8,17775,236,45,-859,-1502,23.6,1551.9,24,3,0,5,4,5,0,0,0,0,16378,7.2,19277,237,65,859,1502,23.7,1637.8
4517860890,1,16,2,1,14,3,14,0,0,0,4,23424,7.4,18730,220,41,11467,8265,22.0,2342.4,7,2,0,3,14,2,0,0,0,0,11957,5.0,10465,117,32,-11467,-8265,11.7,1195.7
4454340438,0,15,1,0,0,4,0,0,0,0,0,13580,6.4,16571,207,48,-4279,-4529,20.7,1358.0,37,2,1,4,0,2,2,1,1,0,17859,7.6,21100,266,82,4279,4529,26.6,1785.9
4481987758,1,42,3,0,14,9,13,1,1,0,0,19830,7.2,19377,217,60,2594,2485,21.7,1983.0,14,6,1,9,14,9,0,0,0,0,17236,6.6,16892,185,40,-2594,-2485,18.5,1723.6
4515344624,0,16,5,0,1,2,1,1,0,1,0,14264,7.0,18355,220,63,-1450,340,22.0,1426.4,20,5,1,2,1,2,1,1,0,0,15714,6.8,18015,259,48,1450,-340,25.9,1571.4
4488853318,0,11,2,0,2,9,1,0,0,0,0,13380,6.2,14784,188,48,-4446,-3703,18.8,1338.0,18,0,1,9,2,10,1,1,0,0,17826,7.2,18487,233,44,4446,3703,23.3,1782.6
4525151632,0,15,2,0,3,10,1,0,0,0,0,15049,6.6,17888,209,56,-3891,-2276,20.9,1504.9,30,3,1,10,3,12,1,1,0,0,18940,7.4,20164,221,78,3891,2276,22.1,1894.0
4526239133,1,14,4,0,2,6,2,0,0,0,0,14836,6.8,17216,210,56,-1704,-1787,21.0,1483.6,26,4,1,6,2,5,0,0,0,0,16540,7.4,19003,226,64,1704,1787,22.6,1654.0
4500544230,1,14,3,1,5,4,3,1,1,0,0,16490,7.0,18411,214,55,1018,-1023,21.4,1649.0,13,0,0,4,5,2,1,0,1,0,15472,7.2,19434,204,64,-1018,1023,20.4,1547.2
4523403818,1,20,6,1,6,8,7,0,0,0,0,17053,7.0,18362,219,46,-298,0,21.9,1705.3,18,4,0,8,6,7,1,1,0,0,17351,7.2,18362,213,45,298,0,21.3,1735.1
4467133575,1,16,5,0,8,4,9,0,0,0,0,17239,7.2,18395,209,46,1436,1824,20.9,1723.9,46,3,1,4,8,2,0,0,0,0,15803,6.6,16571,225,53,-1436,-1824,22.5,1580.3
4506917789,1,12,4,0,4,4,4,1,0,1,0,15607,7.0,18678,215,57,-315,718,21.5,1560.7,18,3,1,4,4,3,1,1,0,0,15922,6.8,17960,246,62,315,-718,24.6,1592.2
4522863300,0,16,2,0,5,11,3,1,1,0,0,15594,6.6,16987,213,55,-2997,-2029,21.3,1559.4,18,6,1,11,5,14,0,0,0,0,18591,7.2,19016,222,46,2997,2029,22.2,1859.1
4496563536,1,34,3,0,8,8,9,0,0,0,0,16692,7.0,17643,181,68,-795,-117,18.1,1669.2,35,1,1,8,8,14,0,0,0,0,17487,7.0,17760,222,32,795,117,22.2,1748.7
4518753838,0,14,1,1,5,3,5,0,0,0,0,15892,6.8,18043,216,48,822,25,21.6,1589.2,13,1,0,3,5,3,2,1,1,0,15070,7.2,18018,229,55,-822,-25,22.9,1507.0
4484545103,0,17,0,1,8,7,7,0,0,0,0,16885,6.6,17748,220,40,-11,-1495,22.0,1688.5,12,6,0,7,8,6,1,1,0,0,16896,7.2,19243,213,60,11,1495,21.3,1689.6
4513177860,0,16,1,1,6,5,8,0,0,0,0,16326,7.2,18838,222,50,509,595,22.2,1632.6,14,4,0,5,6,1,1,1,0,0,15817,6.8,18243,231,56,-509,-595,23.1,1581.7
4526606861,1,14,3,1,8,4,7,1,1,0,0,16134,6.6,16880,183,52,857,22,18.3,1613.4,14,0,0,4,8,1,0,0,0,0,15277,6.6,16858,210,52,-857,-22,21.0,1527.7
4479829925,1,15,5,1,7,2,9,0,0,0,0,17428,7.4,18741,219,56,2444,561,21.9,1742.8,16,2,0,2,7,1,1,1,0,0,14984,6.8,18180,242,52,-2444,-561,24.2,1498.4
4489563821,0,14,0,1,3,6,3,2,1,1,0,15900,6.8,17700,234,40,-1286,-995,23.4,1590.0,14,1,0,6,3,6,0,0,0,0,17186,7.0,18695,214,54,1286,995,21.4,1718.6
4525318046,0,41,3,1,6,8,5,0,0,0,0,16351,7.0,18380,234,52,-2929,-154,23.4,1635.1,29,14,0,8,6,10,1,1,0,1,19280,7.2,18534,233,48,2929,154,23.3,1928.0
4524424547,1,16,1,1,6,0,7,2,1,1,0,16874,7.2,19010,260,51,2929,2507,26.0,1687.4,16,2,0,0,6,0,0,0,0,0,13945,6.6,16503,239,52,-2929,-2507,23.9,1394.5
4522610884,1,23,1,0,7,3,10,1,1,0,0,17146,7.2,19310,227,63,2072,2367,22.7,1714.6,15,3,1,3,7,5,0,0,0,0,15074,6.8,16943,241,49,-2072,-2367,24.1,1507.4
4522585401,1,15,5,0,9,4,7,0,0,0,0,17928,7.4,20419,250,60,2514,2924,25.0,1792.8,36,1,1,4,9,5,0,0,0,0,15414,7.0,17495,180,61,-2514,-2924,18.0,1541.4
4525070151,0,12,3,1,3,4,3,1,1,0,0,15420,7.2,18542,237,48,-136,-807,23.7,1542.0,17,1,0,4,3,2,1,0,1,0,15556,7.2,19349,237,64,136,807,23.7,1555.6
4505180812,0,16,5,1,6,3,6,1,1,0,0,16928,7.2,18438,236,52,1071,-35,23.6,1692.8,18,3,0,3,6,0,0,0,0,0,15857,7.2,18473,254,71,-1071,35,25.4,1585.7
4480345116,1,17,6,0,5,8,4,0,0,0,0,14665,6.6,15242,188,32,-2277,-1804,18.8,1466.5,19,4,1,8,5,6,0,0,0,0,16942,6.6,17046,225,50,2277,1804,22.5,1694.2
4498395907,0,39,5,0,5,7,7,2,1,1,0,15745,6.8,17708,225,52,-2082,-1005,22.5,1574.5,18,6,1,7,5,5,0,0,0,0,17827,7.0,18713,264,56,2082,1005,26.4,1782.7
4508510246,0,14,2,1,7,7,4,0,0,0,0,16068,6.8,17309,193,42,-466,608,19.3,1606.8,20,2,0,7,7,9,0,0,0,0,16534,6.4,16701,224,29,466,-608,22.4,1653.4
4519488029,0,14,3,0,3,11,2,0,0,0,0,14016,6.6,16299,190,52,-4534,-2709,19.0,1401.6,11,5,1,11,3,13,1,1,0,0,18550,7.2,19008,228,47,4534,2709,22.8,1855.0
4502140813,0,18,2,0,9,13,12,0,0,0,0,18082,6.8,17805,215,37,-1097,-674,21.5,1808.2,12,5,1,13,9,18,1,1,0,0,19179,7.0,18479,204,54,1097,674,20.4,1917.9
4503218320,0,16,3,1,2,6,2,0,0,0,0,14528,6.8,16573,203,57,-2377,-2338,20.3,1452.8,19,5,0,6,2,5,1,1,0,0,16905,7.2,18911,251,53,2377,2338,25.1,1690.5
4524895008,0,12,2,1,10,7,15,1,1,0,0,17437,7.0,17146,177,57,1059,180,17.7,1743.7,121,1,0,7,10,5,1,0,1,0,16378,6.8,16966,186,55,-1059,-180,18.6,1637.8
4495413031,0,44,2,0,5,7,2,1,1,0,0,15409,7.2,18408,217,64,-1440,-373,21.7,1540.9,17,4,1,7,5,9,0,0,0,0,16849,7.2,18781,241,52,1440,373,24.1,1684.9
4516594125,1,14,3,0,7,3,8,1,1,0,0,16858,7.0,18658,228,40,1160,1541,22.8,1685.8,22,4,1,3,7,6,0,0,0,0,15698,6.6,17117,244,58,-1160,-1541,24.4,1569.8
4445378393,0,16,4,0,10,5,8,1,0,1,0,19169,7.4,19642,235,48,3305,2586,23.5,1916.9,17,1,1,5,10,6,1,1,0,0,15864,7.0,17056,215,44,-3305,-2586,21.5,1586.4
4517670386,0,43,3,0,1,14,1,0,0,0,0,13172,6.0,14988,187,28,-7079,-4936,18.7,1317.2,15,5,1,14,1,21,1,1,0,0,20251,7.4,19924,222,63,7079,4936,22.2,2025.1
4510205356,1,13,1,0,7,6,7,0,0,0,0,16064,7.0,17943,181,48,41,178,18.1,1606.4,11,2,1,6,7,5,2,1,1,0,16023,6.8,17765,206,52,-41,-178,20.6,1602.3
4519771711,0,19,2,0,10,8,9,0,0,0,0,18359,6.8,17074,190,48,1462,249,19.0,1835.9,16,3,1,8,10,12,0,0,0,0,16897,6.6,16825,160,47,-1462,-249,16.0,1689.7
4505063876,1,16,2,0,2,2,3,0,0,0,0,15830,7.2,19605,255,80,909,2001,25.5,1583.0,12,1,1,2,2,3,0,0,0,0,14921,7.0,17604,219,63,-909,-2001,21.9,1492.1
4456065713,1,13,0,1,8,9,6,1,0,1,0,16951,7.0,18684,200,57,-32,-204,20.0,1695.1,15,2,0,9,8,9,1,1,0,0,16983,7.0,18888,216,46,32,204,21.6,1698.3
4521354990,0,10,0,0,7,9,4,0,0,0,0,15933,6.8,16916,221,48,-1790,-1980,22.1,1593.3,14,3,1,9,7,10,1,1,0,0,17723,7.2,18896,223,64,1790,1980,22.3,1772.3
4524994987,1,18,0,1,14,4,15,0,0,0,0,20075,7.0,18552,220,53,5853,3870,22.0,2007.5,15,0,0,4,14,6,0,0,0,0,14222,6.2,14682,179,36,-5853,-3870,17.9,1422.2
4391439154,1,16,3,1,10,2,7,1,1,0,0,18828,7.4,20691,244,68,4124,3900,24.4,1882.8,13,3,0,2,10,1,0,0,0,0,14704,6.8,16791,220,56,-4124,-3900,22.0,1470.4
4494889837,0,15,2,0,3,7,4,0,0,0,0,14584,6.8,16798,220,49,-2543,-1202,22.0,1458.4,18,3,1,7,3,7,1,1,0,0,17127,7.0,18000,258,38,2543,1202,25.8,1712.7
4500504137,1,23,0,1,13,4,17,1,1,0,1,20028,7.0,18736,213,43,4887,2100,21.3,2002.8,16,5,0,4,13,2,0,0,0,0,15141,6.6,16636,207,56,-4887,-2100,20.7,1514.1
4527355079,0,17,7,0,6,5,9,1,1,0,0,16796,6.8,18185,232,34,117,248,23.2,1679.6,49,1,1,5,6,9,0,0,0,0,16679,6.8,17937,221,52,-117,-248,22.1,1667.9
4472446718,1,15,2,1,2,3,0,1,0,1,1,16875,6.8,18159,247,56,2231,223,24.7,1687.5,18,0,0,3,2,3,1,1,0,0,14644,6.8,17936,190,76,-2231,-223,19.0,1464.4
4494910229,1,13,2,1,4,6,8,0,0,0,0,16135,6.6,16458,213,52,173,461,21.3,1613.5,18,0,0,6,4,11,1,1,0,0,15962,6.4,15997,196,52,-173,-461,19.6,1596.2
4491767708,0,14,7,0,3,8,3,0,0,0,0,15160,7.0,17505,217,52,-2174,-1268,21.7,1516.0,13,3,1,8,3,12,2,1,1,0,17334,7.2,18773,227,64,2174,1268,22.7,1733.4
4517806218,0,16,2,1,9,8,7,1,0,1,0,17347,7.0,18573,202,62,-1144,480,20.2,1734.7,13,5,0,8,9,11,1,1,0,1,18491,7.0,18093,199,45,1144,-480,19.9,1849.1
4461353444,0,60,4,1,7,3,9,1,1,0,0,16938,7.0,18699,226,56,1516,426,22.6,1693.8,16,6,0,3,7,4,0,0,0,0,15422,7.0,18273,210,60,-1516,-426,21.0,1542.2
4525184804,1,54,4,0,6,1,8,2,1,1,0,16763,7.0,18897,224,51,2817,2414,22.4,1676.3,37,3,1,1,6,1,0,0,0,0,13946,6.4,16483,207,56,-2817,-2414,20.7,1394.6
4522486224,1,18,3,1,7,4,10,1,1,0,0,16753,6.8,17461,220,39,2015,857,22.0,1675.3,17,5,0,4,7,2,1,0,1,0,14738,6.4,16604,171,60,-2015,-857,17.1,1473.8
4473499451,1,18,5,1,9,4,10,0,0,0,0,18307,7.2,19026,244,49,3113,2284,24.4,1830.7,17,5,0,4,9,3,1,1,0,0,15194,6.4,16742,213,48,-3113,-2284,21.3,1519.4
4522209032,0,15,4,0,4,4,2,1,1,0,0,14697,7.0,17818,222,48,-1620,-1655,22.2,1469.7,16,1,1,4,4,4,0,0,0,0,16317,7.4,19473,255,72,1620,1655,25.5,1631.7
4448123749,0,14,1,0,1,11,0,0,0,0,0,13447,6.4,16199,201,51,-5698,-3675,20.1,1344.7,17,4,1,11,1,12,2,1,1,0,19145,7.2,19874,240,44,5698,3675,24.0,1914.5
4417621987,1,17,6,1,8,8,12,0,0,0,0,17856,6.8,18232,221,50,226,-955,22.1,1785.6,11,2,0,8,8,8,1,1,0,0,17630,7.2,19187,221,50,-226,955,22.1,1763.0
4524611648,1,15,3,1,7,7,9,0,0,0,0,16946,6.8,18077,212,45,1482,1055,21.2,1694.6,17,3,0,7,7,7,1,1,0,0,15464,7.0,17022,161,48,-1482,-1055,16.1,1546.4
4514522984,1,14,3,0,0,5,0,0,0,0,0,12939,6.4,15958,201,32,-4578,-3673,20.1,1293.9,19,2,1,5,0,5,1,1,0,0,17517,7.4,19631,259,79,4578,3673,25.9,1751.7
4487157845,0,20,5,1,4,5,7,0,0,0,0,15067,6.8,17232,172,56,-1641,-1610,17.2,1506.7,19,4,0,5,4,10,0,0,0,0,16708,7.4,18842,254,52,1641,1610,25.4,1670.8
4492820318,1,51,3,0,10,5,16,1,1,0,1,17535,6.4,15420,173,40,1436,-1544,17.3,1753.5,14,2,1,5,10,4,0,0,0,0,16099,6.8,16964,207,66,-1436,1544,20.7,1609.9
4468926711,1,15,1,0,4,8,4,0,0,0,0,15337,6.6,16778,217,40,-2811,-2298,21.7,1533.7,17,2,1,8,4,7,1,1,0,0,18148,7.2,19076,224,56,2811,2298,22.4,1814.8
4500429958,0,15,1,1,7,7,8,1,1,0,0,16812,6.8,17939,226,52,-260,-369,22.6,1681.2,51,2,0,7,7,7,0,0,0,0,17072,7.2,18308,233,53,260,369,23.3,1707.2
4522188300,0,18,4,0,5,4,7,1,0,1,0,15710,7.2,18847,239,43,-152,713,23.9,1571.0,17,3,1,4,5,5,1,1,0,0,15862,7.0,18134,218,74,152,-713,21.8,1586.2
4510949309,1,47,1,1,8,3,8,2,1,1,1,18237,7.0,18102,230,48,3675,2389,23.0,1823.7,12,0,0,3,8,4,0,0,0,0,14562,6.0,15713,170,62,-3675,-2389,17.0,1456.2
4518444936,1,15,3,0,2,4,3,0,0,0,0,14716,6.8,17855,219,56,-839,63,21.9,1471.6,15,4,1,4,2,5,1,1,0,0,15555,7.0,17792,215,56,839,-63,21.5,1555.5
4521238149,1,18,6,0,3,2,1,0,0,0,0,15681,7.0,19274,231,52,919,1527,23.1,1568.1,53,7,1,2,3,2,1,1,0,0,14762,7.0,17747,230,58,-919,-1527,23.0,1476.2
4451057396,0,16,2,1,6,7,5,1,0,1,0,15905,7.0,17754,200,52,-1317,-1427,20.0,1590.5,12,3,0,7,6,10,1,1,0,0,17222,7.2,19181,203,67,1317,1427,20.3,1722.2
4525236524,1,14,2,0,5,6,3,1,1,0,0,15762,7.0,18318,216,52,-208,-353,21.6,1576.2,14,4,1,6,5,5,0,0,0,0,15970,7.0,18671,221,48,208,353,22.1,1597.0
4456493473,0,13,3,0,1,3,0,0,0,0,0,13751,6.8,17182,199,60,-2507,-1567,19.9,1375.1,18,4,1,3,1,3,1,1,0,0,16258,7.2,18749,269,48,2507,1567,26.9,1625.8
4526030769,0,14,1,0,5,17,3,0,0,0,0,14494,6.6,15666,181,36,-5290,-3110,18.1,1449.4,12,2,1,17,5,14,1,1,0,0,19784,7.2,18776,192,48,5290,3110,19.2,1978.4
4516175381,1,15,3,0,9,4,11,1,0,1,1,19684,7.4,20073,217,60,3920,3302,21.7,1968.4,19,1,1,4,9,3,1,1,0,0,15764,6.6,16771,219,48,-3920,-3302,21.9,1576.4
4433180879,1,38,2,0,5,7,6,1,1,0,0,15408,7.0,17993,209,52,-928,-1753,20.9,1540.8,19,2,1,7,5,3,0,0,0,0,16336,7.4,19746,237,56,928,1753,23.7,1633.6
4512919782,0,45,3,1,7,6,10,0,0,0,0,16275,6.8,16968,190,56,495,21,19.0,1627.5,20,0,0,6,7,10,0,0,0,0,15780,6.8,16947,197,48,-495,-21,19.7,1578.0
4510355472,0,19,2,1,4,6,1,0,0,0,0,14547,6.4,15883,188,53,-2074,-1795,18.8,1454.7,19,3,0,6,4,5,2,1,1,0,16621,6.8,17678,196,56,2074,1795,19.6,1662.1
4527044797,0,15,0,0,5,10,5,0,0,0,0,15954,6.8,16521,192,56,-2527,-2193,19.2,1595.4,14,3,1,10,5,8,1,1,0,0,18481,7.4,18714,197,80,2527,2193,19.7,1848.1
4525580330,1,12,0,0,5,10,5,1,0,1,0,16063,6.8,17891,195,60,-2368,-1240,19.5,1606.3,14,1,1,10,5,9,1,1,0,0,18431,7.2,19131,233,47,2368,1240,23.3,1843.1
4487526235,1,17,1,0,4,5,4,0,0,0,0,16194,6.8,17871,238,76,376,-194,23.8,1619.4,19,4,1,5,4,10,2,1,1,0,15818,7.0,18065,215,52,-376,194,21.5,1581.8
4512589969,0,16,4,1,5,2,6,0,0,0,0,17126,7.0,19205,249,53,2361,1802,24.9,1712.6,11,7,0,2,5,2,2,1,1,0,14765,6.8,17403,230,52,-2361,-1802,23.0,1476.5
4517744860,1,20,2,1,7,7,7,1,1,0,0,16636,6.8,17569,207,53,-1117,-509,20.7,1663.6,16,4,0,7,7,4,0,0,0,0,17753,7.0,18078,230,54,1117,509,23.0,1775.3
4467502993,1,18,4,0,4,6,4,0,0,0,0,15691,7.2,18589,237,52,96,466,23.7,1569.1,26,5,1,6,4,2,0,0,0,0,15595,6.8,18123,221,52,-96,-466,22.1,1559.5
4502662072,0,14,1,1,12,12,16,0,0,0,0,18714,6.8,18333,199,37,801,262,19.9,1871.4,19,0,0,12,12,12,0,0,0,0,17913,6.8,18071,182,37,-801,-262,18.2,1791.3
4527431280,1,13,4,0,12,7,17,1,1,0,0,18608,7.4,19209,215,56,1824,1556,21.5,1860.8,15,1,1,7,12,6,0,0,0,0,16784,7.0,17653,222,43,-1824,-1556,22.2,1678.4
4516387872,1,17,4,1,12,4,18,1,1,0,0,19640,7.0,18636,216,52,5151,3496,21.6,1964.0,10,1,0,4,12,5,0,0,0,0,14489,6.0,15140,175,36,-5151,-3496,17.5,1448.9
4527443985,1,18,0,1,9,2,6,0,0,0,0,17947,7.2,19669,239,36,4121,3050,23.9,1794.7,50,1,0,2,9,1,0,0,0,0,13826,6.8,16619,177,62,-4121,-3050,17.7,1382.6
4461174959,0,40,2,1,5,8,6,1,1,0,0,15107,6.8,17606,187,44,-2607,-2365,18.7,1510.7,18,2,0,8,5,8,0,0,0,0,17714,7.4,19971,238,56,2607,2365,23.8,1771.4
4420667626,0,11,1,0,1,5,1,0,0,0,0,13738,6.6,16678,223,34,-3468,-2158,22.3,1373.8,14,2,1,5,1,7,2,1,1,0,17206,7.4,18836,259,70,3468,2158,25.9,1720.6
4503181649,1,18,4,1,5,2,8,0,0,0,0,16684,7.4,19585,240,59,2672,1784,24.0,1668.4,15,2,0,2,5,2,0,0,0,0,14012,7.0,17801,220,47,-2672,-1784,22.0,1401.2
4496821254,0,15,2,1,9,6,9,2,1,1,0,18050,7.4,19654,239,37,1949,214,23.9,1805.0,12,1,0,6,9,2,0,0,0,0,16101,7.0,19440,214,58,-1949,-214,21.4,1610.1
4525188268,1,14,4,1,8,4,14,1,1,0,0,17451,6.8,17118,210,53,2470,1058,21.0,1745.1,14,1,0,4,8,3,0,0,0,0,14981,6.6,16060,219,30,-2470,-1058,21.9,1498.1
4523699051,1,34,3,1,10,7,12,0,0,0,0,17951,6.6,17346,211,45,2095,628,21.1,1795.1,15,2,0,7,10,4,0,0,0,0,15856,6.8,16718,171,47,-2095,-628,17.1,1585.6
4494271393,1,18,1,1,1,1,1,1,0,1,0,15186,7.0,17891,231,60,1120,477,23.1,1518.6,39,2,0,1,1,2,1,1,0,0,14066,6.8,17414,196,60,-1120,-477,19.6,1406.6
4516145589,1,15,1,0,9,9,11,0,0,0,0,18026,7.0,18214,211,56,894,639,21.1,1802.6,11,3,1,9,9,8,0,0,0,0,17132,6.8,17575,195,47,-894,-639,19.5,1713.2
4524924257,0,14,3,0,4,9,1,1,0,1,0,14979,6.6,17213,210,52,-3414,-1141,21.0,1497.9,20,3,1,9,4,11,0,0,0,0,18393,7.2,18354,229,51,3414,1141,22.9,1839.3
4495515321,1,18,2,0,3,1,4,0,0,0,0,14654,7.0,17393,201,49,-663,-413,20.1,1465.4,11,2,1,1,3,2,1,1,0,0,15317,6.8,17806,248,58,663,413,24.8,1531.7
4482030809,0,12,2,0,6,11,6,0,0,0,0,17982,7.0,18687,244,56,-708,387,24.4,1798.2,9,3,1,11,6,9,1,1,0,0,18690,7.2,18300,203,44,708,-387,20.3,1869.0
4521922174,0,18,0,1,11,5,8,0,0,0,0,18956,7.2,19208,243,47,3415,1887,24.3,1895.6,205,2,0,5,11,6,1,1,0,0,15541,6.8,17321,192,52,-3415,-1887,19.2,1554.1
4516724538,1,17,3,1,8,3,7,1,0,1,0,19318,7.8,21508,257,71,4787,4701,25.7,1931.8,31,2,0,3,8,1,1,1,0,0,14531,6.6,16807,230,50,-4787,-4701,23.0,1453.1
4524214463,1,15,3,1,7,5,8,0,0,0,0,16828,6.8,17273,217,35,912,-241,21.7,1682.8,19,3,0,5,7,5,1,1,0,0,15916,6.6,17514,217,60,-912,241,21.7,1591.6
4513456428,1,18,5,1,11,6,13,1,1,0,0,18214,7.2,19670,220,52,2262,2885,22.0,1821.4,18,4,0,6,11,6,0,0,0,0,15952,6.6,16785,228,34,-2262,-2885,22.8,1595.2
4451957612,0,17,2,1,5,2,9,0,0,0,0,15429,6.8,16480,202,44,1043,-1408,20.2,1542.9,38,3,0,2,5,3,0,0,0,0,14386,6.8,17888,203,38,-1043,1408,20.3,1438.6
4524714078,0,11,1,0,3,6,3,2,1,1,0,15685,7.0,18609,232,58,-516,266,23.2,1568.5,14,1,1,6,3,8,0,0,0,0,16201,6.8,18343,208,45,516,-266,20.8,1620.1
4412400770,1,35,4,1,8,5,7,2,1,1,0,16712,6.8,17310,208,41,2427,2303,20.8,1671.2,12,2,0,5,8,7,0,0,0,0,14285,6.4,15007,172,33,-2427,-2303,17.2,1428.5
4477413718,1,15,5,1,6,1,5,0,0,0,0,16807,7.2,19976,263,64,2954,3730,26.3,1680.7,11,0,0,1,6,1,1,1,0,0,13853,6.6,16246,177,80,-2954,-3730,17.7,1385.3
4413023613,0,26,1,0,2,3,4,0,0,0,0,15416,7.0,18096,253,64,-83,-64,25.3,1541.6,14,3,1,3,2,3,1,1,0,0,15499,7.2,18160,230,68,83,64,23.0,1549.9
4510529947,0,19,5,0,7,6,10,0,0,0,0,15878,6.6,16090,187,45,567,-789,18.7,1587.8,16,6,1,6,7,7,0,0,0,0,15311,6.6,16879,220,40,-567,789,22.0,1531.1
4491170236,1,17,3,0,6,9,6,0,0,0,0,16407,7.4,18871,168,67,-949,-297,16.8,1640.7,68,5,1,9,6,3,1,1,0,0,17356,7.2,19168,216,53,949,297,21.6,1735.6
4519789324,1,15,1,0,6,5,2,1,1,0,0,15967,7.0,18611,237,56,-999,-778,23.7,1596.7,10,3,1,5,6,5,1,0,1,0,16966,7.2,19389,250,54,999,778,25.0,1696.6
4488915308,0,16,8,0,4,11,9,0,0,0,0,15124,6.8,17488,213,37,-4664,-2707,21.3,1512.4,22,2,1,11,4,7,2,1,1,0,19788,7.4,20195,249,66,4664,2707,24.9,1978.8
4489955666,1,18,2,1,18,6,16,2,1,1,0,21893,7.6,21511,243,56,7125,3657,24.3,2189.3,9,2,0,6,18,0,0,0,0,0,14768,7.2,17854,176,42,-7125,-3657,17.6,1476.8
4500193521,0,17,3,1,7,4,5,1,1,0,0,16960,6.8,17503,215,59,-60,10,21.5,1696.0,16,5,0,4,7,7,1,0,1,1,17020,6.8,17493,222,46,60,-10,22.2,1702.0
4494819577,0,44,3,0,4,7,4,1,0,1,0,15475,6.6,16428,195,56,-1972,-1010,19.5,1547.5,16,2,1,7,4,15,0,0,0,0,17447,6.8,17438,230,43,1972,1010,23.0,1744.7
4524990772,0,15,0,1,7,8,8,0,0,0,0,16979,6.8,17700,228,34,1038,454,22.8,1697.9,10,3,0,8,7,4,1,1,0,0,15941,6.8,17246,174,56,-1038,-454,17.4,1594.1
4459414345,0,41,0,0,1,10,0,0,0,0,0,12925,6.4,15498,187,32,-6386,-4210,18.7,1292.5,12,1,1,10,1,6,1,0,1,1,19311,7.2,19708,247,56,6386,4210,24.7,1931.1
4479699071,1,16,4,1,10,5,14,1,1,0,0,18392,7.2,17969,221,48,2119,209,22.1,1839.2,16,2,0,5,10,6,0,0,0,0,16273,7.0,17760,206,48,-2119,-209,20.6,1627.3
4437257190,1,27,5,1,10,6,8,1,0,1,0,18392,6.8,18818,222,52,2263,1634,22.2,1839.2,18,1,0,6,10,5,1,1,0,0,16129,6.4,17184,213,60,-2263,-1634,21.3,1612.9
4520606377,1,16,6,0,5,5,5,1,1,0,0,16388,7.0,18495,256,32,178,882,25.6,1638.8,17,6,1,5,5,5,1,0,1,0,16210,6.8,17613,216,63,-178,-882,21.6,1621.0
4523105841,0,11,3,0,2,11,1,1,1,0,0,14643,6.8,17019,230,56,-4728,-3668,23.0,1464.3,28,4,1,11,2,14,0,0,0,0,19371,7.6,20687,236,64,4728,3668,23.6,1937.1
4512998598,1,18,3,1,14,7,14,2,1,1,0,19984,7.0,19327,207,64,3140,3525,20.7,1998.4,43,1,0,7,14,9,0,0,0,0,16844,6.4,15802,201,40,-3140,-3525,20.1,1684.4
4509889611,1,82,2,1,12,3,14,1,1,0,0,19032,7.2,19015,191,63,3965,3505,19.1,1903.2,12,3,0,3,12,3,0,0,0,0,15067,6.4,15510,182,52,-3965,-3505,18.2,1506.7
4453485597,1,15,5,0,3,5,5,1,1,0,0,15049,6.8,17760,247,45,-1564,-953,24.7,1504.9,16,0,1,5,3,4,0,0,0,0,16613,7.2,18713,242,67,1564,953,24.2,1661.3
4521415877,0,18,0,1,7,14,6,0,0,0,0,16054,6.4,16044,176,40,-3304,-3201,17.6,1605.4,12,1,0,14,7,8,1,1,0,0,19358,7.2,19245,170,58,3304,3201,17.0,1935.8
4523659113,1,10,3,0,7,7,7,0,0,0,0,17152,6.8,18219,223,48,629,753,22.3,1715.2,16,1,1,7,7,9,1,1,0,0,16523,6.8,17466,212,44,-629,-753,21.2,1652.3
4520030026,0,14,2,1,5,4,9,2,1,1,0,16455,7.2,17798,229,44,1844,1397,22.9,1645.5,19,4,0,4,5,6,0,0,0,0,14611,6.6,16401,213,36,-1844,-1397,21.3,1461.1
4497467264,1,15,4,1,8,3,8,1,1,0,0,17640,7.2,19566,233,56,2768,2761,23.3,1764.0,18,2,0,3,8,2,0,0,0,0,14872,6.6,16805,220,52,-2768,-2761,22.0,1487.2
4497697674,1,18,3,1,6,2,10,1,1,0,0,16623,7.2,18555,211,54,1792,-764,21.1,1662.3,13,3,0,2,6,2,1,0,1,0,14831,7.0,19319,223,72,-1792,764,22.3,1483.1
4524340253,0,16,3,0,5,5,7,0,0,0,0,16878,7.0,19372,238,63,808,1415,23.8,1687.8,38,5,1,5,5,8,1,1,0,0,16070,7.0,17957,214,56,-808,-1415,21.4,1607.0
4426682867,0,15,9,0,4,8,7,0,0,0,0,15049,6.6,16534,211,47,-2353,-2050,21.1,1504.9,29,9,1,8,4,7,2,1,1,0,17402,7.0,18584,235,44,2353,2050,23.5,1740.2
4514844404,0,15,4,0,7,9,8,0,0,0,0,16795,6.8,18170,217,52,-1317,-816,21.7,1679.5,17,1,1,9,7,14,1,1,0,0,18112,7.4,18986,247,51,1317,816,24.7,1811.2
4472849009,0,21,2,1,5,6,5,2,1,1,0,15817,7.0,17992,218,43,-27,-371,21.8,1581.7,17,4,0,6,5,7,0,0,0,0,15844,7.2,18363,203,41,27,371,20.3,1584.4
4442492836,1,38,5,1,5,4,5,1,1,0,0,15967,6.8,17855,203,62,803,798,20.3,1596.7,18,1,0,4,5,6,0,0,0,0,15164,6.8,17057,226,38,-803,-798,22.6,1516.4
4495598638,0,21,1,0,3,3,5,0,0,0,0,15480,7.0,19018,243,61,-816,-27,24.3,1548.0,17,6,1,3,3,3,1,1,0,0,16296,7.0,19045,278,63,816,27,27.8,1629.6
4484294172,0,14,2,0,5,6,0,1,1,0,0,15682,7.0,18027,247,44,-438,-778,24.7,1568.2,47,0,1,6,5,6,0,0,0,0,16120,7.0,18805,206,51,438,778,20.6,1612.0
4456177266,0,13,1,1,6,8,5,0,0,0,0,16459,7.0,18612,201,58,-2021,-1891,20.1,1645.9,20,0,0,8,6,7,0,0,0,0,18480,7.4,20503,235,80,2021,1891,23.5,1848.0
4467678363,1,45,2,0,2,6,1,0,0,0,0,13979,6.6,16912,203,48,-2871,-2427,20.3,1397.9,19,5,1,6,2,4,1,1,0,0,16850,7.4,19339,243,59,2871,2427,24.3,1685.0
4519161047,1,14,3,1,9,5,6,1,0,1,0,18122,7.2,19174,233,57,2195,554,23.3,1812.2,15,0,0,5,9,4,0,0,0,0,15927,7.2,18620,200,54,-2195,-554,20.0,1592.7
4494697495,1,15,1,0,10,5,8,1,1,0,0,17910,7.2,20300,211,60,2786,3197,21.1,1791.0,10,1,1,5,10,4,0,0,0,0,15124,6.8,17103,175,48,-2786,-3197,17.5,1512.4
4459235569,0,16,2,1,8,9,9,1,1,0,0,17385,7.2,18439,185,70,-747,-782,18.5,1738.5,17,3,0,9,8,12,0,0,0,0,18132,7.4,19221,214,50,747,782,21.4,1813.2
4527571899,1,15,4,0,11,9,11,1,0,1,0,17729,6.8,17260,190,40,679,211,19.0,1772.9,19,3,1,9,11,7,0,0,0,0,17050,6.8,17049,192,27,-679,-211,19.2,1705.0
4501342795,1,18,3,1,9,7,12,1,1,0,0,18920,7.4,19580,238,44,2339,625,23.8,1892.0,13,3,0,7,9,5,0,0,0,0,16581,7.0,18955,220,39,-2339,-625,22.0,1658.1
4521769577,0,49,3,0,4,9,2,0,0,0,0,15067,6.6,17556,223,56,-3456,-1621,22.3,1506.7,17,3,1,9,4,7,1,1,0,0,18523,7.2,19177,235,52,3456,1621,23.5,1852.3
4509325423,0,23,6,1,3,5,5,1,1,0,0,16091,6.6,17434,230,54,-1053,-1363,23.0,1609.1,17,7,0,5,3,5,0,0,0,0,17144,7.0,18797,248,47,1053,1363,24.8,1714.4
4521995809,0,18,1,0,2,6,2,0,0,0,0,13408,6.6,15571,185,43,-5838,-4101,18.5,1340.8,15,2,1,6,2,4,1,1,0,0,19246,7.2,19672,255,72,5838,4101,25.5,1924.6
4468841659,0,11,4,0,7,7,5,1,1,0,0,15720,6.8,17797,185,44,-325,-231,18.5,1572.0,86,3,1,7,7,4,0,0,0,0,16045,7.0,18028,200,44,325,231,20.0,1604.5
4519988685,0,22,2,1,9,6,13,0,0,0,0,17569,6.8,17101,212,40,1728,-738,21.2,1756.9,11,2,0,6,9,7,0,0,0,0,15841,7.0,17839,180,56,-1728,738,18.0,1584.1
4527231679,0,13,2,1,7,3,7,0,0,0,0,16838,7.2,18339,239,53,1828,302,23.9,1683.8,19,0,0,3,7,0,1,1,0,0,15010,6.8,18037,235,44,-1828,-302,23.5,1501.0
4448358133,1,20,0,1,5,7,9,0,0,0,0,16072,6.8,16945,236,32,-184,408,23.6,1607.2,12,5,0,7,5,7,0,0,0,0,16256,6.8,16537,195,39,184,-408,19.5,1625.6
4521155877,0,20,2,0,3,6,1,0,0,0,0,14719,6.6,16759,214,43,-2418,-2255,21.4,1471.9,38,1,1,6,3,7,0,0,0,0,17137,7.0,19014,240,64,2418,2255,24.0,1713.7
4505508838,0,20,2,1,6,5,7,1,1,0,0,17070,7.2,18971,223,73,760,995,22.3,1707.0,39,2,0,5,6,6,0,0,0,0,16310,6.8,17976,230,39,-760,-995,23.0,1631.0
4488805966,1,12,2,1,7,4,7,1,1,0,0,15680,6.6,17099,186,52,-259,-1115,18.6,1568.0,37,1,0,4,7,4,0,0,0,0,15939,7.0,18214,227,51,259,1115,22.7,1593.9
4522504958,0,15,4,0,6,8,7,1,1,0,0,16000,6.4,16023,212,19,-1208,-2526,21.2,1600.0,17,2,1,8,6,13,0,0,0,0,17208,7.2,18549,210,37,1208,2526,21.0,1720.8
4524165991,0,52,3,0,6,8,7,1,1,0,0,15753,6.8,16744,203,45,-1964,-1415,20.3,1575.3,16,3,1,8,6,7,1,0,1,0,17717,7.0,18159,238,48,1964,1415,23.8,1771.7
4511197912,1,43,2,1,12,7,13,0,0,0,0,18278,6.8,17024,191,24,2352,707,19.1,1827.8,17,5,0,7,12,9,0,0,0,0,15926,6.6,16317,189,45,-2352,-707,18.9,1592.6
4522457944,1,16,2,1,6,4,5,0,0,0,0,16938,7.0,17614,220,48,2145,-316,22.0,1693.8,36,3,0,4,6,5,0,0,0,0,14793,6.8,17930,197,44,-2145,316,19.7,1479.3
4484592953,1,29,1,1,7,4,6,0,0,0,0,17028,7.4,19169,247,52,1586,2622,24.7,1702.8,17,1,0,4,7,4,1,1,0,0,15442,6.6,16547,214,55,-1586,-2622,21.4,1544.2
4523014807,0,80,0,0,5,7,5,1,1,0,0,17026,7.0,18231,213,76,17,-403,21.3,1702.6,15,2,1,7,5,6,1,0,1,0,17009,7.0,18634,218,68,-17,403,21.8,1700.9
4516980931,1,12,1,0,5,11,3,0,0,0,0,16321,7.0,17802,185,64,-2593,-1668,18.5,1632.1,12,0,1,11,5,18,1,1,0,0,18914,7.2,19470,245,45,2593,1668,24.5,1891.4
4449441137,1,37,4,0,8,3,8,0,0,0,0,16896,7.4,19116,225,45,1447,2623,22.5,1689.6,85,3,1,3,8,2,1,1,0,0,15449,6.4,16493,190,52,-1447,-2623,19.0,1544.9
4522469111,1,15,3,1,4,7,8,0,0,0,0,16002,6.6,16283,204,45,98,-786,20.4,1600.2,16,4,0,7,4,8,1,1,0,0,15904,6.6,17069,193,44,-98,786,19.3,1590.4
4526037415,0,15,2,1,9,7,12,0,0,0,0,17604,6.8,17925,194,49,1538,1118,19.4,1760.4,50,2,0,7,9,7,1,1,0,0,16066,6.8,16807,168,48,-1538,-1118,16.8,1606.6
4517858736,0,14,2,1,6,3,7,0,0,0,0,16310,7.0,18578,235,48,690,998,23.5,1631.0,18,1,0,3,6,5,1,1,0,0,15620,6.8,17580,230,40,-690,-998,23.0,1562.0
4497776955,0,87,2,0,2,4,0,0,0,0,0,14532,6.6,17477,217,52,-1021,-1439,21.7,1453.2,12,1,1,4,2,2,0,0,0,0,15553,7.2,18916,206,64,1021,1439,20.6,1555.3
4496068567,1,13,2,1,9,5,6,1,0,1,0,17076,7.2,18945,194,54,834,1853,19.4,1707.6,16,0,0,5,9,2,0,0,0,0,16242,6.6,17092,238,36,-834,-1853,23.8,1624.2
4477114963,0,10,7,0,10,4,13,0,0,0,0,18959,7.0,19305,220,48,3522,1996,22.0,1895.9,16,3,1,4,10,5,1,1,0,0,15437,6.6,17309,206,69,-3522,-1996,20.6,1543.7
4522083891,0,14,5,1,12,9,10,1,1,0,0,18910,7.2,18538,203,47,1454,1187,20.3,1891.0,15,1,0,9,12,14,0,0,0,0,17456,7.0,17351,185,40,-1454,-1187,18.5,1745.6
4504872920,0,15,2,1,5,3,6,0,0,0,0,16478,6.8,17590,254,44,1207,-488,25.4,1647.8,38,3,0,3,5,6,2,1,1,0,15271,7.2,18078,212,72,-1207,488,21.2,1527.1
4468006580,0,17,0,0,4,10,10,0,0,0,0,15064,6.2,14203,141,40,-5181,-5072,14.1,1506.4,17,2,1,10,4,9,2,1,1,1,20245,7.4,19275,240,60,5181,5072,24.0,2024.5
4524569254,1,13,3,0,9,5,4,2,1,1,0,18434,7.4,20263,223,70,2812,2497,22.3,1843.4,16,2,1,5,9,3,0,0,0,0,15622,7.2,17766,226,55,-2812,-2497,22.6,1562.2
4519218713,1,15,2,0,11,7,15,0,0,0,0,18894,6.8,17942,219,35,1573,-624,21.9,1889.4,13,2,1,7,11,7,2,1,1,0,17321,7.0,18566,220,76,-1573,624,22.0,1732.1
4525558466,1,18,3,1,4,3,4,1,1,0,0,16571,7.2,18893,258,52,1749,1270,25.8,1657.1,20,3,0,3,4,3,0,0,0,0,14822,6.6,17623,232,49,-1749,-1270,23.2,1482.2
4508892154,0,17,3,1,10,10,10,1,1,0,1,17418,6.2,14242,175,22,774,-188,17.5,1741.8,16,3,0,10,10,12,0,0,0,0,16644,6.0,14430,143,43,-774,188,14.3,1664.4
4513065219,0,17,0,0,4,13,7,1,1,0,0,14007,6.2,14101,197,27,-6259,-5376,19.7,1400.7,14,3,1,13,4,14,0,0,0,0,20266,7.2,19477,247,45,6259,5376,24.7,2026.6
4527462322,0,15,1,1,4,8,3,0,0,0,0,15475,7.0,17551,216,48,-1892,-2127,21.6,1547.5,16,1,0,8,4,9,1,1,0,0,17367,7.4,19678,211,63,1892,2127,21.1,1736.7
4500263311,0,103,1,0,2,5,0,1,1,0,0,13649,6.8,17258,199,52,-2497,-1239,19.9,1364.9,13,3,1,5,2,4,0,0,0,0,16146,7.0,18497,211,60,2497,1239,21.1,1614.6
4444956835,0,40,2,0,2,3,2,1,1,0,0,14506,7.2,17908,230,63,-1288,-685,23.0,1450.6,16,3,1,3,2,5,0,0,0,0,15794,7.0,18593,217,57,1288,685,21.7,1579.4
4494756316,0,15,2,0,9,8,9,1,1,0,0,16884,6.4,17197,193,55,-968,-3,19.3,1688.4,17,3,1,8,9,6,1,0,1,0,17852,6.8,17200,210,45,968,3,21.0,1785.2
4472483704,1,65,2,0,3,8,5,0,0,0,0,14823,6.8,17193,193,56,-3916,-1400,19.3,1482.3,23,5,1,8,3,7,2,1,1,1,18739,7.0,18593,245,53,3916,1400,24.5,1873.9
4510307677,1,17,1,1,11,4,14,1,1,0,0,17961,7.2,19152,205,41,3354,2760,20.5,1796.1,13,0,0,4,11,5,0,0,0,0,14607,6.8,16392,206,32,-3354,-2760,20.6,1460.7
4419866013,0,16,3,0,8,6,12,1,1,0,0,16879,7.0,18288,199,44,45,-351,19.9,1687.9,27,4,1,6,8,5,0,0,0,0,16834,7.0,18639,254,49,-45,351,25.4,1683.4
4473795908,1,16,4,1,7,2,6,0,0,0,1,19456,7.8,21097,230,76,4525,4052,23.0,1945.6,26,0,0,2,7,2,0,0,0,0,14931,6.6,17045,247,52,-4525,-4052,24.7,1493.1
4503044010,1,21,2,1,10,4,14,2,1,1,0,18132,6.8,17869,212,42,1947,136,21.2,1813.2,22,5,0,4,10,3,0,0,0,0,16185,6.6,17733,219,49,-1947,-136,21.9,1618.5
4520690347,0,19,2,0,1,2,1,0,0,0,0,14215,6.6,17252,228,52,-579,-379,22.8,1421.5,39,6,1,2,1,1,1,1,0,0,14794,6.8,17631,233,40,579,379,23.3,1479.4
4521779426,1,13,2,1,7,5,12,1,1,0,0,17042,7.0,18045,223,60,1004,559,22.3,1704.2,12,2,0,5,7,9,0,0,0,0,16038,6.8,17486,182,48,-1004,-559,18.2,1603.8
4527150511,0,16,3,0,3,3,1,0,0,0,0,14948,6.8,17612,218,48,-347,125,21.8,1494.8,16,3,1,3,3,2,0,0,0,0,15295,6.6,17487,204,52,347,-125,20.4,1529.5
4512309053,0,19,3,0,10,7,7,0,0,0,0,17984,7.2,18275,229,44,2086,1202,22.9,1798.4,16,5,1,7,10,5,0,0,0,0,15898,6.8,17073,189,39,-2086,-1202,18.9,1589.8
4513061726,0,14,3,1,2,6,2,1,1,0,0,15381,6.6,16972,249,52,-2545,-1960,24.9,1538.1,15,4,0,6,2,6,1,0,1,1,17926,7.0,18932,243,56,2545,1960,24.3,1792.6
4463558465,1,15,4,1,7,7,8,0,0,0,0,15887,6.8,17319,171,57,-560,-1443,17.1,1588.7,16,1,0,7,7,3,0,0,0,0,16447,7.0,18762,209,39,560,1443,20.9,1644.7
4387767645,1,16,1,1,10,7,9,1,1,0,1,19018,7.2,19294,209,63,3126,3795,20.9,1901.8,12,1,0,7,10,11,0,0,0,0,15892,6.4,15499,162,51,-3126,-3795,16.2,1589.2
4505265174,0,21,4,0,5,7,7,1,1,0,0,15983,7.2,18335,229,43,-704,-531,22.9,1598.3,18,3,1,7,5,10,0,0,0,0,16687,7.2,18866,205,48,704,531,20.5,1668.7
4465807712,0,14,3,1,8,6,14,1,1,0,0,17151,7.0,18082,227,43,1338,46,22.7,1715.1,17,2,0,6,8,5,0,0,0,0,15813,7.0,18036,204,52,-1338,-46,20.4,1581.3
4527516350,1,25,2,1,6,7,6,0,0,0,0,16246,7.0,17593,193,45,-766,-577,19.3,1624.6,15,3,0,7,6,9,1,1,0,0,17012,7.2,18170,204,61,766,577,20.4,1701.2
4477637530,0,39,0,1,2,9,3,1,0,1,0,14157,6.4,16183,198,48,-3421,-2978,19.8,1415.7,16,3,0,9,2,10,1,1,0,0,17578,7.2,19161,238,48,3421,2978,23.8,1757.8
4515568453,0,15,1,0,8,10,6,0,0,0,0,15995,6.8,17109,172,57,-3535,-1199,17.2,1599.5,11,0,1,10,8,13,1,1,0,1,19530,7.2,18308,220,44,3535,1199,22.0,1953.0
4496990681,0,16,6,0,4,5,7,1,1,0,0,15376,6.6,16496,225,40,-733,-784,22.5,1537.6,15,1,1,5,4,6,0,0,0,0,16109,6.6,17280,201,52,733,784,20.1,1610.9
4521747245,1,15,3,0,5,3,5,0,0,0,0,16564,7.0,18605,222,63,1436,1597,22.2,1656.4,14,4,1,3,5,5,1,1,0,0,15128,6.8,17008,221,52,-1436,-1597,22.1,1512.8
4522665247,0,38,2,0,9,15,9,0,0,0,0,17371,6.8,17227,183,42,-2793,-3416,18.3,1737.1,15,3,1,15,9,12,0,0,0,0,20164,7.6,20643,228,42,2793,3416,22.8,2016.4
4514331863,1,16,4,0,16,7,16,1,1,0,1,20300,7.4,19812,192,44,3309,2603,19.2,2030.0,213,5,1,7,16,6,1,0,1,0,16991,6.8,17209,194,48,-3309,-2603,19.4,1699.1
4494107603,0,27,5,1,6,3,5,2,1,1,0,16843,7.2,19160,241,52,1597,1617,24.1,1684.3,18,6,0,3,6,5,0,0,0,0,15246,6.8,17543,231,42,-1597,-1617,23.1,1524.6
4518119286,1,17,0,1,6,6,7,1,1,0,0,16521,6.8,17859,214,56,90,-1069,21.4,1652.1,17,1,0,6,6,3,1,0,1,0,16431,7.2,18928,243,52,-90,1069,24.3,1643.1
4464534299,1,16,2,1,9,3,13,1,0,1,0,17786,7.4,19357,235,52,3090,1008,23.5,1778.6,17,3,0,3,9,2,1,1,0,0,14696,7.2,18349,215,60,-3090,-1008,21.5,1469.6
4511958473,0,37,2,1,7,4,7,0,0,0,0,16695,7.2,18868,222,49,1486,1605,22.2,1669.5,17,3,0,4,7,3,1,1,0,0,15209,6.8,17263,229,44,-1486,-1605,22.9,1520.9
4513519782,1,17,1,0,7,8,5,0,0,0,0,16447,7.4,19247,215,52,-1422,345,21.5,1644.7,16,1,1,8,7,10,1,1,0,0,17869,7.2,18902,244,48,1422,-345,24.4,1786.9
4517636739,0,22,3,0,7,12,4,0,0,0,0,15633,6.4,16398,188,40,-5271,-4236,18.8,1563.3,17,12,1,12,7,14,2,1,1,0,20904,7.6,20634,269,67,5271,4236,26.9,2090.4
4454764258,0,34,3,1,4,5,4,1,0,1,0,16021,6.8,18017,209,69,-217,571,20.9,1602.1,71,1,0,5,4,6,1,1,0,0,16238,6.8,17446,236,47,217,-571,23.6,1623.8
4473009756,0,13,2,0,7,7,10,1,1,0,0,16397,6.6,17090,222,40,-1023,-2028,22.2,1639.7,39,1,1,7,7,6,0,0,0,0,17420,7.2,19118,243,52,1023,2028,24.3,1742.0
4521612568,1,16,1,0,4,11,4,1,1,0,0,15089,7.2,17882,219,48,-3426,-2754,21.9,1508.9,18,6,1,11,4,15,0,0,0,0,18515,7.6,20636,227,48,3426,2754,22.7,1851.5
4526346248,1,11,0,1,5,5,5,0,0,0,1,17803,7.0,18782,242,52,2197,1516,24.2,1780.3,13,1,0,5,5,8,0,0,0,0,15606,6.8,17266,228,37,-2197,-1516,22.8,1560.6
4486292796,0,12,2,0,7,11,4,0,0,0,0,15528,6.6,17206,235,6,-3546,-1919,23.5,1552.8,14,0,1,11,7,12,0,0,0,0,19074,7.2,19125,238,65,3546,1919,23.8,1907.4
4387753545,1,16,3,1,11,10,12,1,1,0,0,18286,6.6,16569,183,31,149,-1568,18.3,1828.6,11,4,0,10,11,12,1,0,1,0,18137,7.0,18137,205,53,-149,1568,20.5,1813.7
4524960407,1,22,0,1,4,7,4,1,0,1,1,17104,6.6,17075,224,61,-669,-502,22.4,1710.4,17,4,0,7,4,8,1,1,0,0,17773,6.8,17577,209,46,669,502,20.9,1777.3
4518050394,0,44,3,1,3,3,3,0,0,0,0,15081,6.8,17777,206,50,-66,815,20.6,1508.1,16,3,0,3,3,6,0,0,0,0,15147,7.0,16962,215,45,66,-815,21.5,1514.7
4518354034,1,15,4,1,7,8,9,0,0,0,0,16790,7.0,17505,193,60,382,-64,19.3,1679.0,11,3,0,8,7,12,0,0,0,0,16408,7.0,17569,208,44,-382,64,20.8,1640.8
4467345105,0,19,4,0,9,8,5,0,0,0,0,18090,7.0,18948,238,43,736,-349,23.8,1809.0,16,5,1,8,9,9,0,0,0,0,17354,7.4,19297,213,59,-736,349,21.3,1735.4
4501459269,1,12,5,1,8,9,15,0,0,0,0,18315,7.0,18534,209,51,246,1266,20.9,1831.5,17,0,0,9,8,8,1,1,0,0,18069,6.8,17268,208,46,-246,-1266,20.8,1806.9
4498639695,0,16,2,0,3,7,5,0,0,0,0,14767,7.0,17485,212,68,-2150,-1486,21.2,1476.7,13,1,1,7,3,9,1,1,0,0,16917,7.2,18971,225,59,2150,1486,22.5,1691.7
4524982143,1,20,4,1,10,6,15,2,1,1,1,19890,6.8,18304,214,56,3290,1398,21.4,1989.0,13,3,0,6,10,7,0,0,0,1,16600,6.6,16906,214,40,-3290,-1398,21.4,1660.0
4519269898,1,16,1,1,6,8,5,0,0,0,0,15969,6.8,17938,231,40,-809,10,23.1,1596.9,10,2,0,8,6,8,0,0,0,0,16778,6.6,17928,216,35,809,-10,21.6,1677.8
4520806066,1,13,0,1,8,8,7,1,1,0,0,16228,6.6,16387,194,44,-412,22,19.4,1622.8,16,0,0,8,8,9,0,0,0,0,16640,6.6,16365,208,51,412,-22,20.8,1664.0
4509942464,1,18,2,0,8,4,11,1,1,0,0,17255,7.0,18288,237,43,2116,1613,23.7,1725.5,15,3,1,4,8,5,0,0,0,0,15139,6.6,16675,203,52,-2116,-1613,20.3,1513.9
4509446311,0,75,1,0,0,7,0,0,0,0,0,13405,6.6,15825,214,42,-3556,-2950,21.4,1340.5,20,5,1,7,0,6,0,0,0,0,16961,7.0,18775,237,36,3556,2950,23.7,1696.1
4527053268,1,41,5,1,8,6,12,0,0,0,0,18675,7.6,20603,219,61,2125,2034,21.9,1867.5,15,2,0,6,8,5,1,1,0,0,16550,7.0,18569,222,64,-2125,-2034,22.2,1655.0
4517168876,0,14,3,1,4,8,6,0,0,0,0,15549,6.8,18169,228,65,-1841,-357,22.8,1554.9,28,1,0,8,4,11,0,0,0,0,17390,7.0,18526,223,49,1841,357,22.3,1739.0
4527469441,1,16,3,1,8,6,13,0,0,0,0,17672,7.2,18962,245,50,1121,933,24.5,1767.2,34,3,0,6,8,8,1,1,0,0,16551,6.8,18029,238,61,-1121,-933,23.8,1655.1
4521725362,1,20,2,1,8,5,7,0,0,0,0,18225,7.2,18898,236,47,1868,726,23.6,1822.5,16,1,0,5,8,5,0,0,0,0,16357,6.8,18172,223,56,-1868,-726,22.3,1635.7
4523725496,0,14,3,0,2,12,2,0,0,0,0,14158,6.6,16377,194,41,-5740,-3709,19.4,1415.8,19,1,1,12,2,8,2,1,1,0,19898,7.4,20086,240,57,5740,3709,24.0,1989.8
4516422291,0,16,1,0,6,8,9,0,0,0,0,16479,6.6,16357,230,36,-266,-65,23.0,1647.9,14,1,1,8,6,13,2,1,1,0,16745,6.6,16422,186,52,266,65,18.6,1674.5
4525860458,1,44,3,1,6,2,7,0,0,0,0,17311,7.0,18763,257,52,2781,1229,25.7,1731.1,13,15,0,2,6,2,0,0,0,0,14530,6.8,17534,216,60,-2781,-1229,21.6,1453.0
4523849056,1,26,2,1,5,4,8,1,1,0,0,15518,6.6,16862,197,50,-686,-619,19.7,1551.8,21,4,0,4,5,5,1,0,1,0,16204,6.8,17481,249,49,686,619,24.9,1620.4
4450437970,1,35,0,1,6,4,4,2,1,1,0,15997,7.2,19158,195,60,499,2441,19.5,1599.7,21,1,0,4,6,4,0,0,0,0,15498,6.6,16717,210,41,-499,-2441,21.0,1549.8
4461048637,1,13,2,1,8,1,14,1,1,0,0,17113,7.0,18837,203,52,3278,2617,20.3,1711.3,13,2,0,1,8,0,0,0,0,0,13835,6.6,16220,194,56,-3278,-2617,19.4,1383.5
4497057886,0,15,2,0,1,8,2,1,1,0,0,14702,6.6,16461,214,55,-5136,-3713,21.4,1470.2,14,3,1,8,1,7,0,0,0,1,19838,7.6,20174,289,46,5136,3713,28.9,1983.8
4521698665,1,20,4,1,5,3,8,2,1,1,0,16321,7.0,18143,249,52,1151,-108,24.9,1632.1,17,1,0,3,5,4,0,0,0,0,15170,7.0,18251,218,47,-1151,108,21.8,1517.0
4496483924,1,15,1,1,10,6,10,1,1,0,0,18498,7.2,20017,238,56,1446,1597,23.8,1849.8,14,3,0,6,10,5,0,0,0,0,17052,7.0,18420,229,56,-1446,-1597,22.9,1705.2
4526971230,1,16,2,0,7,6,4,0,0,0,0,15473,6.8,17556,195,48,-1174,-778,19.5,1547.3,14,3,1,6,7,5,0,0,0,0,16647,7.2,18334,221,38,1174,778,22.1,1664.7
4485619170,0,12,6,1,4,5,6,1,0,1,0,16260,6.8,18128,225,63,266,-282,22.5,1626.0,78,2,0,5,4,10,1,1,0,0,15994,7.2,18410,224,48,-266,282,22.4,1599.4
4501146183,0,14,0,1,4,4,2,0,0,0,0,15853,6.8,18455,229,64,20,-1382,22.9,1585.3,18,2,0,4,4,3,1,1,0,0,15833,7.4,19837,232,69,-20,1382,23.2,1583.3
4526372741,1,12,1,1,10,4,9,1,1,0,0,18009,7.4,19630,226,56,3026,1849,22.6,1800.9,35,4,0,4,10,1,0,0,0,0,14983,6.8,17781,205,51,-3026,-1849,20.5,1498.3
4501847669,0,14,2,0,6,10,5,0,0,0,0,15256,6.6,16464,189,28,-1555,-357,18.9,1525.6,17,2,1,10,6,12,1,1,0,0,16811,6.8,16821,182,45,1555,357,18.2,1681.1
4526401078,0,11,1,0,4,3,3,1,1,0,0,15080,7.0,18378,208,56,-401,-439,20.8,1508.0,37,1,1,3,4,3,0,0,0,0,15481,7.4,18817,232,53,401,439,23.2,1548.1
4524698581,0,11,0,1,3,13,1,0,0,0,0,13737,6.2,15314,174,36,-7218,-5853,17.4,1373.7,13,1,0,13,3,12,1,1,0,0,20955,7.6,21167,250,61,7218,5853,25.0,2095.5
4493896445,1,20,3,0,6,1,8,0,0,0,0,16932,7.4,19607,243,55,2545,1922,24.3,1693.2,15,2,1,1,6,1,0,0,0,0,14387,6.8,17685,240,56,-2545,-1922,24.0,1438.7
4447333769,1,20,6,0,5,3,4,0,0,0,0,17455,7.4,19749,254,79,2409,2186,25.4,1745.5,12,4,1,3,5,4,1,0,1,0,15046,6.8,17563,239,45,-2409,-2186,23.9,1504.6
4459426947,0,16,2,0,5,6,5,1,1,0,0,16842,7.0,18443,221,58,-259,-1001,22.1,1684.2,16,4,1,6,5,6,0,0,0,0,17101,7.4,19444,247,64,259,1001,24.7,1710.1
4473666102,0,13,3,0,1,10,1,0,0,0,0,13785,6.8,16211,215,43,-4124,-3090,21.5,1378.5,16,3,1,10,1,13,1,1,0,0,17909,7.2,19301,260,54,4124,3090,26.0,1790.9
4508816408,1,13,4,0,6,1,4,0,0,0,0,16931,7.2,19352,222,50,1931,2084,22.2,1693.1,30,1,1,1,6,1,0,0,0,0,15000,6.8,17268,222,67,-1931,-2084,22.2,1500.0
4490242391,0,19,3,1,9,6,15,1,1,0,0,17679,6.8,17322,222,32,363,-1888,22.2,1767.9,34,2,0,6,9,7,1,0,1,0,17316,7.2,19210,230,79,-363,1888,23.0,1731.6
4508291469,0,17,0,0,7,8,8,0,0,0,0,16228,6.6,16832,191,44,-1127,-1496,19.1,1622.8,35,1,1,8,7,6,2,1,1,0,17355,7.0,18328,204,53,1127,1496,20.4,1735.5
4513405622,1,38,1,1,10,6,7,0,0,0,0,17682,7.6,20336,201,66,2310,4456,20.1,1768.2,17,4,0,6,10,10,1,1,0,0,15372,6.4,15880,210,16,-2310,-4456,21.0,1537.2
4477502000,1,60,4,1,6,7,7,1,0,1,0,17247,7.0,18845,233,65,915,1710,23.3,1724.7,16,3,0,7,6,9,0,0,0,0,16332,7.0,17135,214,36,-915,-1710,21.4,1633.2
4492536033,0,36,5,1,5,8,4,1,1,0,0,16396,7.2,18166,211,60,-1640,-907,21.1,1639.6,16,2,0,8,5,9,0,0,0,0,18036,7.2,19073,250,48,1640,907,25.0,1803.6
4505754774,1,28,6,0,14,6,22,0,0,0,0,19890,6.8,17275,174,46,4401,2185,17.4,1989.0,16,2,1,6,14,6,1,1,0,0,15489,6.2,15090,204,36,-4401,-2185,20.4,1548.9
4488632154,1,21,4,1,4,4,5,1,1,0,1,17201,7.2,18839,234,56,1070,1159,23.4,1720.1,18,5,0,4,4,2,1,0,1,1,16131,6.8,17680,215,62,-1070,-1159,21.5,1613.1
4513183607,0,45,5,1,8,6,11,1,1,0,0,17405,7.0,18074,204,51,1059,-338,20.4,1740.5,10,5,0,6,8,9,0,0,0,0,16346,7.0,18412,221,36,-1059,338,22.1,1634.6
4462640479,0,15,3,0,1,9,0,0,0,0,0,13881,6.8,16482,225,56,-4851,-3577,22.5,1388.1,35,5,1,9,1,12,1,1,0,0,18732,7.4,20059,243,70,4851,3577,24.3,1873.2
4460653436,0,40,1,0,5,11,8,0,0,0,0,16177,7.0,18425,224,45,-1546,-710,22.4,1617.7,15,6,1,11,5,12,1,1,0,0,17723,7.4,19135,183,58,1546,710,18.3,1772.3
4477975030,0,19,3,1,5,4,5,0,0,0,0,16157,6.8,17603,240,28,804,365,24.0,1615.7,14,2,0,4,5,4,0,0,0,0,15353,7.0,17238,206,52,-804,-365,20.6,1535.3
4514505161,1,37,1,1,6,3,3,2,1,1,2,18742,7.4,20148,252,68,3725,2903,25.2,1874.2,12,14,0,3,6,5,0,0,0,0,15017,6.8,17245,208,52,-3725,-2903,20.8,1501.7
4499861497,1,15,2,1,5,5,6,1,0,1,0,16405,7.0,18502,239,43,861,1078,23.9,1640.5,14,2,0,5,5,9,1,1,0,0,15544,6.6,17424,233,44,-861,-1078,23.3,1554.4
4468770669,0,13,1,0,6,8,6,1,1,0,0,16877,7.0,18403,203,66,-147,273,20.3,1687.7,14,1,1,8,6,7,0,0,0,0,17024,6.8,18130,214,39,147,-273,21.4,1702.4
4522201700,1,17,1,0,4,4,3,0,0,0,0,15688,6.8,18341,237,51,91,591,23.7,1568.8,21,5,1,4,4,6,0,0,0,0,15597,6.8,17750,239,54,-91,-591,23.9,1559.7
